//MAP CONVERTED BY dmm2tgm.py THIS HEADER COMMENT PREVENTS RECONVERSION, DO NOT REMOVE
"cq" = (
/obj/machinery/light/floor,
/turf/open/floor/noslip/white,
/area/shuttle/escape)
"cr" = (
/obj/machinery/button/flasher{
	pixel_y = -21;
	req_one_access_txt = "3;4;38;63";
	id = "celerity_sec"
	},
/obj/item/storage/box/handcuffs{
	pixel_x = 9;
	pixel_y = 3
	},
/obj/structure/table/glass/plasma,
/obj/machinery/recharger{
	pixel_x = -5
	},
/turf/open/floor/noslip/dark,
/area/shuttle/escape)
"dL" = (
/obj/structure/chair/shuttlecraft_chair{
	dir = 4;
	pixel_x = -8
	},
/turf/open/floor/noslip/dark,
/area/shuttle/escape)
"ev" = (
/obj/structure/chair/shuttlecraft_chair{
	dir = 4;
	pixel_x = -8
	},
/turf/open/floor/noslip/standard,
/area/shuttle/escape)
"gX" = (
/obj/machinery/computer/emergency_shuttle{
	dir = 1
	},
/turf/open/floor/noslip/white,
/area/shuttle/escape)
"iq" = (
/obj/structure/reagent_dispensers/peppertank{
	pixel_y = -30
	},
/turf/open/floor/noslip/dark,
/area/shuttle/escape)
"jo" = (
/obj/machinery/door/airlock/ship/command/glass{
	name = "Bridge";
	req_access_txt = "19";
	req_one_access_txt = "19"
	},
/turf/open/floor/noslip/white,
/area/shuttle/escape)
"ka" = (
/obj/structure/reagent_dispensers/fueltank{
	anchored = 1
	},
/turf/open/floor/noslip,
/area/shuttle/escape)
"ky" = (
/obj/structure/sign/departments/minsky/security/security{
	pixel_y = -32
	},
/obj/item/storage/firstaid/regular{
	pixel_x = 6;
	pixel_y = 6
	},
/obj/item/storage/firstaid/regular{
	pixel_x = 3;
	pixel_y = 3
	},
/obj/item/storage/firstaid/regular,
/obj/structure/table/glass/plasma,
/turf/open/floor/noslip/blue,
/area/shuttle/escape)
"lx" = (
/obj/structure/window/plasma/reinforced{
	dir = 4
	},
/obj/machinery/flasher{
	pixel_y = 22;
	id = "celerity_sec"
	},
/turf/open/floor/noslip/dark,
/area/shuttle/escape)
"ly" = (
/obj/structure/sign/departments/minsky/security/security{
	pixel_y = -32
	},
/obj/machinery/vending/medical,
/turf/open/floor/noslip/blue,
/area/shuttle/escape)
"oy" = (
/obj/structure/chair/shuttlecraft_chair{
	dir = 4;
	pixel_x = -8
	},
/turf/open/floor/noslip/white,
/area/shuttle/escape)
"oA" = (
/obj/effect/spawner/structure/window/shuttle,
/turf/open/floor/plating,
/area/shuttle/escape)
"pp" = (
/obj/structure/window/plasma/reinforced{
	dir = 4
	},
/obj/machinery/flasher{
	pixel_y = -22;
	id = "celerity_sec"
	},
/turf/open/floor/noslip/dark,
/area/shuttle/escape)
"pI" = (
/obj/machinery/door/airlock/shuttle/glass,
/obj/structure/fans/tiny,
/turf/open/floor/noslip/standard,
/area/shuttle/escape)
"qt" = (
/obj/structure/chair/shuttlecraft_chair{
	dir = 8;
	pixel_x = 8
	},
/turf/open/floor/noslip/dark,
/area/shuttle/escape)
"rr" = (
/obj/structure/closet/emcloset,
/turf/open/floor/noslip,
/area/shuttle/escape)
"sT" = (
/turf/open/floor/noslip/standard,
/area/shuttle/escape)
"ti" = (
/turf/closed/wall/mineral/titanium/nodiagonal,
/area/shuttle/escape)
"tA" = (
/obj/structure/table/glass/plasma,
/obj/item/defibrillator/loaded,
/obj/item/storage/firstaid/advanced,
/turf/open/floor/noslip/blue,
/area/shuttle/escape)
"tJ" = (
/obj/structure/reagent_dispensers/water_cooler,
/turf/open/floor/noslip,
/area/shuttle/escape)
"ua" = (
/obj/structure/table/glass/plasma,
/obj/item/storage/toolbox/mechanical,
/turf/open/floor/noslip/white,
/area/shuttle/escape)
"uh" = (
/obj/machinery/recharge_station,
/turf/open/floor/noslip,
/area/shuttle/escape)
"vv" = (
/obj/machinery/stasis,
/turf/open/floor/noslip/blue,
/area/shuttle/escape)
"vK" = (
/obj/structure/chair/fancy/shuttle,
/turf/open/floor/noslip/white,
/area/shuttle/escape)
"wn" = (
/obj/structure/closet/crate/freezer/blood{
	anchored = 1
	},
/obj/machinery/iv_drip,
/turf/open/floor/noslip/blue,
/area/shuttle/escape)
"wr" = (
/obj/machinery/computer/station_alert{
	dir = 1;
	name = "ship alert console"
	},
/turf/open/floor/noslip/white,
/area/shuttle/escape)
"xh" = (
/obj/structure/reagent_dispensers/watertank,
/turf/open/floor/noslip,
/area/shuttle/escape)
"xM" = (
/obj/machinery/light/floor,
/turf/open/floor/noslip/blue,
/area/shuttle/escape)
"yq" = (
/obj/machinery/light/floor,
/turf/open/floor/noslip/dark,
/area/shuttle/escape)
"yU" = (
/turf/template_noop,
/area/template_noop)
"zL" = (
/obj/structure/table/glass/plasma,
/obj/structure/extinguisher_cabinet/east,
/obj/item/phone,
/turf/open/floor/noslip/white,
/area/shuttle/escape)
"Aj" = (
/obj/structure/window/plasma/reinforced/spawner/east,
/obj/structure/chair/shuttlecraft_chair{
	dir = 8;
	pixel_x = 2
	},
/turf/open/floor/noslip/standard,
/area/shuttle/escape)
"BG" = (
/obj/structure/closet/crate/medical{
	name = "medical crate"
	},
/obj/item/storage/firstaid/regular,
/obj/item/storage/firstaid/o2{
	pixel_x = 3;
	pixel_y = 3
	},
/obj/item/storage/firstaid/toxin{
	pixel_x = -4;
	pixel_y = 3
	},
/obj/item/healthanalyzer{
	pixel_x = 3;
	pixel_y = 3
	},
/obj/item/lazarus_injector,
/mob/living/simple_animal/bot/medbot{
	name = "\improper emergency medibot";
	pixel_x = -3;
	pixel_y = 2
	},
/turf/open/floor/noslip,
/area/shuttle/escape)
"BX" = (
/obj/structure/closet/firecloset{
	anchored = 1
	},
/turf/open/floor/noslip,
/area/shuttle/escape)
"Da" = (
/obj/structure/shuttle/engine/propulsion{
	dir = 1
	},
/turf/open/floor/plating,
/area/shuttle/escape)
"Dk" = (
/turf/closed/wall/mineral/titanium,
/area/shuttle/escape)
"DJ" = (
/obj/structure/chair/shuttlecraft_chair{
	pixel_y = 18
	},
/turf/open/floor/noslip/blue,
/area/shuttle/escape)
"Ey" = (
/obj/structure/chair/shuttlecraft_chair{
	dir = 8;
	pixel_x = 8
	},
/turf/open/floor/noslip/white,
/area/shuttle/escape)
"Ft" = (
/obj/structure/tank_dispenser/oxygen,
/turf/open/floor/noslip,
/area/shuttle/escape)
"FH" = (
/turf/open/floor/noslip/dark,
/area/shuttle/escape)
"Hr" = (
/obj/structure/table/glass/plasma,
/obj/machinery/recharger{
	active_power_usage = 0;
	idle_power_usage = 0;
	pixel_y = 4;
	use_power = 0
	},
/turf/open/floor/noslip/white,
/area/shuttle/escape)
"Ii" = (
/obj/machinery/vending/wallmed{
	name = "Emergency NanoMed";
	use_power = 0
	},
/turf/closed/wall/mineral/titanium,
/area/shuttle/escape)
"IC" = (
/obj/machinery/door/airlock/shuttle/glass,
/obj/structure/fans/tiny,
/obj/docking_port/mobile/emergency{
	name = "Dominion of Light Evacuation Shuttle, Celerity Class";
	width = 13;
	dir = 2;
	height = 26
	},
/turf/open/floor/noslip/standard,
/area/shuttle/escape)
"IG" = (
/obj/structure/closet/radiation{
	anchored = 1
	},
/turf/open/floor/noslip,
/area/shuttle/escape)
"IH" = (
/obj/structure/window/plasma/reinforced/spawner/west,
/obj/structure/chair/shuttlecraft_chair{
	dir = 4;
	pixel_x = -2
	},
/turf/open/floor/noslip/standard,
/area/shuttle/escape)
"IV" = (
/turf/open/floor/noslip,
/area/shuttle/escape)
"Jc" = (
/obj/machinery/door/window/brigdoor/security/cell/eastright{
	req_one_access_txt = "3;4;38;63"
	},
/obj/machinery/light/floor,
/turf/open/floor/noslip/dark,
/area/shuttle/escape)
"KC" = (
/turf/open/floor/noslip/blue,
/area/shuttle/escape)
"NH" = (
/obj/structure/shuttle/engine/propulsion{
	dir = 4
	},
/turf/template_noop,
/area/template_noop)
"NR" = (
/obj/structure/reagent_dispensers/peppertank{
	pixel_y = 32
	},
/turf/open/floor/noslip/dark,
/area/shuttle/escape)
"Ov" = (
/obj/machinery/computer/crew{
	dir = 1
	},
/turf/open/floor/noslip/white,
/area/shuttle/escape)
"Pm" = (
/obj/structure/chair/shuttlecraft_chair{
	dir = 4;
	pixel_x = -8
	},
/obj/machinery/light/floor,
/turf/open/floor/noslip/white,
/area/shuttle/escape)
"Qp" = (
/obj/machinery/door/airlock/ship/medical/glass{
	req_one_access_txt = "5;2;34;19";
	name = "Trauma Center"
	},
/turf/open/floor/noslip/blue,
/area/shuttle/escape)
"QN" = (
/obj/structure/shuttle/engine/propulsion,
/turf/open/floor/plating,
/area/shuttle/escape)
"QZ" = (
/obj/structure/table/glass/plasma,
/turf/open/floor/noslip/white,
/area/shuttle/escape)
"Sm" = (
/obj/structure/window/plasma/reinforced/spawner/east,
/turf/open/floor/noslip/standard,
/area/shuttle/escape)
"Tv" = (
/obj/machinery/door/airlock/ship/security/glass{
	req_one_access_txt = "2;34;19"
	},
/turf/open/floor/noslip/dark,
/area/shuttle/escape)
"Tz" = (
/obj/structure/window/plasma/reinforced/spawner/west,
/turf/open/floor/noslip/standard,
/area/shuttle/escape)
"TD" = (
/turf/open/floor/noslip/white,
/area/shuttle/escape)
"VG" = (
/obj/structure/shuttle/engine/propulsion{
	dir = 8
	},
/turf/template_noop,
/area/template_noop)
"VU" = (
/obj/structure/sign/departments/medbay/alt{
	pixel_y = -32
	},
/turf/open/floor/noslip/standard,
/area/shuttle/escape)
"Wo" = (
/obj/structure/chair/shuttlecraft_chair{
	dir = 8;
	pixel_x = 8
	},
/turf/open/floor/noslip/standard,
/area/shuttle/escape)
"Yl" = (
/obj/structure/table/glass/plasma,
/obj/item/storage/backpack/duffelbag/med/surgery,
/obj/item/storage/backpack/duffelbag/med/surgery{
	pixel_y = 6
	},
/turf/open/floor/noslip/blue,
/area/shuttle/escape)
"Zy" = (
/obj/structure/chair/shuttlecraft_chair{
	dir = 8;
	pixel_x = 8
	},
/obj/machinery/light/floor,
/turf/open/floor/noslip/white,
/area/shuttle/escape)
"ZM" = (
/obj/machinery/light/floor,
/turf/open/floor/noslip/standard,
/area/shuttle/escape)
"ZX" = (
/obj/structure/extinguisher_cabinet/south,
/turf/open/floor/noslip/dark,
/area/shuttle/escape)

(1,1,1) = {"
yU
yU
ti
pI
Dk
Dk
Dk
Dk
pI
ti
QN
yU
yU
VG
yU
yU
yU
yU
yU
yU
yU
yU
yU
yU
yU
yU
"}
(2,1,1) = {"
yU
yU
pI
ZM
ev
ev
ev
ev
ZM
Dk
Dk
oA
Dk
ti
QN
yU
yU
VG
yU
yU
yU
yU
yU
yU
yU
yU
"}
(3,1,1) = {"
yU
yU
oA
sT
Aj
Aj
Aj
Aj
sT
Dk
DJ
xM
vv
Dk
Dk
Dk
Dk
ti
QN
yU
yU
VG
yU
yU
yU
yU
"}
(4,1,1) = {"
yU
yU
pI
ZM
Tz
IH
IH
IH
ZM
Dk
DJ
KC
vv
Dk
dL
dL
dL
Dk
Dk
oA
oA
ti
QN
yU
yU
yU
"}
(5,1,1) = {"
yU
yU
Dk
ti
IV
sT
IV
sT
IV
Dk
DJ
KC
vv
Dk
lx
Jc
pp
Dk
QZ
oy
Pm
Dk
Dk
Dk
Dk
Dk
"}
(6,1,1) = {"
yU
yU
Da
Dk
sT
BX
rr
IG
VU
Dk
KC
KC
ly
Dk
FH
FH
iq
Dk
ua
TD
TD
oy
oy
vK
gX
oA
"}
(7,1,1) = {"
yU
yU
Da
Dk
uh
Ft
Ii
BG
IV
Qp
xM
KC
xM
Tv
yq
FH
yq
jo
cq
TD
cq
TD
cq
vK
wr
oA
"}
(8,1,1) = {"
yU
yU
Da
Dk
sT
tJ
ka
xh
VU
Dk
KC
KC
ky
Dk
FH
FH
cr
Dk
Hr
TD
TD
Ey
Ey
vK
Ov
oA
"}
(9,1,1) = {"
yU
yU
Dk
ti
IV
sT
IV
sT
IV
Dk
DJ
KC
Yl
Dk
NR
yq
ZX
Dk
zL
Ey
Zy
Dk
Dk
Dk
Dk
Dk
"}
(10,1,1) = {"
yU
yU
pI
ZM
Sm
Aj
Aj
Aj
ZM
Dk
DJ
KC
tA
Dk
qt
qt
qt
Dk
Dk
oA
oA
ti
QN
yU
yU
yU
"}
(11,1,1) = {"
yU
yU
oA
sT
IH
IH
IH
IH
sT
Dk
DJ
xM
wn
Dk
Dk
Dk
Dk
ti
QN
yU
yU
NH
yU
yU
yU
yU
"}
(12,1,1) = {"
yU
yU
IC
ZM
Wo
Wo
Wo
Wo
ZM
Dk
Dk
oA
Dk
ti
QN
yU
yU
NH
yU
yU
yU
yU
yU
yU
yU
yU
"}
(13,1,1) = {"
yU
yU
ti
pI
Dk
Dk
Dk
Dk
pI
ti
QN
yU
yU
NH
yU
yU
yU
yU
yU
yU
yU
yU
yU
yU
yU
yU
"}
