//MAP CONVERTED BY dmm2tgm.py THIS HEADER COMMENT PREVENTS RECONVERSION, DO NOT REMOVE
"a" = (
/turf/template_noop,
/area/template_noop)
"c" = (
/obj/structure/shuttle/engine/propulsion/burst/right,
/obj/effect/turf_decal/stripes/line,
/turf/open/floor/plating/airless,
/area/shuttle/supply)
"e" = (
/obj/effect/spawner/structure/window/shuttle,
/obj/structure/shuttle/engine/heater,
/turf/open/floor/plating,
/area/shuttle/supply)
"h" = (
/obj/effect/turf_decal/tile/brown,
/obj/effect/turf_decal/tile/brown{
	dir = 1
	},
/obj/effect/turf_decal,
/turf/open/floor/mineral/titanium/yellow,
/area/shuttle/supply)
"i" = (
/obj/effect/turf_decal/tile/brown,
/obj/effect/turf_decal/tile/brown{
	dir = 1
	},
/obj/effect/turf_decal{
	dir = 6
	},
/turf/open/floor/mineral/titanium/yellow,
/area/shuttle/supply)
"k" = (
/obj/structure/shuttle/engine/propulsion/burst/left,
/obj/effect/turf_decal/stripes/line,
/turf/open/floor/plating/airless,
/area/shuttle/supply)
"m" = (
/obj/effect/turf_decal/tile/brown,
/obj/effect/turf_decal/tile/brown{
	dir = 1
	},
/turf/open/floor/mineral/titanium/yellow,
/area/shuttle/supply)
"r" = (
/obj/structure/shuttle/engine/propulsion,
/obj/effect/turf_decal/stripes/line,
/turf/open/floor/plating/airless,
/area/shuttle/supply)
"s" = (
/obj/effect/turf_decal/tile/brown,
/obj/effect/turf_decal/tile/brown{
	dir = 1
	},
/obj/effect/turf_decal{
	dir = 8
	},
/turf/open/floor/mineral/titanium/yellow,
/area/shuttle/supply)
"v" = (
/obj/structure/fans/tiny,
/obj/machinery/door/airlock/shuttle{
	name = "Supply Shuttle Airlock";
	req_one_access_txt = "31;69"
	},
/turf/open/floor/mineral/plastitanium,
/area/shuttle/supply)
"y" = (
/obj/effect/turf_decal/tile/brown,
/obj/effect/turf_decal/tile/brown{
	dir = 1
	},
/obj/effect/turf_decal{
	dir = 9
	},
/turf/open/floor/mineral/titanium/yellow,
/area/shuttle/supply)
"C" = (
/obj/effect/turf_decal{
	dir = 8
	},
/obj/effect/turf_decal{
	dir = 4
	},
/obj/effect/turf_decal,
/turf/open/floor/mineral/plastitanium,
/area/shuttle/supply)
"D" = (
/obj/structure/fans/tiny,
/obj/machinery/door/airlock/shuttle{
	name = "Supply Shuttle Airlock";
	req_one_access_txt = "31;69"
	},
/obj/docking_port/mobile/supply{
	dir = 4;
	dwidth = 3;
	width = 13
	},
/turf/open/floor/mineral/plastitanium,
/area/shuttle/supply)
"F" = (
/obj/effect/turf_decal/tile/brown,
/obj/effect/turf_decal/tile/brown{
	dir = 1
	},
/obj/effect/turf_decal{
	dir = 1
	},
/turf/open/floor/mineral/titanium/yellow,
/area/shuttle/supply)
"H" = (
/obj/machinery/door/airlock/shuttle{
	name = "Supply Shuttle Airlock";
	req_one_access_txt = "31;69"
	},
/obj/structure/fans/tiny,
/turf/open/floor/mineral/plastitanium,
/area/shuttle/supply)
"I" = (
/obj/effect/turf_decal{
	dir = 8
	},
/obj/effect/turf_decal{
	dir = 4
	},
/turf/open/floor/mineral/plastitanium,
/area/shuttle/supply)
"J" = (
/obj/effect/turf_decal/tile/brown,
/obj/effect/turf_decal/tile/brown{
	dir = 1
	},
/obj/effect/turf_decal{
	dir = 4
	},
/turf/open/floor/mineral/titanium/yellow,
/area/shuttle/supply)
"O" = (
/obj/effect/turf_decal/tile/brown,
/obj/effect/turf_decal/tile/brown{
	dir = 1
	},
/obj/effect/turf_decal{
	dir = 5
	},
/turf/open/floor/mineral/titanium/yellow,
/area/shuttle/supply)
"P" = (
/obj/effect/spawner/structure/window/shuttle,
/turf/open/floor/plating,
/area/shuttle/supply)
"T" = (
/turf/closed/wall/mineral/titanium,
/area/shuttle/supply)
"W" = (
/obj/effect/turf_decal/tile/brown,
/obj/effect/turf_decal/tile/brown{
	dir = 1
	},
/obj/effect/turf_decal{
	dir = 10
	},
/turf/open/floor/mineral/titanium/yellow,
/area/shuttle/supply)
"Z" = (
/obj/effect/turf_decal{
	dir = 8
	},
/obj/effect/turf_decal{
	dir = 4
	},
/obj/effect/turf_decal{
	dir = 1
	},
/turf/open/floor/mineral/plastitanium,
/area/shuttle/supply)

(1,1,1) = {"
T
T
v
D
T
H
H
T
H
H
T
T
a
"}
(2,1,1) = {"
T
y
s
s
s
s
s
s
s
s
W
T
k
"}
(3,1,1) = {"
P
F
m
m
m
m
m
m
m
m
h
e
r
"}
(4,1,1) = {"
P
F
m
Z
I
I
I
I
C
m
h
e
r
"}
(5,1,1) = {"
P
F
m
m
m
m
m
m
m
m
h
e
r
"}
(6,1,1) = {"
T
O
J
J
J
J
J
J
J
J
i
T
c
"}
(7,1,1) = {"
T
T
T
T
P
P
P
P
T
T
T
T
a
"}
