"a" = (/turf/open/space/basic,/area/space)
"b" = (/turf/closed/wall,/area/space)
"c" = (/turf/open/floor/plasteel,/area/space)
"d" = (/obj/structure/rack,/turf/open/floor/plasteel,/area/space)
"e" = (/obj/machinery/door/airlock/highsecurity{name = "Spacial Equipment"},/turf/open/floor/plasteel,/area/space)
"f" = (/obj/machinery/door/airlock/security{name = "Holding Cell"},/turf/open/floor/plasteel,/area/space)
"g" = (/obj/machinery/door/airlock/security/glass{name = "Riot-Equipment"},/turf/open/floor/plasteel,/area/space)
"h" = (/obj/structure/tank_dispenser/oxygen,/turf/open/floor/plasteel,/area/space)
"i" = (/obj/structure/table,/turf/open/floor/plasteel,/area/space)
"j" = (/turf/closed/wall/r_wall,/area/space)
"k" = (/obj/effect/spawner/structure/window/reinforced,/turf/open/floor/plating,/area/space)
"l" = (/obj/machinery/door/airlock/security/glass{name = "Space-Police"},/turf/open/floor/plasteel,/area/space)
"m" = (/obj/structure/chair/office{dir = 8},/turf/open/floor/plasteel,/area/space)
"n" = (/obj/structure/lattice,/turf/open/space/basic,/area/space)
"o" = (/turf/closed/mineral/random,/area/space)
"p" = (/obj/structure/toilet,/turf/open/floor/plasteel,/area/space)
"q" = (/obj/machinery/shower{dir = 4},/turf/open/floor/plasteel,/area/space)
"r" = (/obj/machinery/shower{dir = 8},/turf/open/floor/plasteel,/area/space)
"s" = (/obj/structure/door_assembly,/turf/open/floor/plasteel,/area/space)
"t" = (/obj/machinery/door/window/southleft,/turf/open/floor/plasteel,/area/space)
"u" = (/obj/machinery/door/window/southright,/turf/open/floor/plasteel,/area/space)
"v" = (/turf/closed/mineral/bananium,/area/space)
"w" = (/obj/structure/grille,/turf/open/floor/plating,/area/space)
"x" = (/turf/open/floor/holofloor/asteroid,/area/space)
"y" = (/obj/structure/holosign/barrier,/turf/open/floor/plasteel,/area/space)
"z" = (/obj/structure/grille/broken,/turf/open/floor/plating,/area/space)
"A" = (/obj/structure/mineral_door/sandstone,/turf/open/floor/holofloor/asteroid,/area/space)
"B" = (/turf/open/floor/plating,/area/space)
"C" = (/obj/structure/janitorialcart{dir = 4},/turf/open/floor/plating,/area/space)
"D" = (/obj/structure/sink{dir = 4; pixel_x = 11},/turf/open/floor/plating,/area/space)
"E" = (/obj/structure/table,/obj/item/soap,/obj/item/reagent_containers/spray/cleaner,/turf/open/floor/plating,/area/space)
"F" = (/obj/item/reagent_containers/glass/bucket,/obj/item/mop,/obj/structure/table,/turf/open/floor/plating,/area/space)
"G" = (/obj/structure/chair{dir = 4},/turf/open/floor/plasteel,/area/space)
"H" = (/obj/structure/table/glass,/turf/open/floor/plasteel,/area/space)
"I" = (/obj/structure/chair{dir = 8},/turf/open/floor/plasteel,/area/space)
"J" = (/obj/structure/sink/kitchen{pixel_y = 32},/turf/open/floor/plasteel,/area/space)
"K" = (/obj/structure/table/reinforced,/turf/open/floor/plating,/area/space)

(1,1,1) = {"
aaaaaaaaaaaaaaaaaaaaaaaaaaaaaaaaaaaaaaaa
aaaaaaaaaaaaaaaaaaaaaaaaaaaaaaaaaaaaaaaa
aaaaaaaaaaaaaaaaaaaaaaaaaaaaaaaaaaaaaaaa
aaaaaaaaaaaaaaaaaaaaaaaaaaaaaaaaaaaaaaaa
aaaaaaabbbbbbbbbbbbbbbbbbbbbbbaaaaaaaaaa
aaaaaaabcccccccccccccccccccccbaaaaaaaaaa
aaaaaaabcccccccccccccccccccccbaaaaaaaaaa
aaaaaaabccbbbbbbbbbbbbbbbbbccbaaaaaaaaaa
aaaaaaabccbccccbdddddbccccbccbaaaaaaaaaa
aaaaaaabccbccccbccccceccccbccbaaaaaaaaaa
aaaaaaabccbbfbbbccccdbccccbccbaaaaaaaaaa
aaaaaaabccbccccgccdddbccchbccbaaaaaaaaaa
aaaaaaabccbcciijjkkkjjkkkjjccbaaaaaaaaaa
aaaaaaabcclccimjaananaanaajccbaaaaaaaaaa
aaaaaaabccbccccjaanaoaanaajccbaaaaaaaaaa
aaaaaaabccbbbbbjaaooooanaajccbaaaaaaaaaa
aaaaaaabccbpbqrjnoooooonnnjccbaaaaaaaaaa
aaaaaaabccbsbtujoovvvvooaakccbaaaaaaaaaa
aaaaaaabccbccccwoovxxxooonkccbaaaaaaaaaa
aaaaaaabccycccczAxxxxxoooakccbaaaaaaaaaa
aaaaaaabccbcccckoovxxvooaakccbaaaaaaaaaa
aaaaaaabccbbbbBjaoooooonnnjccbaaaaaaaaaa
aaaaaaabccbCDbBjnnooooanaajccbaaaaaaaaaa
aaaaaaabccbBBBBjanannaanaajccbaaaaaaaaaa
aaaaaaabccbEFbBjkkjjkkjjkkjccbaaaaaaaaaa
aaaaaaabccbbbbBbcGHHIcbJccbccbaaaaaaaaaa
aaaaaaabccbBBBBBcGHHIcKcccbccbaaaaaaaaaa
aaaaaaabccbBBbbbcGHHIcKcccbccbaaaaaaaaaa
aaaaaaabccbBBBBbccccccKcccbccbaaaaaaaaaa
aaaaaaabccbBBBBbHIcGHIbcccbccbaaaaaaaaaa
aaaaaaabccbbbbbbbbcbbbbbcbbccbaaaaaaaaaa
aaaaaaabcccccccccccccccccccccbaaaaaaaaaa
aaaaaaabcccccccccccccccccccccbaaaaaaaaaa
aaaaaaabbbbbbbbbbbbbbbbbbbbbbbaaaaaaaaaa
aaaaaaaaaaaaaaaaaaaaaaaaaaaaaaaaaaaaaaaa
aaaaaaaaaaaaaaaaaaaaaaaaaaaaaaaaaaaaaaaa
aaaaaaaaaaaaaaaaaaaaaaaaaaaaaaaaaaaaaaaa
aaaaaaaaaaaaaaaaaaaaaaaaaaaaaaaaaaaaaaaa
aaaaaaaaaaaaaaaaaaaaaaaaaaaaaaaaaaaaaaaa
aaaaaaaaaaaaaaaaaaaaaaaaaaaaaaaaaaaaaaaa
"}
