"a" = (/turf/open/floor/mineral/plastitanium/airless,/area/shuttle/syndicate)
"m" = (/obj/docking_port/mobile/elevator{dir = 8; dwidth = 1; height = 3; id = "hammurabielevator"; width = 3},/obj/machinery/atmospherics/pipe/simple/supply/hidden{dir = 5},/obj/machinery/atmospherics/pipe/simple/scrubbers/hidden/layer3{dir = 6},/turf/open/floor/mineral/plastitanium/airless,/area/shuttle/syndicate)
"O" = (/obj/machinery/computer/shuttle{density = 0; desc = "A panel that allows you to operate an elevator."; dir = 4; icon = 'icons/obj/turbolift.dmi'; icon_state = "panel"; name = "elevator controls"; no_destination_swap = 1; pixel_x = -32; possible_destinations = "hammurabi_down;hammurabi_up"; shuttleId = "hammurabielevator"},/turf/open/floor/mineral/plastitanium/airless,/area/shuttle/syndicate)
"P" = (/obj/machinery/atmospherics/components/unary/vent_pump/on,/turf/open/floor/mineral/plastitanium/airless,/area/shuttle/syndicate)
"T" = (/obj/machinery/atmospherics/components/unary/vent_scrubber/on/layer3{dir = 1},/turf/open/floor/mineral/plastitanium/airless,/area/shuttle/syndicate)

(1,1,1) = {"
aaP
Oam
aaT
"}
