"a" = (/turf/open/floor/mineral/plastitanium/airless,/area/shuttle/syndicate)
"m" = (/obj/docking_port/mobile/elevator{dir = 8; dwidth = 1; height = 3; id = "hammurabielevator"; width = 3},/turf/open/floor/mineral/plastitanium/airless,/area/shuttle/syndicate)
"O" = (/obj/machinery/computer/shuttle{density = 0; desc = "A panel that allows you to operate an elevator."; dir = 4; icon = 'icons/obj/turbolift.dmi'; icon_state = "panel"; name = "elevator controls"; no_destination_swap = 1; pixel_x = -32; possible_destinations = "hammurabi_down;hammurabi_up"; shuttleId = "hammurabielevator"},/turf/open/floor/mineral/plastitanium/airless,/area/shuttle/syndicate)

(1,1,1) = {"
aaa
Oam
aaa
"}
