"g" = (/turf/closed/mineral,/area/ruin/powered)
"m" = (/turf/template_noop,/area/template_noop)
"o" = (/obj/effect/decal/cleanable/blood/tracks{dir = 10},/turf/open/floor/plating/asteroid/snow/airless,/area/ruin/powered)
"p" = (/obj/effect/decal/cleanable/blood/tracks{dir = 1},/turf/open/floor/plating/asteroid/snow/airless,/area/ruin/powered)
"q" = (/obj/effect/decal/cleanable/blood,/obj/effect/decal/cleanable/blood/gibs/up,/turf/open/floor/plating/asteroid/snow/airless,/area/ruin/powered)
"t" = (/obj/structure/bonfire/prelit,/turf/open/floor/plating/snowed/colder,/area/ruin/powered)
"v" = (/obj/machinery/door/airlock/freezer,/obj/structure/fans/tiny/invisible,/turf/open/floor/plating/snowed,/area/ruin/powered)
"y" = (/obj/item/clothing/glasses/cold,/turf/open/floor/plating/snowed/colder,/area/ruin/powered)
"B" = (/obj/vehicle/ridden/atv{dir = 4},/turf/open/floor/plating/snowed/colder,/area/ruin/powered)
"C" = (/turf/open/floor/plating/asteroid/snow/airless,/area/ruin/powered)
"H" = (/turf/closed/wall/mineral/snow,/area/ruin/powered)
"K" = (/turf/open/floor/plating/snowed/colder,/area/ruin/powered)
"L" = (/mob/living/simple_animal/hostile/skeleton/eskimo,/turf/open/floor/plating/snowed/colder,/area/ruin/powered)
"T" = (/obj/effect/decal/cleanable/blood/gibs/limb,/obj/effect/decal/cleanable/blood/gibs/limb{dir = 4},/turf/open/floor/plating/snowed/colder,/area/ruin/powered)
"Y" = (/obj/effect/decal/cleanable/blood/tracks{dir = 8},/obj/item/key{desc = "A small grey key meant to be placed inside a vehicle. There is nothing special about this key at all besides that.";name = "ATV key"},/turf/open/floor/plating/asteroid/snow/airless,/area/ruin/powered)

(1,1,1) = {"
mmmmmmmmmmmmmmmmmmmmmmmmmmmmmmmmmmmmmmmm
mmmmmmmmmmmmmmmmmmmmmmmmmmmmmmmmmmmmmmmm
mmmmmmmmmmmmmmmmmmmmmmmmmmmmmmmmmmmmmmmm
mmmmmmmmmmmmmmmmmmmmmmmmmmmmmmmmmmmmmmmm
mmmmmmmmmmmmmmmmmmmmmmmmmmmmmmmmmmmmmmmm
mmmmmmmmmmmmmmmggggggmmmmmmmmmmmmmmmmmmm
mmmmmmmmmmmmmggggggggggmmmmmmmmmmmmmmmmm
mmmmmmmmmmmmgggggggggggggmmmmmmmmmmmmmmm
mmmmmmmmmmmggCCCCCCCgggggggmmmmmmmmmmmmm
mmmmmmmmmmggCCHHHHHCCgggggggmmmmmmmmmmmm
mmmmmmmmmggCCHHKKBHHCCgggggggmmmmmmmmmmm
mmmmmmmmggCCHHKLKyKHHCCggggggggmmmmmmmmm
mmmmmmmmggCHHKKTtKKLHHCgggggggggmmmmmmmm
mmmmmmggggCCHHKKKKKHHCCgggggggggmmmmmmmm
mmmmmmgggggCCHHKKKHHCCgggggggggggmmmmmmm
mmmmmmggggggCCHHvHHCCggggggggggggmmmmmmm
mmmmgggggggggCCCpCCCgggggggggggggmmmmmmm
mmmmgggggggggCCCoYqCgggggggggggggmmmmmmm
mmmgggggggggggCCCCCggggggggggggggmmmmmmm
mmgggggggggggggggggggggggggggggggmmmmmmm
mmgggggggggggggggggggggggggggggggmmmmmmm
mmgggggggggggggggggggggggggggggggmmmmmmm
mmggggggggggggggggggggggggggggggmmmmmmmm
mmggggggggggggggggggggggggggggggmmmmmmmm
mmgggggggggggggggggggggggggggggmmmmmmmmm
mmgggggggggggggggggggggggggggggmmmmmmmmm
mmmgggggggggggggggggggggggggggmmmmmmmmmm
mmmmgggggggggggggggggggggggmmmmmmmmmmmmm
mmmmmmgggggggggggggggggggmmmmmmmmmmmmmmm
mmmmmmmmgggggggggggggggmmmmmmmmmmmmmmmmm
mmmmmmmmmmmggggggggggmmmmmmmmmmmmmmmmmmm
mmmmmmmmmmmmggggggggmmmmmmmmmmmmmmmmmmmm
mmmmmmmmmmmmmmmmmmmmmmmmmmmmmmmmmmmmmmmm
mmmmmmmmmmmmmmmmmmmmmmmmmmmmmmmmmmmmmmmm
mmmmmmmmmmmmmmmmmmmmmmmmmmmmmmmmmmmmmmmm
mmmmmmmmmmmmmmmmmmmmmmmmmmmmmmmmmmmmmmmm
mmmmmmmmmmmmmmmmmmmmmmmmmmmmmmmmmmmmmmmm
mmmmmmmmmmmmmmmmmmmmmmmmmmmmmmmmmmmmmmmm
mmmmmmmmmmmmmmmmmmmmmmmmmmmmmmmmmmmmmmmm
mmmmmmmmmmmmmmmmmmmmmmmmmmmmmmmmmmmmmmmm
"}
