//MAP CONVERTED BY dmm2tgm.py THIS HEADER COMMENT PREVENTS RECONVERSION, DO NOT REMOVE
"a" = (
/obj/structure/flora/ash/cap_shroom,
/turf/open/floor/plating/asteroid,
/area/ruin/unpowered)
"b" = (
/turf/template_noop,
/area/template_noop)
"d" = (
/obj/structure/flora/ash/stem_shroom,
/turf/open/floor/plating/asteroid/airless,
/area/ruin/unpowered)
"e" = (
/obj/structure/flora/ash/leaf_shroom,
/turf/open/floor/plating/asteroid/airless,
/area/ruin/unpowered)
"g" = (
/obj/item/stack/sheet/iron,
/turf/template_noop,
/area/template_noop)
"h" = (
/turf/closed/mineral/random,
/area/ruin/unpowered)
"i" = (
/turf/closed/wall/mineral/plastitanium,
/area/ruin/unpowered)
"j" = (
/turf/closed/wall/mineral/plastitanium/nodiagonal,
/area/ruin/unpowered)
"k" = (
/turf/closed/mineral/random/high_chance,
/area/ruin/unpowered)
"l" = (
/obj/structure/shuttle/engine/propulsion/burst{
	dir = 8
	},
/turf/closed/wall/mineral/plastitanium,
/area/ruin/unpowered)
"m" = (
/mob/living/simple_animal/hostile/carp,
/turf/template_noop,
/area/template_noop)
"n" = (
/obj/effect/decal/cleanable/dirt,
/obj/structure/frame/computer,
/obj/item/shard,
/obj/effect/decal/cleanable/dirt,
/turf/open/floor/mineral/plastitanium/airless,
/area/ruin/unpowered)
"o" = (
/obj/effect/decal/cleanable/dirt,
/obj/structure/door_assembly/door_assembly_hatch{
	density = 0;
	name = "broken airlock"
	},
/turf/open/floor/plating/airless,
/area/ruin/unpowered)
"p" = (
/obj/effect/decal/cleanable/blood,
/obj/effect/decal/cleanable/dirt,
/obj/effect/decal/cleanable/dirt,
/obj/structure/chair/comfy/shuttle{
	dir = 4
	},
/turf/open/floor/mineral/plastitanium/airless,
/area/ruin/unpowered)
"q" = (
/obj/effect/decal/cleanable/dirt,
/obj/effect/decal/cleanable/dirt,
/obj/structure/fluff/broken_flooring{
	icon_state = "singular"
	},
/obj/effect/decal/cleanable/blood,
/obj/effect/decal/cleanable/dirt,
/turf/open/floor/plating/airless,
/area/ruin/unpowered)
"r" = (
/obj/structure/lattice,
/turf/template_noop,
/area/ruin/unpowered)
"s" = (
/obj/structure/girder/displaced,
/turf/template_noop,
/area/template_noop)
"t" = (
/obj/effect/gibspawner/human,
/turf/open/floor/plating/asteroid/airless,
/area/template_noop)
"u" = (
/obj/item/stack/cable_coil/yellow{
	amount = 1
	},
/turf/open/floor/plating/airless{
	icon_state = "platingdmg3"
	},
/area/ruin/unpowered)
"v" = (
/obj/effect/decal/cleanable/dirt,
/turf/open/floor/plating/airless{
	icon_state = "platingdmg1"
	},
/area/ruin/unpowered)
"w" = (
/obj/item/stack/sheet/mineral/plastitanium,
/turf/template_noop,
/area/template_noop)
"x" = (
/obj/item/wallframe/camera,
/turf/template_noop,
/area/template_noop)
"y" = (
/obj/structure/fluff/broken_flooring{
	dir = 4;
	icon_state = "plating"
	},
/turf/template_noop,
/area/ruin/unpowered)
"z" = (
/turf/open/floor/plating/asteroid/airless,
/area/ruin/unpowered)
"A" = (
/obj/item/stack/rods,
/turf/template_noop,
/area/template_noop)
"B" = (
/obj/item/stack/sheet/iron,
/turf/open/floor/plating/asteroid/airless,
/area/ruin/unpowered)
"C" = (
/turf/closed/mineral,
/area/ruin/unpowered)
"D" = (
/obj/structure/flora/ash/stem_shroom,
/turf/open/floor/plating/asteroid,
/area/ruin/unpowered)
"E" = (
/turf/closed/wall,
/area/ruin/unpowered)
"F" = (
/turf/closed/wall/rust,
/area/ruin/unpowered)
"G" = (
/obj/structure/flora/ash/tall_shroom,
/turf/open/floor/plating/asteroid/airless,
/area/ruin/unpowered)
"H" = (
/turf/open/floor/plating,
/area/ruin/unpowered)
"I" = (
/obj/structure/closet/crate,
/turf/open/floor/plating,
/area/ruin/unpowered)
"J" = (
/obj/effect/spawner/lootdrop/crate_spawner,
/turf/open/floor/plating,
/area/ruin/unpowered)
"M" = (
/obj/structure/barricade/wooden,
/obj/structure/door_assembly,
/turf/open/floor/plating,
/area/ruin/unpowered)
"N" = (
/obj/structure/table,
/obj/item/storage/toolbox/electrical,
/turf/open/floor/plating,
/area/ruin/unpowered)
"O" = (
/obj/structure/closet/crate,
/obj/effect/spawner/lootdrop/maintenance,
/turf/open/floor/plating,
/area/ruin/unpowered)
"P" = (
/obj/effect/decal/remains/human,
/turf/open/floor/plating,
/area/ruin/unpowered)
"Q" = (
/obj/structure/table,
/obj/item/storage/toolbox/syndicate,
/turf/open/floor/plating,
/area/ruin/unpowered)
"R" = (
/obj/structure/table,
/turf/open/floor/plating,
/area/ruin/unpowered)
"S" = (
/obj/structure/flora/ash/tall_shroom,
/turf/open/floor/plating/asteroid,
/area/ruin/unpowered)
"T" = (
/obj/structure/flora/ash/cacti,
/turf/open/floor/plating/asteroid/airless,
/area/ruin/unpowered)
"U" = (
/turf/open/floor/plating/asteroid,
/area/ruin/unpowered)
"V" = (
/obj/structure/barricade/wooden,
/turf/open/floor/plating,
/area/ruin/unpowered)
"W" = (
/obj/structure/barricade/wooden,
/obj/machinery/door/airlock/external,
/turf/open/floor/plating/asteroid/airless,
/area/ruin/unpowered)
"X" = (
/obj/machinery/door/airlock/external,
/turf/open/floor/plating,
/area/ruin/unpowered)
"Y" = (
/obj/structure/flora/ash/cap_shroom,
/turf/open/floor/plating/asteroid/airless,
/area/ruin/unpowered)

(1,1,1) = {"
b
b
b
b
b
m
b
b
b
b
b
b
b
b
b
b
b
b
b
b
b
b
b
b
b
b
b
b
b
b
b
b
b
b
b
b
b
b
b
b
"}
(2,1,1) = {"
b
b
b
b
b
b
b
b
b
b
b
b
b
b
b
b
b
b
b
b
b
b
b
b
b
b
b
b
b
b
b
b
b
b
b
b
b
b
b
b
"}
(3,1,1) = {"
b
b
b
b
b
b
b
b
b
b
b
b
b
b
b
b
b
b
b
b
b
b
b
e
z
z
z
b
b
b
b
b
b
b
b
b
C
b
b
b
"}
(4,1,1) = {"
b
b
b
b
b
b
b
b
b
b
b
b
b
b
b
b
b
b
b
b
b
z
z
z
z
z
z
b
b
b
b
b
b
b
b
b
b
b
b
b
"}
(5,1,1) = {"
b
b
b
b
b
b
b
b
b
b
b
A
b
b
b
b
b
b
b
b
C
C
C
C
C
z
z
z
z
b
b
b
b
b
b
b
b
b
b
b
"}
(6,1,1) = {"
b
b
b
b
b
b
b
b
b
g
b
b
b
b
h
b
b
b
b
C
C
C
C
C
C
z
z
T
z
z
G
z
b
b
b
b
b
b
b
b
"}
(7,1,1) = {"
b
b
b
b
b
l
j
o
j
i
b
b
b
b
b
b
b
b
b
C
C
C
C
C
C
C
C
C
z
z
z
z
z
b
b
b
b
b
b
b
"}
(8,1,1) = {"
b
b
b
b
l
j
n
p
u
i
i
b
h
b
b
b
b
b
b
C
C
C
C
C
C
C
C
C
C
C
C
z
z
b
b
b
b
b
b
b
"}
(9,1,1) = {"
b
b
b
i
j
j
j
q
v
r
i
b
h
h
b
b
b
b
C
C
C
C
C
C
C
C
C
C
C
C
C
Y
z
z
z
b
b
b
b
b
"}
(10,1,1) = {"
b
b
b
j
i
b
i
r
r
b
y
b
b
b
b
h
b
b
C
C
C
C
C
C
C
C
C
C
C
C
C
C
z
z
z
b
b
b
b
b
"}
(11,1,1) = {"
b
b
b
i
b
b
b
s
b
r
w
A
b
b
b
b
b
b
C
C
C
C
C
C
C
C
C
C
C
C
C
C
z
z
z
z
z
b
b
b
"}
(12,1,1) = {"
b
b
g
b
b
b
b
b
w
b
z
B
h
h
b
b
b
b
C
C
C
C
C
C
C
F
F
E
F
E
E
E
C
C
z
z
d
b
b
b
"}
(13,1,1) = {"
b
b
h
h
b
b
b
b
x
h
z
h
h
h
h
h
b
b
C
C
C
C
C
C
H
J
J
P
H
F
H
H
C
C
z
z
z
b
b
b
"}
(14,1,1) = {"
b
h
h
h
b
b
b
t
h
h
e
h
h
h
h
h
b
b
b
b
C
C
C
E
H
H
H
H
I
F
H
H
E
C
z
z
z
b
b
b
"}
(15,1,1) = {"
b
b
b
b
b
b
b
h
h
h
h
h
h
h
h
h
h
b
b
b
C
C
C
E
H
H
N
Q
J
E
H
H
C
C
z
G
z
b
b
b
"}
(16,1,1) = {"
h
b
b
b
z
T
h
h
h
k
k
h
h
h
h
h
h
b
b
b
C
C
C
F
E
M
F
F
E
E
a
O
E
C
C
C
z
b
b
b
"}
(17,1,1) = {"
b
b
b
e
h
h
h
h
k
k
k
k
h
h
h
h
h
b
b
b
b
C
C
C
H
H
O
I
O
E
H
H
F
C
C
C
z
b
b
b
"}
(18,1,1) = {"
b
b
b
h
h
h
h
k
k
k
k
k
h
h
h
h
b
b
b
b
b
C
C
C
H
H
H
H
H
E
H
S
F
C
C
C
z
b
b
b
"}
(19,1,1) = {"
b
b
b
h
h
h
k
k
k
k
k
h
h
h
h
b
b
b
b
b
b
C
C
E
H
H
H
H
H
M
H
H
E
C
C
C
z
b
b
b
"}
(20,1,1) = {"
b
b
b
h
h
h
h
k
k
k
h
h
h
h
h
b
b
b
m
b
b
b
C
E
I
I
H
R
H
E
H
U
E
E
E
C
z
b
b
b
"}
(21,1,1) = {"
b
b
h
h
h
h
h
h
h
h
h
h
h
h
h
b
b
b
b
b
b
b
C
C
F
F
M
F
H
E
D
V
W
V
X
z
z
b
b
b
"}
(22,1,1) = {"
b
b
h
h
h
h
h
h
h
h
h
h
h
h
b
b
b
b
b
b
b
b
b
C
J
I
H
F
O
E
E
C
E
E
E
C
z
b
b
b
"}
(23,1,1) = {"
b
b
b
h
h
h
h
h
h
h
h
h
h
b
b
b
b
b
b
b
b
b
b
C
C
E
F
E
C
C
C
C
C
C
C
C
z
b
m
b
"}
(24,1,1) = {"
b
b
b
b
h
h
h
b
b
b
b
b
b
b
b
b
b
b
b
b
b
b
b
C
C
C
C
C
C
C
C
C
C
C
C
C
z
b
b
b
"}
(25,1,1) = {"
b
b
b
b
b
b
b
b
b
b
b
b
b
b
b
b
b
b
b
b
b
b
b
C
C
C
C
C
C
C
C
C
C
C
C
C
z
b
b
b
"}
(26,1,1) = {"
b
b
b
b
b
b
b
b
b
b
b
b
b
b
b
b
b
b
b
b
b
b
b
C
C
C
C
C
C
C
C
C
C
C
C
G
z
b
b
b
"}
(27,1,1) = {"
b
b
b
b
b
b
b
b
b
b
b
b
b
b
b
b
b
b
b
b
b
b
b
C
C
C
C
C
C
C
C
C
C
C
C
z
z
b
b
b
"}
(28,1,1) = {"
b
b
b
b
b
b
b
b
b
b
h
h
h
b
b
b
b
b
b
b
b
b
b
b
C
C
C
C
C
C
C
C
z
z
z
z
b
b
b
b
"}
(29,1,1) = {"
b
b
h
h
h
b
b
b
b
h
h
h
h
h
h
h
b
b
b
b
b
b
b
b
C
C
C
C
C
C
z
z
z
Y
z
b
b
b
b
b
"}
(30,1,1) = {"
b
h
h
h
h
h
b
b
h
h
h
h
h
h
h
z
z
b
b
b
b
b
b
b
b
h
h
h
h
b
b
b
b
b
b
b
b
b
b
b
"}
(31,1,1) = {"
b
h
h
h
h
h
b
b
h
h
h
h
h
z
Y
z
d
b
b
b
b
b
b
b
b
b
h
h
b
b
b
b
b
b
b
b
b
b
b
b
"}
(32,1,1) = {"
b
h
h
k
k
h
h
b
b
h
h
z
T
z
z
h
h
b
b
b
b
b
b
b
b
b
b
b
b
b
b
b
b
b
b
h
h
b
b
b
"}
(33,1,1) = {"
b
h
h
k
k
h
h
b
b
b
z
z
z
h
h
h
h
b
b
b
b
b
b
b
b
b
b
b
b
b
b
b
b
h
h
h
h
h
b
b
"}
(34,1,1) = {"
b
b
h
h
k
k
h
b
b
h
h
h
h
h
h
h
h
b
b
b
b
b
b
b
b
b
b
b
b
b
b
b
b
h
h
k
h
h
b
b
"}
(35,1,1) = {"
b
b
h
h
k
k
h
h
b
h
h
h
h
h
h
h
b
b
b
b
b
b
b
b
b
b
b
b
b
b
b
b
h
h
k
k
h
h
b
b
"}
(36,1,1) = {"
b
b
b
h
h
h
h
h
b
h
h
h
h
h
h
h
b
b
b
b
b
b
b
b
b
b
b
b
b
b
b
b
h
h
k
k
h
b
b
b
"}
(37,1,1) = {"
b
b
b
b
h
h
h
h
b
b
h
h
h
h
h
h
b
b
b
b
b
b
b
b
b
b
b
b
b
b
b
b
h
h
h
h
h
b
b
b
"}
(38,1,1) = {"
b
b
b
b
b
h
h
b
b
b
h
h
h
h
h
b
b
b
b
b
b
b
b
b
b
b
b
b
b
b
b
b
b
b
h
h
b
b
b
b
"}
(39,1,1) = {"
b
b
b
b
b
b
b
b
b
b
b
h
h
h
b
b
b
b
b
b
b
b
b
b
b
b
b
b
b
b
b
b
b
b
b
b
b
b
b
b
"}
(40,1,1) = {"
b
b
b
k
b
b
b
b
b
b
b
b
b
b
b
b
b
b
b
b
b
b
b
b
b
b
b
b
b
b
b
b
b
b
b
b
b
b
b
b
"}
