//MAP CONVERTED BY dmm2tgm.py THIS HEADER COMMENT PREVENTS RECONVERSION, DO NOT REMOVE
"a" = (
/turf/open/space/basic,
/area/space)
"b" = (
/obj/structure/sign/warning/radiation/rad_area{
	pixel_y = -32
	},
/turf/open/space/basic,
/area/space)
"c" = (
/turf/closed/mineral,
/area/ruin/powered)
"d" = (
/turf/closed/wall/steel,
/area/ruin/powered)
"e" = (
/obj/structure/sign/warning/radiation/rad_area{
	pixel_x = -32
	},
/turf/open/space/basic,
/area/space)
"f" = (
/obj/structure/sign/warning/radiation/rad_area{
	pixel_x = 32
	},
/turf/open/space/basic,
/area/space)
"g" = (
/turf/open/floor/monotile/airless,
/area/ruin/powered)
"h" = (
/obj/effect/decal/nuclear_waste,
/turf/open/floor/monotile/airless,
/area/ruin/powered)
"i" = (
/obj/structure/closet/radiation,
/turf/open/floor/monotile/airless,
/area/ruin/powered)
"j" = (
/obj/machinery/vending/tool,
/turf/open/floor/monotile/airless,
/area/ruin/powered)
"k" = (
/obj/machinery/vending/engivend,
/turf/open/floor/monotile/airless,
/area/ruin/powered)
"l" = (
/obj/machinery/door/airlock/ship/engineering,
/turf/open/floor/monotile/airless,
/area/ruin/powered)
"m" = (
/obj/machinery/light/broken,
/obj/structure/closet/crate,
/turf/open/floor/monotile/airless,
/area/ruin/powered)
"n" = (
/obj/structure/closet/crate,
/turf/open/floor/monotile/airless,
/area/ruin/powered)
"o" = (
/turf/open/floor/plating/asteroid/airless,
/area/ruin/powered)
"p" = (
/obj/effect/decal/nuclear_waste,
/turf/open/floor/plating/asteroid/airless,
/area/ruin/powered)
"q" = (
/obj/machinery/light/broken{
	dir = 4
	},
/turf/open/floor/monotile/airless,
/area/ruin/powered)
"r" = (
/turf/open/floor/engine/airless,
/area/ruin/powered)
"s" = (
/obj/effect/decal/nuclear_waste,
/turf/open/floor/engine/airless,
/area/ruin/powered)
"t" = (
/obj/machinery/smartfridge/drinks{
	desc = "Abandoned for ages. Could probably be used to store your beer.";
	icon = 'nsv13/goonstation/icons/reactor.dmi';
	icon_state = "broken";
	name = "Ruined stormdrive";
	pixel_x = -16
	},
/turf/open/floor/engine/airless,
/area/ruin/powered)
"u" = (
/obj/machinery/light/broken{
	dir = 4
	},
/turf/open/floor/engine/airless,
/area/ruin/powered)
"v" = (
/turf/open/floor/plating/airless,
/area/ruin/powered)
"w" = (
/obj/machinery/light/broken{
	dir = 8
	},
/turf/open/floor/monotile/airless,
/area/ruin/powered)
"x" = (
/obj/effect/spawner/structure/window/reinforced,
/turf/open/floor/plating,
/area/ruin/powered)
"y" = (
/obj/machinery/light/broken{
	dir = 1
	},
/turf/open/floor/monotile/airless,
/area/ruin/powered)
"z" = (
/obj/structure/frame,
/turf/open/floor/monotile/airless,
/area/ruin/powered)
"A" = (
/obj/machinery/door/airlock/ship/external{
	name = "Nuclear lab"
	},
/obj/effect/mapping_helpers/airlock/cyclelink_helper{
	dir = 4
	},
/turf/open/floor/plating/airless,
/area/ruin/powered)
"B" = (
/obj/structure/sign/warning/vacuum/external{
	pixel_y = 32
	},
/turf/open/floor/plating/airless,
/area/ruin/powered)
"C" = (
/obj/machinery/door/airlock/ship/external{
	name = "Nuclear lab"
	},
/obj/effect/mapping_helpers/airlock/cyclelink_helper{
	dir = 8
	},
/turf/open/floor/plating/airless,
/area/ruin/powered)
"D" = (
/obj/machinery/light/broken,
/turf/open/floor/monotile/airless,
/area/ruin/powered)
"E" = (
/obj/structure/sign/warning/radiation/rad_area{
	pixel_y = 32
	},
/turf/open/space/basic,
/area/space)

(1,1,1) = {"
a
a
a
a
a
a
a
a
a
a
a
a
a
a
a
a
a
a
a
a
a
a
a
a
a
a
a
a
a
a
a
a
a
a
a
a
a
a
a
a
"}
(2,1,1) = {"
a
a
a
a
a
a
a
a
a
a
a
a
a
a
a
a
a
a
a
a
a
a
a
a
a
a
a
a
a
a
a
a
a
a
a
a
a
a
a
a
"}
(3,1,1) = {"
a
a
a
a
a
a
a
a
a
a
a
a
a
a
a
a
a
a
a
a
a
a
a
a
a
a
a
a
a
a
a
a
a
a
a
a
a
a
a
a
"}
(4,1,1) = {"
a
a
a
a
a
a
a
a
a
a
a
a
a
a
a
a
a
a
a
a
a
a
a
c
c
c
a
f
a
f
a
a
a
a
a
a
a
a
a
a
"}
(5,1,1) = {"
a
a
a
a
a
a
a
a
a
a
a
a
a
a
a
a
a
a
a
a
f
a
c
c
c
c
c
d
A
d
c
a
a
a
a
a
a
a
a
a
"}
(6,1,1) = {"
a
a
a
a
a
a
a
a
a
a
a
a
a
a
a
a
a
a
c
c
d
c
c
c
c
c
c
d
B
d
c
c
a
a
a
a
a
a
a
a
"}
(7,1,1) = {"
a
a
a
a
a
a
a
a
a
a
a
a
a
a
a
a
c
c
c
c
c
c
c
c
c
c
d
d
C
d
d
c
c
a
a
a
a
a
a
a
"}
(8,1,1) = {"
a
a
a
a
a
a
a
a
a
a
a
a
a
f
a
a
c
c
c
c
c
c
c
c
c
c
d
i
g
g
d
c
d
E
a
a
a
a
a
a
"}
(9,1,1) = {"
a
a
a
a
a
a
a
a
a
a
c
c
c
d
c
c
c
c
c
c
c
c
c
c
c
c
d
d
g
g
d
c
c
a
a
a
a
a
a
a
"}
(10,1,1) = {"
a
a
a
a
a
a
a
a
a
a
c
c
c
c
d
d
d
d
d
d
d
d
d
d
d
d
d
h
g
h
d
c
c
c
a
a
a
a
a
a
"}
(11,1,1) = {"
a
a
a
a
a
a
a
a
a
c
c
c
c
c
d
g
g
g
h
g
g
g
h
h
g
w
g
g
g
D
d
c
c
c
c
a
a
a
a
a
"}
(12,1,1) = {"
a
a
a
a
a
a
a
a
c
c
c
c
c
c
d
h
g
h
g
g
h
g
g
g
g
g
g
h
g
g
d
c
c
c
c
c
a
a
a
a
"}
(13,1,1) = {"
a
a
a
a
a
a
a
c
c
c
c
c
c
c
d
h
g
g
g
g
q
g
g
g
g
h
g
g
g
h
d
c
c
c
c
d
E
a
a
a
"}
(14,1,1) = {"
a
a
a
a
a
a
a
c
c
c
c
c
c
c
d
d
l
d
d
d
d
d
d
d
v
v
d
g
h
g
d
c
c
c
c
c
c
a
a
a
"}
(15,1,1) = {"
a
a
a
a
a
a
b
d
c
c
c
c
c
c
d
i
g
h
d
c
c
c
c
c
o
o
d
g
g
g
d
c
c
c
c
c
c
a
a
a
"}
(16,1,1) = {"
a
a
a
a
a
a
a
c
c
c
c
c
c
c
d
j
g
m
d
c
c
c
o
o
o
o
d
h
g
h
d
c
c
c
c
c
c
c
a
a
"}
(17,1,1) = {"
a
a
a
a
a
a
a
c
c
c
c
c
c
c
d
k
g
n
d
c
c
o
p
o
o
o
x
h
g
g
d
c
c
c
c
c
c
c
c
a
"}
(18,1,1) = {"
a
a
a
a
a
a
a
c
c
c
c
c
c
c
d
d
d
d
d
c
d
o
o
o
p
o
x
h
h
g
d
c
c
c
c
c
c
c
c
a
"}
(19,1,1) = {"
a
a
a
a
a
a
a
a
c
c
c
c
c
c
c
c
c
c
c
o
d
r
r
r
r
r
d
y
g
g
d
c
c
c
c
c
c
c
c
a
"}
(20,1,1) = {"
a
a
a
a
a
a
a
a
c
c
c
c
c
c
c
c
c
c
o
o
o
s
r
r
r
r
d
g
g
h
d
c
c
c
c
c
c
d
E
a
"}
(21,1,1) = {"
a
a
a
a
a
a
a
a
a
c
c
c
c
c
c
c
c
c
o
o
o
r
r
t
r
r
v
g
g
h
d
c
c
c
c
c
c
c
c
a
"}
(22,1,1) = {"
a
a
a
a
a
a
a
a
b
d
c
c
c
c
c
c
c
c
o
p
o
r
r
r
r
s
d
g
h
g
d
c
c
c
c
c
c
c
c
a
"}
(23,1,1) = {"
a
a
a
a
a
a
a
a
a
c
c
c
c
c
c
c
c
c
o
o
d
r
r
u
r
r
x
g
g
g
d
c
c
c
c
c
c
c
c
a
"}
(24,1,1) = {"
a
a
a
a
a
a
a
a
c
c
c
c
c
c
c
c
c
c
c
c
d
o
o
d
o
d
d
h
h
g
d
c
c
c
c
c
c
c
c
a
"}
(25,1,1) = {"
a
a
a
a
a
a
a
a
c
c
c
c
c
c
c
c
c
c
c
c
c
o
o
o
o
c
d
g
g
D
d
c
c
c
c
c
c
c
d
E
"}
(26,1,1) = {"
a
a
a
a
a
a
a
c
c
c
c
c
c
c
c
c
c
c
c
c
o
o
o
o
o
c
d
h
g
h
d
c
c
c
c
c
c
c
c
a
"}
(27,1,1) = {"
a
a
a
a
a
a
c
c
c
c
c
c
c
c
c
c
c
c
c
c
o
o
o
c
c
c
d
g
g
h
d
c
c
c
c
c
c
c
c
a
"}
(28,1,1) = {"
a
a
a
a
a
b
d
c
c
c
c
c
c
c
c
c
c
c
c
c
o
o
c
c
c
c
d
h
g
g
d
c
c
c
c
c
c
c
a
a
"}
(29,1,1) = {"
a
a
a
a
a
a
c
c
c
c
c
c
c
c
c
c
c
c
c
c
c
c
c
c
c
c
d
g
g
g
d
c
c
c
c
c
c
a
a
a
"}
(30,1,1) = {"
a
a
a
a
a
a
a
c
c
c
c
c
c
c
c
c
c
c
c
c
c
c
c
c
c
c
d
z
n
h
d
c
c
c
c
d
E
a
a
a
"}
(31,1,1) = {"
a
a
a
a
a
a
a
a
c
c
c
c
c
c
c
c
c
c
c
c
c
c
c
c
c
c
d
d
d
d
d
c
c
c
c
c
a
a
a
a
"}
(32,1,1) = {"
a
a
a
a
a
a
a
a
c
c
c
c
c
c
c
c
c
c
c
c
c
c
c
c
c
c
c
c
c
c
c
c
c
c
c
a
a
a
a
a
"}
(33,1,1) = {"
a
a
a
a
a
a
a
a
a
c
c
c
c
c
c
c
c
c
c
c
c
c
c
c
c
c
c
c
c
c
c
c
c
a
a
a
a
a
a
a
"}
(34,1,1) = {"
a
a
a
a
a
a
a
a
a
a
c
c
c
c
c
c
c
c
c
c
c
c
c
c
c
c
c
c
c
c
c
c
a
a
a
a
a
a
a
a
"}
(35,1,1) = {"
a
a
a
a
a
a
a
a
a
a
a
c
d
c
c
c
c
c
c
c
c
c
c
c
c
a
a
c
c
d
c
a
a
a
a
a
a
a
a
a
"}
(36,1,1) = {"
a
a
a
a
a
a
a
a
a
a
a
a
e
a
a
c
c
c
c
d
c
c
a
a
a
a
a
a
a
e
a
a
a
a
a
a
a
a
a
a
"}
(37,1,1) = {"
a
a
a
a
a
a
a
a
a
a
a
a
a
a
a
a
a
a
a
e
a
a
a
a
a
a
a
a
a
a
a
a
a
a
a
a
a
a
a
a
"}
(38,1,1) = {"
a
a
a
a
a
a
a
a
a
a
a
a
a
a
a
a
a
a
a
a
a
a
a
a
a
a
a
a
a
a
a
a
a
a
a
a
a
a
a
a
"}
(39,1,1) = {"
a
a
a
a
a
a
a
a
a
a
a
a
a
a
a
a
a
a
a
a
a
a
a
a
a
a
a
a
a
a
a
a
a
a
a
a
a
a
a
a
"}
(40,1,1) = {"
a
a
a
a
a
a
a
a
a
a
a
a
a
a
a
a
a
a
a
a
a
a
a
a
a
a
a
a
a
a
a
a
a
a
a
a
a
a
a
a
"}
