"a" = (/obj/structure/lattice,/turf/template_noop,/area/template_noop)
"b" = (/obj/machinery/door/airlock/ship/external{name = "Portable zoo"},/obj/effect/mapping_helpers/airlock/cyclelink_helper{dir = 1},/turf/open/floor/plating,/area/ruin/powered)
"c" = (/obj/machinery/light/small{dir = 4},/turf/open/floor/plating,/area/ruin/powered)
"d" = (/turf/open/floor/grass/fakebasalt,/area/ruin/powered)
"e" = (/obj/structure/lattice/catwalk,/turf/template_noop,/area/template_noop)
"f" = (/obj/effect/overlay/palmtree_l,/turf/open/floor/plating/beach/sand,/area/ruin/powered)
"g" = (/obj/structure/flora/rock,/turf/open/floor/grass,/area/ruin/powered)
"h" = (/obj/structure/flora/ausbushes/lavendergrass,/mob/living/simple_animal/butterfly,/turf/open/floor/grass,/area/ruin/powered)
"i" = (/obj/structure/flora/ausbushes/lavendergrass,/turf/open/floor/grass,/area/ruin/powered)
"j" = (/obj/structure/flora/rock/pile,/turf/open/floor/grass/fakebasalt,/area/ruin/powered)
"k" = (/obj/machinery/light{dir = 8},/turf/open/floor/grass/fakebasalt,/area/ruin/powered)
"l" = (/mob/living/simple_animal/parrot,/turf/open/floor/grass,/area/ruin/powered)
"m" = (/obj/machinery/door/airlock/ship/external{name = "Portable zoo"},/obj/effect/mapping_helpers/airlock/cyclelink_helper{dir = 8},/turf/open/floor/plating,/area/ruin/powered)
"s" = (/obj/effect/overlay/coconut,/turf/open/floor/plating/beach/sand,/area/ruin/powered)
"t" = (/mob/living/simple_animal/crab,/turf/open/floor/plating/beach/sand,/area/ruin/powered)
"u" = (/mob/living/carbon/monkey,/turf/open/floor/grass,/area/ruin/powered)
"v" = (/obj/machinery/light,/turf/open/floor/plating/beach/sand,/area/ruin/powered)
"w" = (/turf/closed/mineral,/area/ruin/powered)
"x" = (/turf/open/floor/grass,/area/ruin/powered)
"y" = (/obj/structure/flora/ausbushes/sparsegrass,/turf/open/floor/grass,/area/ruin/powered)
"z" = (/obj/machinery/door/airlock/ship/external{name = "Portable zoo"},/obj/effect/mapping_helpers/airlock/cyclelink_helper,/turf/open/floor/plating,/area/ruin/powered)
"A" = (/obj/structure/flora/rock,/turf/open/floor/grass/fakebasalt,/area/ruin/powered)
"B" = (/obj/structure/flora/ausbushes/grassybush,/turf/open/floor/grass,/area/ruin/powered)
"D" = (/obj/machinery/light{dir = 4},/turf/open/floor/grass,/area/ruin/powered)
"E" = (/obj/structure/flora/tree/jungle,/turf/open/floor/grass,/area/ruin/powered)
"F" = (/turf/template_noop,/area/template_noop)
"H" = (/mob/living/simple_animal/cow,/turf/open/floor/grass,/area/ruin/powered)
"I" = (/obj/machinery/light/small{dir = 8},/turf/open/floor/plating,/area/ruin/powered)
"K" = (/obj/machinery/light/small,/turf/open/floor/plating,/area/ruin/powered)
"L" = (/obj/structure/flora/tree/jungle/small,/turf/open/floor/grass,/area/ruin/powered)
"M" = (/obj/effect/spawner/structure/window/reinforced,/turf/open/floor/plating,/area/ruin/powered)
"N" = (/obj/structure/flora/ausbushes/fullgrass,/turf/open/floor/grass,/area/ruin/powered)
"O" = (/turf/open/floor/plating/beach/sand,/area/ruin/powered)
"P" = (/obj/effect/overlay/palmtree_r,/turf/open/floor/plating/beach/sand,/area/ruin/powered)
"S" = (/mob/living/simple_animal/hostile/bear,/turf/open/floor/grass/fakebasalt,/area/ruin/powered)
"T" = (/mob/living/simple_animal/hostile/gorilla,/turf/open/floor/grass,/area/ruin/powered)
"U" = (/obj/machinery/light,/turf/open/floor/grass,/area/ruin/powered)
"W" = (/turf/closed/wall/steel,/area/ruin/powered)
"X" = (/obj/machinery/door/airlock/ship/external{name = "Portable zoo"},/obj/effect/mapping_helpers/airlock/cyclelink_helper{dir = 4},/turf/open/floor/plating,/area/ruin/powered)
"Y" = (/obj/machinery/light/small{dir = 1},/turf/open/floor/plating,/area/ruin/powered)
"Z" = (/turf/open/floor/plating,/area/ruin/powered)

(1,1,1) = {"
FFFFFFFFFFFFFFFFFFFFFFFFFFFFFFFFFFFFFFFF
FFFFFFFFFFFFFFFFFFFFFFFFFFFFFFFFFFFFFFFF
FFFFaWaFFFFFFFFFFFFFFFFFFFFFFFFFFFaWaFFF
FFFFWWWMMMWWFFFFFFFFFFFFFFFFFWWMMMWWWFFF
FFFFaWlxxxxWWWFFFFFFFFFFFFFWWWOOOsOWaFFF
FFFFFMxExTxWYWaaaaaaaaaaaaaWZWOtfOOMFFFF
FFFFFMxTxxxXZmeeeeeeeeeeeeeXZmOOsOfMFFFF
FFFFFMxxxuEWZWaaaaaaaaaaaaaWKWPtOPtMFFFF
FFFFFWLuxUxWWWaFaFwwwwwwFFFWWWsvOsOWFFFF
FFFFFWWWzWWWFaFFwwwwwwwwwFFFFWWWzWWWFFFF
FFFFFFWZZcWFFaawwwwwwwwwwwwwFFWIZZWFFFFF
FFFFFFWWbWWaawwwwwwwwwwwwwwwwFWWbWWFFFFF
FFFFFFFaeaaawwwwwwwwwwwwwwwwwFFaeaFFFFFF
FFFFFFFaeaFFwwwwwwwwwwwwwwwwwFFaeaFFFFFF
FFFFFFFaeaFwwwwwwwwwwwwwwwwwwwFaeaFFFFFF
FFFFFFFaeaFwwwwwwwwwwwwwwwwwwwFaeaFFFFFF
FFFFFFFaeawwwwwwwwwwwwwwwwwwwwFaeaFFFFFF
FFFFFFFaeawwwwwwwwwwwwwwwwwwwwwaeaFFFFFF
FFFFFFFaeawwwwwwwwwwwwwwwwwwwwwaeaFFFFFF
FFFFFFFaewwwwwwwwwwwwwwwwwwwwwwweaFFFFFF
FFFFFFFaewwwwwwwwwwwwwwwwwwwwwwweaFFFFFF
FFFFFFFaewwwwwwwwwwwwwwwwwwwwwwweaFFFFFF
FFFFFFFaewwwwwwwwwwwwwwwwwwwwwwaeaFFFFFF
FFFFFFFaewwwwwwwwwwwwwwwwwwwwwFaeaFFFFFF
FFFFFFFaewwwwwwwwwwwwwwwwwwwwwFaeaFFFFFF
FFFFFFFaeawwwwwwwwwwwwwwwwwwwFFaeaFFFFFF
FFFFFFFaeaFwwwwwwwwwwwwwwwwwwFFaeaFFFFFF
FFFFFFFaeaaawwwwwwwwwwwwwwwwFFFaeaFFFFFF
FFFFFFWWzWWFawwwwwwwwwwwwwwFFFWWzWWFFFFF
FFFFFFWIZZWaaaawwwwwwwwwwwFFFFWZZcWFFFFF
FFFFFWWWbWWWaaaaFwwwwwwwwFFFFWWWbWWWFFFF
FFFFFWxBiHBWWWaaFFwwwwwFFFFWWWdjdddWFFFF
FFFFFMiHNyDWYWaFFFFFFFFFFFaWYWkdSddMFFFF
FFFFFMxBhBiXZmeeeeeeeeeeeeeXZmdAdjdMFFFF
FFFFFMiNNxHWZWaFFFFFFFFFFFaWZWdSdSdMFFFF
FFFFaWxigNyWWWFFFFFFFFFFFFFWWWdddddWaFFF
FFFFWWWMMMWWFFFFFFFFFFFFFFFFFWWMMMWWWFFF
FFFFaWaFFFFFFFFFFFFFFFFFFFFFFFFFFFaWaFFF
FFFFFFFFFFFFFFFFFFFFFFFFFFFFFFFFFFFFFFFF
FFFFFFFFFFFFFFFFFFFFFFFFFFFFFFFFFFFFFFFF
"}
