//MAP CONVERTED BY dmm2tgm.py THIS HEADER COMMENT PREVENTS RECONVERSION, DO NOT REMOVE
"a" = (
/turf/closed/mineral,
/area/ruin/powered)
"b" = (
/turf/closed/wall,
/area/ruin/powered)
"c" = (
/mob/living/simple_animal/slime/random,
/turf/open/floor/monotile/dark,
/area/ruin/powered)
"d" = (
/obj/item/shard,
/turf/open/floor/monotile/dark,
/area/ruin/powered)
"e" = (
/obj/machinery/light{
	dir = 1
	},
/turf/open/floor/monotile/dark,
/area/ruin/powered)
"f" = (
/turf/open/floor/monotile/dark,
/area/ruin/powered)
"g" = (
/obj/structure/window,
/turf/open/floor/monotile/dark,
/area/ruin/powered)
"h" = (
/obj/structure/window,
/obj/structure/window{
	dir = 4
	},
/turf/open/floor/monotile/dark,
/area/ruin/powered)
"i" = (
/obj/structure/window,
/obj/structure/window{
	dir = 8
	},
/turf/open/floor/monotile/dark,
/area/ruin/powered)
"j" = (
/obj/machinery/door/airlock/ship{
	req_one_access_txt = "200"
	},
/turf/open/floor/monotile,
/area/ruin/powered)
"k" = (
/mob/living/simple_animal/slime,
/turf/open/floor/monotile/dark,
/area/ruin/powered)
"l" = (
/obj/structure/window{
	dir = 4
	},
/turf/open/floor/monotile/dark,
/area/ruin/powered)
"m" = (
/obj/structure/chair{
	dir = 4
	},
/turf/open/floor/monotile,
/area/ruin/powered)
"n" = (
/obj/structure/table,
/turf/open/floor/monotile,
/area/ruin/powered)
"o" = (
/obj/machinery/light{
	dir = 1
	},
/obj/structure/chair{
	dir = 8
	},
/turf/open/floor/monotile,
/area/ruin/powered)
"p" = (
/turf/open/floor/monotile,
/area/ruin/powered)
"q" = (
/obj/structure/window,
/mob/living/simple_animal/slime,
/turf/open/floor/monotile/dark,
/area/ruin/powered)
"r" = (
/obj/structure/window{
	dir = 4
	},
/obj/item/shard,
/turf/open/floor/monotile/dark,
/area/ruin/powered)
"s" = (
/obj/machinery/door/airlock/ship{
	req_one_access_txt = "200"
	},
/turf/open/floor/monotile/dark,
/area/ruin/powered)
"t" = (
/obj/structure/sign/poster/official/no_erp{
	pixel_x = 32
	},
/obj/machinery/light{
	dir = 4
	},
/turf/open/floor/monotile/dark,
/area/ruin/powered)
"u" = (
/obj/structure/table/glass,
/turf/open/floor/monotile,
/area/ruin/powered)
"v" = (
/obj/structure/table/optable,
/turf/open/floor/monotile/dark,
/area/ruin/powered)
"w" = (
/obj/structure/tank_dispenser,
/turf/open/floor/monotile,
/area/ruin/powered)
"x" = (
/obj/machinery/light,
/obj/structure/table/glass,
/obj/item/toy/plush/slimeplushie,
/turf/open/floor/monotile,
/area/ruin/powered)
"y" = (
/obj/structure/table/glass,
/obj/item/book/random,
/turf/open/floor/monotile,
/area/ruin/powered)
"z" = (
/obj/machinery/smartfridge/extract,
/turf/open/floor/monotile,
/area/ruin/powered)
"A" = (
/obj/machinery/light{
	dir = 8
	},
/turf/open/floor/monotile/dark,
/area/ruin/powered)
"B" = (
/obj/effect/mapping_helpers/airlock/cyclelink_helper,
/obj/machinery/door/airlock/ship/external/glass,
/turf/open/floor/plating,
/area/ruin/powered)
"C" = (
/obj/machinery/light/small{
	dir = 8
	},
/turf/open/floor/plating,
/area/ruin/powered)
"D" = (
/obj/item/shard,
/mob/living/simple_animal/slime,
/turf/open/floor/monotile/dark,
/area/ruin/powered)
"E" = (
/turf/template_noop,
/area/template_noop)
"F" = (
/obj/structure/window{
	dir = 1
	},
/turf/open/floor/monotile/dark,
/area/ruin/powered)
"G" = (
/obj/structure/window{
	dir = 4
	},
/obj/structure/window{
	dir = 1
	},
/turf/open/floor/monotile/dark,
/area/ruin/powered)
"H" = (
/obj/effect/mapping_helpers/airlock/cyclelink_helper{
	dir = 1
	},
/obj/machinery/door/airlock/ship/external/glass,
/turf/open/floor/plating,
/area/ruin/powered)
"I" = (
/obj/structure/lattice,
/turf/template_noop,
/area/template_noop)
"J" = (
/obj/structure/lattice/catwalk,
/turf/template_noop,
/area/template_noop)

(1,1,1) = {"
E
E
E
E
E
E
E
E
E
E
E
E
E
E
E
E
E
E
E
E
E
E
E
E
E
E
E
E
E
E
E
E
E
E
E
E
E
E
E
E
"}
(2,1,1) = {"
E
E
E
E
E
E
E
E
E
E
E
E
E
E
E
E
E
E
E
E
E
E
E
E
E
E
E
E
E
E
E
E
E
E
E
E
E
E
E
E
"}
(3,1,1) = {"
E
E
E
E
E
E
E
E
E
E
E
E
E
E
E
E
E
E
E
E
E
E
E
E
E
E
E
E
E
E
E
E
E
E
E
E
E
E
E
E
"}
(4,1,1) = {"
E
E
E
E
E
E
E
E
E
E
E
E
E
E
E
E
E
E
E
E
E
E
E
E
E
E
E
E
E
E
E
E
E
E
E
E
E
E
E
E
"}
(5,1,1) = {"
E
E
E
E
E
E
E
E
E
E
E
E
E
E
E
E
E
E
E
E
E
a
a
a
a
a
a
a
a
E
E
E
E
E
E
E
E
E
E
E
"}
(6,1,1) = {"
E
E
E
E
E
E
E
E
E
E
E
E
E
E
E
a
a
a
a
a
a
a
a
a
a
a
a
a
a
a
E
E
E
E
E
E
E
E
E
E
"}
(7,1,1) = {"
E
E
E
E
E
E
E
E
E
E
E
E
E
a
a
a
a
a
a
a
a
a
a
a
a
a
a
a
a
a
E
E
E
E
E
E
E
E
E
E
"}
(8,1,1) = {"
E
E
E
E
E
E
E
E
E
E
E
E
a
a
a
a
a
a
a
a
a
a
a
a
a
a
a
a
a
a
a
E
E
E
E
E
E
E
E
E
"}
(9,1,1) = {"
E
E
E
E
E
E
E
E
E
E
E
E
a
a
a
a
a
a
a
a
a
a
a
a
a
a
a
a
a
a
a
a
E
E
E
E
E
E
E
E
"}
(10,1,1) = {"
E
E
E
E
E
E
E
E
E
E
E
a
a
a
a
a
a
a
a
a
a
a
a
a
a
a
a
a
a
a
a
a
E
E
E
E
E
E
E
E
"}
(11,1,1) = {"
E
E
E
E
E
E
E
E
E
E
E
a
a
a
a
a
a
a
a
a
b
b
b
b
b
a
a
a
a
a
a
a
a
E
E
E
E
E
E
E
"}
(12,1,1) = {"
E
E
E
E
E
E
E
E
E
E
E
a
a
a
a
a
a
a
a
a
b
c
g
f
b
b
b
b
b
b
a
a
a
a
E
E
E
E
E
E
"}
(13,1,1) = {"
E
E
E
E
E
E
E
E
E
E
E
a
a
a
a
a
a
a
a
a
b
d
h
f
b
m
p
p
u
b
b
a
a
a
E
E
E
E
E
E
"}
(14,1,1) = {"
E
E
E
E
E
E
E
E
E
E
E
a
a
a
a
a
a
a
a
a
b
e
f
f
b
n
p
p
p
w
b
a
a
I
I
E
E
E
E
E
"}
(15,1,1) = {"
E
E
E
E
E
E
E
E
E
E
E
a
a
a
a
a
a
a
a
a
b
f
f
f
b
o
p
p
p
p
b
b
b
J
J
J
E
E
E
E
"}
(16,1,1) = {"
E
E
E
E
E
E
E
E
E
E
E
a
a
a
a
a
a
a
a
a
b
d
i
f
b
p
p
p
p
p
B
C
H
J
J
J
E
E
E
E
"}
(17,1,1) = {"
E
E
E
E
E
E
E
E
E
E
E
a
a
a
a
a
a
a
a
a
b
c
g
f
j
p
p
p
p
p
b
b
b
J
J
J
E
E
E
E
"}
(18,1,1) = {"
E
E
E
E
E
E
E
E
E
E
E
a
a
a
a
a
a
a
a
a
b
b
b
b
b
b
b
p
p
u
b
a
a
I
I
E
E
E
E
E
"}
(19,1,1) = {"
E
E
E
E
E
E
E
E
E
E
E
a
a
a
a
a
a
a
a
a
a
a
a
a
a
a
b
p
p
x
b
a
a
I
E
E
E
E
E
E
"}
(20,1,1) = {"
E
E
E
E
E
E
E
E
E
E
E
a
a
a
a
a
a
a
a
a
a
a
a
a
a
a
b
p
p
y
b
a
a
a
E
E
E
E
E
E
"}
(21,1,1) = {"
E
E
E
E
E
E
E
E
E
E
E
a
a
a
a
a
a
a
a
a
a
a
a
a
a
a
b
p
p
z
b
a
a
a
a
E
E
E
E
E
"}
(22,1,1) = {"
E
E
E
E
E
E
E
E
E
E
E
a
a
a
a
a
a
a
a
a
a
a
a
b
b
b
b
s
b
b
b
b
b
b
a
E
E
E
E
E
"}
(23,1,1) = {"
E
E
E
E
E
E
E
E
E
E
E
a
a
a
a
a
a
a
a
a
a
a
a
b
k
g
f
f
f
A
f
D
f
b
a
a
E
E
E
E
"}
(24,1,1) = {"
E
E
E
E
E
E
E
E
E
E
E
a
a
a
a
a
a
a
a
a
a
a
a
b
f
q
f
f
f
f
c
F
k
b
a
a
E
E
E
E
"}
(25,1,1) = {"
E
E
E
E
E
E
E
E
E
E
E
a
a
a
a
a
a
a
a
a
a
a
a
b
l
r
f
f
f
f
f
G
l
b
a
a
E
E
E
E
"}
(26,1,1) = {"
E
E
E
E
E
E
E
E
E
E
E
a
a
a
a
a
a
a
a
a
a
a
a
b
k
g
f
k
v
f
f
d
f
b
a
a
E
E
E
E
"}
(27,1,1) = {"
E
E
E
E
E
E
E
E
E
E
E
a
a
a
a
a
a
a
a
a
a
a
a
b
f
q
f
f
f
f
f
F
k
b
a
a
E
E
E
E
"}
(28,1,1) = {"
E
E
E
E
E
E
E
E
E
E
E
a
a
a
a
a
a
a
a
a
a
a
a
b
l
r
l
d
l
l
d
G
l
b
a
a
E
E
E
E
"}
(29,1,1) = {"
E
E
E
E
E
E
E
E
E
E
E
E
a
a
a
a
a
a
a
a
a
a
a
b
f
f
f
f
g
k
f
f
f
b
a
a
E
E
E
E
"}
(30,1,1) = {"
E
E
E
E
E
E
E
E
E
E
E
E
E
a
a
a
a
a
a
a
a
a
a
b
f
k
f
t
g
f
f
k
b
b
a
E
E
E
E
E
"}
(31,1,1) = {"
E
E
E
E
E
E
E
E
E
E
E
E
E
E
a
a
a
a
a
a
a
a
a
b
b
b
b
b
b
b
b
b
b
E
E
E
E
E
E
E
"}
(32,1,1) = {"
E
E
E
E
E
E
E
E
E
E
E
E
E
E
E
a
a
a
a
a
a
a
a
a
a
a
a
a
a
a
a
a
E
E
E
E
E
E
E
E
"}
(33,1,1) = {"
E
E
E
E
E
E
E
E
E
E
E
E
E
E
E
E
a
a
a
a
a
a
a
a
a
a
a
a
a
E
a
E
E
E
E
E
E
E
E
E
"}
(34,1,1) = {"
E
E
E
E
E
E
E
E
E
E
E
E
E
E
E
E
E
E
a
a
a
a
a
a
a
a
a
a
E
E
E
E
E
E
E
E
E
E
E
E
"}
(35,1,1) = {"
E
E
E
E
E
E
E
E
E
E
E
E
E
E
E
E
E
E
E
E
E
E
E
E
E
E
E
E
E
E
E
E
E
E
E
E
E
E
E
E
"}
(36,1,1) = {"
E
E
E
E
E
E
E
E
E
E
E
E
E
E
E
E
E
E
E
E
E
E
E
E
E
E
E
E
E
E
E
E
E
E
E
E
E
E
E
E
"}
(37,1,1) = {"
E
E
E
E
E
E
E
E
E
E
E
E
E
E
E
E
E
E
E
E
E
E
E
E
E
E
E
E
E
E
E
E
E
E
E
E
E
E
E
E
"}
(38,1,1) = {"
E
E
E
E
E
E
E
E
E
E
E
E
E
E
E
E
E
E
E
E
E
E
E
E
E
E
E
E
E
E
E
E
E
E
E
E
E
E
E
E
"}
(39,1,1) = {"
E
E
E
E
E
E
E
E
E
E
E
E
E
E
E
E
E
E
E
E
E
E
E
E
E
E
E
E
E
E
E
E
E
E
E
E
E
E
E
E
"}
(40,1,1) = {"
E
E
E
E
E
E
E
E
E
E
E
E
E
E
E
E
E
E
E
E
E
E
E
E
E
E
E
E
E
E
E
E
E
E
E
E
E
E
E
E
"}
