"h" = (/turf/template_noop,/area/template_noop)
"o" = (/turf/closed/mineral,/area/ruin/powered)
"r" = (/turf/closed/wall/steel,/area/ruin/powered)
"B" = (/obj/structure/filingcabinet,/obj/item/folder/syndicate/mining,/turf/open/floor/plating,/area/ruin/powered)
"M" = (/obj/machinery/door/airlock/vault/ship{name = "Vault"; req_one_access_txt = "53"},/turf/open/floor/plating,/area/ruin/powered)
"N" = (/obj/item/grenade/smokebomb,/obj/structure/closet/crate,/obj/item/clothing/glasses/night,/turf/open/floor/plating,/area/ruin/powered)
"R" = (/obj/structure/safe,/obj/item/reagent_containers/food/drinks/bottle/vodka/badminka,/obj/item/stack/ore/bluespace_crystal,/obj/item/stack/ore/bluespace_crystal,/obj/item/stack/ore/bluespace_crystal,/obj/item/stack/ore/bluespace_crystal,/obj/item/stack/ore/diamond,/obj/item/stack/ore/diamond,/obj/item/stack/ore/diamond,/obj/item/stack/ore/diamond,/obj/item/stack/ore/diamond,/obj/item/stack/ore/bananium,/obj/item/stack/ore/bananium,/obj/item/stack/ore/bananium,/obj/item/stack/ore/bananium,/obj/item/stack/ore/bananium,/obj/item/stack/ore/plasma,/obj/item/stack/ore/plasma,/obj/item/stack/ore/plasma,/obj/item/stack/ore/plasma,/obj/item/stack/ore/plasma,/obj/item/stack/ore/uranium,/obj/item/stack/ore/uranium,/obj/item/stack/ore/uranium,/obj/item/stack/ore/uranium,/obj/item/stack/ore/uranium,/turf/open/floor/plating,/area/ruin/powered)
"T" = (/turf/open/floor/plating,/area/ruin/powered)

(1,1,1) = {"
hhhhhhhhhhhhhhhhhhhhhhhhhhhhhhhhhhoooohh
hhhhhhhhhhhhhhhhhhhhhhhhhhhhhhhhhooooooh
hhhhhhoooooohhhhhhhhhhhhhhhhhhhhoooooooh
hhhhhoooooooohhhhhhhhhhhhhhhhhhhoooooooh
hhhhhoooooooohhhhhhhhhhhhhhhhhhhoooooooh
hhhhhooooooohhhhhhhhhhhhhhhhhhhhoooooooh
hhhhhhoooooohhhhhhhhhhhhhhhhhhhhhooooohh
hhhhhhhoooohhhhhhhhhhhhhhhhhhhhhhhoooohh
hhhhhhhhhhhhhhhhhhhhhhhhhhhhhhhhhhhoohhh
hhhhhhhhhhhhhhhoooooooooooooohhhhhhhhhhh
hhhhhhhhhhhhhooooooooooooooooohhhhhhhhhh
hhhhhhhhhhoooooooooooooooooooohhhhhhhhhh
hhhhhhhhooooooooooooooooooooooohhhhhhhhh
hhhhhhhooooooooooooooooooooooooohhhhhhhh
hhhhhhoooooooooooooooooooooooooohhhhhhhh
hhhhhooooooooooooooooooooooooooohhhhhhhh
hhhhhhoooooooooooooooooooooooooohhhhhhhh
hhhhhooooooooooooooooooooooooooohhhhhhhh
hhhhhooooooooooooooooooooooooooohhhhhhhh
hhhhhooooooooooooooooooooooooooohhhhhhhh
hhhhoorrrroooooooooooooooooooooohhhhhhhh
hhhhoorRBroooooooooooooooooooooohhhhhhhh
hhhhooMTTroooooooooooooooooooooohhhhhhhh
hhhhoorTNrooooooooooooooooooooohhhhhhhhh
hhhhhorrrroooooooooooooooooooooohhhhhhhh
hhhhhooooooooooooooooooooooooooohhhhhhhh
hhhhhhooooooooooooooooooooooooohhhhhhhhh
hhhhhhhhhooooooooooooooooooooohhhhhhhhhh
hhhhhhhhhhooohooooooooooooooooohhhhhhhhh
hhhhhhhhhhhhhhhoooooooooooooooohhhhhhhhh
hhhhhhhhhhhhhhhhhoooooooooooooohhhhhhhhh
hhhhhhhhhhhhhhhhhhhooooooooooohhhhhhhhhh
hhhhhhhhhoohhhhhhhhhhoooooooohhhhhhhhhhh
hhhhhhhhoooohhhhhhhhhhooooohhhhhhhhhhhhh
hhhhhhhhooooohhhhhhhhhhhhhhhhhhhhhhhhhhh
hhhhhhhooooooohhhhhhhhhhhhhhhhhhhhhhhhhh
hhhhhhhoooooohhhhhhhhhhhhhhhhhhhhhhhhhhh
hhhhhhhoooooohhhhhhhhhhhhhhhhhhhhhhhhhhh
hhhhhhhhhooohhhhhhhhhhhhhhhhhhhhhhhhhhhh
hhhhhhhhhhhhhhhhhhhhhhhhhhhhhhhhhhhhhhhh
"}
