//MAP CONVERTED BY dmm2tgm.py THIS HEADER COMMENT PREVENTS RECONVERSION, DO NOT REMOVE
"a" = (
/turf/template_noop,
/area/template_noop)
"b" = (
/turf/closed/mineral,
/area/ruin/powered)
"c" = (
/turf/open/floor/plating/asteroid,
/area/ruin/powered)
"d" = (
/obj/structure/flora/tree/palm,
/turf/open/floor/plating/asteroid,
/area/ruin/powered)
"e" = (
/mob/living/simple_animal/pet/gondola,
/turf/open/floor/plating/asteroid,
/area/ruin/powered)
"f" = (
/obj/structure/flora/ausbushes/palebush,
/turf/open/floor/plating/asteroid,
/area/ruin/powered)
"g" = (
/obj/structure/flora/ausbushes/ywflowers,
/turf/open/floor/plating/asteroid,
/area/ruin/powered)
"h" = (
/obj/structure/flora/ausbushes/stalkybush,
/turf/open/floor/plating/asteroid,
/area/ruin/powered)
"i" = (
/obj/structure/flora/ausbushes/ppflowers,
/turf/open/floor/plating/asteroid,
/area/ruin/powered)
"j" = (
/obj/effect/overlay/coconut,
/turf/open/floor/plating/asteroid,
/area/ruin/powered)
"k" = (
/mob/living/simple_animal/pet/gondola{
	icon_state = "gondola";
	dir = 8
	},
/turf/open/floor/plating/asteroid,
/area/ruin/powered)
"l" = (
/obj/structure/flora/ausbushes/lavendergrass,
/turf/open/floor/plating/asteroid,
/area/ruin/powered)
"m" = (
/obj/machinery/light,
/turf/open/floor/plating/asteroid,
/area/ruin/powered)
"n" = (
/obj/structure/flora/rock{
	name = "rock of tranquility"
	},
/turf/open/floor/plating/asteroid,
/area/ruin/powered)
"o" = (
/obj/structure/flora/ausbushes/fernybush,
/turf/open/floor/plating/asteroid,
/area/ruin/powered)
"p" = (
/turf/closed/wall/steel,
/area/ruin/powered)
"q" = (
/obj/item/a_gift,
/turf/open/floor/plating/asteroid,
/area/ruin/powered)
"r" = (
/obj/effect/spawner/structure/window/reinforced,
/turf/open/floor/plating,
/area/ruin/powered)
"s" = (
/obj/structure/table/wood/bar,
/obj/machinery/chem_dispenser/drinks/beer,
/turf/open/floor/carpet/black,
/area/ruin/powered)
"t" = (
/obj/structure/table/wood/bar,
/obj/machinery/chem_dispenser/drinks,
/turf/open/floor/carpet/black,
/area/ruin/powered)
"u" = (
/obj/structure/table/wood/bar,
/obj/machinery/reagentgrinder,
/turf/open/floor/carpet/black,
/area/ruin/powered)
"v" = (
/obj/structure/sign/poster/official/help_others{
	pixel_y = 32
	},
/obj/structure/closet/secure_closet/bar,
/turf/open/floor/carpet/black,
/area/ruin/powered)
"w" = (
/turf/open/floor/carpet/black,
/area/ruin/powered)
"x" = (
/mob/living/simple_animal/pet/gondola,
/turf/open/floor/carpet/black,
/area/ruin/powered)
"y" = (
/obj/structure/sign/poster/official/no_erp{
	pixel_x = 32
	},
/turf/open/floor/plating/asteroid,
/area/ruin/powered)
"z" = (
/obj/structure/table/wood/fancy,
/turf/open/floor/carpet/black,
/area/ruin/powered)
"A" = (
/obj/structure/table/wood/fancy,
/obj/item/clothing/head/collectable/tophat,
/turf/open/floor/carpet/black,
/area/ruin/powered)
"B" = (
/mob/living/simple_animal/pet/gondola{
	icon_state = "gondola";
	dir = 4
	},
/turf/open/floor/plating/asteroid,
/area/ruin/powered)
"C" = (
/obj/machinery/light{
	dir = 4
	},
/turf/open/floor/plating/asteroid,
/area/ruin/powered)
"D" = (
/obj/structure/chair/stool/bar,
/obj/machinery/light{
	dir = 8
	},
/turf/open/floor/carpet/black,
/area/ruin/powered)
"E" = (
/obj/structure/chair/stool/bar,
/turf/open/floor/carpet/black,
/area/ruin/powered)
"F" = (
/obj/structure/table/wood/poker,
/turf/open/floor/carpet/black,
/area/ruin/powered)
"G" = (
/obj/machinery/light{
	dir = 4
	},
/turf/open/floor/carpet/black,
/area/ruin/powered)
"H" = (
/obj/machinery/light{
	dir = 8
	},
/turf/open/floor/plating/asteroid,
/area/ruin/powered)
"I" = (
/obj/structure/mineral_door/paperframe,
/turf/open/floor/plating,
/area/ruin/powered)
"J" = (
/mob/living/simple_animal/pet/gondola{
	icon_state = "gondola";
	dir = 4
	},
/turf/open/floor/carpet/black,
/area/ruin/powered)
"K" = (
/obj/structure/table/wood/poker,
/obj/item/skub,
/turf/open/floor/carpet/black,
/area/ruin/powered)
"L" = (
/obj/structure/sign/poster/official/no_erp{
	pixel_x = 32
	},
/mob/living/simple_animal/pet/gondola{
	icon_state = "gondola";
	dir = 8
	},
/turf/open/floor/carpet/black,
/area/ruin/powered)
"M" = (
/obj/structure/flora/ausbushes/genericbush,
/turf/open/floor/plating/asteroid,
/area/ruin/powered)
"N" = (
/obj/structure/piano,
/turf/open/floor/carpet/black,
/area/ruin/powered)
"O" = (
/obj/structure/chair/wood{
	icon_state = "wooden_chair";
	dir = 8
	},
/turf/open/floor/carpet/black,
/area/ruin/powered)
"P" = (
/mob/living/simple_animal/pet/gondola{
	icon_state = "gondola";
	dir = 1
	},
/turf/open/floor/carpet/black,
/area/ruin/powered)
"Q" = (
/obj/effect/mapping_helpers/airlock/cyclelink_helper,
/obj/machinery/door/airlock/ship/external/glass,
/turf/open/floor/plating,
/area/ruin/powered)
"R" = (
/obj/structure/closet/cardboard,
/mob/living/simple_animal/pet/gondola{
	name = "benis snake"
	},
/turf/open/floor/plating/asteroid,
/area/ruin/powered)
"S" = (
/obj/structure/sign/warning/vacuum{
	pixel_x = 32
	},
/turf/open/floor/plating,
/area/ruin/powered)
"T" = (
/obj/structure/lattice,
/turf/template_noop,
/area/template_noop)
"U" = (
/obj/structure/sign/barsign,
/turf/closed/wall/steel,
/area/ruin/powered)
"V" = (
/obj/effect/mapping_helpers/airlock/cyclelink_helper{
	dir = 1
	},
/obj/structure/fans/tiny/invisible,
/obj/machinery/door/airlock/ship/external/glass,
/turf/open/floor/plating,
/area/ruin/powered)
"W" = (
/obj/structure/lattice/catwalk,
/turf/template_noop,
/area/template_noop)

(1,1,1) = {"
a
a
a
a
a
a
a
a
a
a
a
a
a
a
a
a
a
a
a
a
a
a
a
a
a
a
a
a
a
a
a
a
a
a
a
a
a
a
a
a
"}
(2,1,1) = {"
a
a
a
a
a
a
a
a
a
a
a
a
a
a
a
a
a
a
a
a
a
a
a
a
a
a
a
a
a
a
a
a
a
a
b
b
a
a
a
a
"}
(3,1,1) = {"
a
a
a
a
a
a
a
a
a
a
a
a
a
a
a
a
a
a
a
a
a
a
a
a
a
a
a
a
a
a
a
a
a
b
b
b
b
a
a
a
"}
(4,1,1) = {"
a
a
a
a
a
a
a
a
a
a
a
a
a
a
a
a
a
a
a
a
a
a
a
a
a
a
a
a
a
a
a
a
b
b
b
b
b
b
a
a
"}
(5,1,1) = {"
a
a
a
a
a
a
a
a
a
a
a
a
a
a
a
a
a
a
a
a
a
a
a
a
a
a
a
a
a
a
a
a
b
b
b
R
b
b
a
a
"}
(6,1,1) = {"
a
a
a
a
a
a
a
a
a
a
a
a
a
a
a
a
a
a
a
a
a
a
a
a
a
a
a
a
a
a
a
a
a
b
b
b
b
b
a
a
"}
(7,1,1) = {"
a
a
a
a
a
a
a
a
a
a
a
a
a
a
a
a
a
a
a
b
b
b
b
b
b
b
b
a
a
a
a
a
a
a
b
b
b
a
a
a
"}
(8,1,1) = {"
a
a
a
a
a
a
a
a
a
a
a
a
a
a
a
a
a
a
b
b
b
b
b
b
b
b
b
b
a
a
a
a
a
a
a
a
a
a
a
a
"}
(9,1,1) = {"
a
a
a
a
a
a
a
a
a
a
a
a
a
b
b
a
a
b
b
b
b
b
b
b
b
b
b
b
b
b
a
a
a
a
a
a
a
a
a
a
"}
(10,1,1) = {"
a
a
a
a
a
a
a
a
a
a
a
a
a
b
b
b
b
b
b
b
b
b
b
c
c
c
c
c
b
b
b
a
a
a
a
a
a
a
a
a
"}
(11,1,1) = {"
a
a
a
a
a
a
a
a
a
a
a
a
b
b
b
b
b
b
b
b
b
b
c
e
c
h
c
c
c
b
b
b
a
a
a
a
a
a
a
a
"}
(12,1,1) = {"
a
a
a
a
a
a
a
a
a
a
a
a
b
b
b
b
b
b
b
b
b
c
c
f
c
c
e
c
g
c
b
b
b
a
a
a
a
a
a
a
"}
(13,1,1) = {"
a
a
a
a
a
a
a
a
a
a
b
b
b
b
b
b
b
b
b
b
c
c
c
c
i
c
c
c
c
e
c
b
b
a
a
a
a
a
a
a
"}
(14,1,1) = {"
a
a
a
a
a
a
a
a
a
a
b
b
b
b
b
b
b
b
b
b
c
c
d
c
j
c
n
q
c
c
c
b
b
a
a
a
a
a
a
a
"}
(15,1,1) = {"
a
a
a
a
a
a
a
a
a
b
b
b
b
b
b
b
b
b
b
b
c
c
c
g
c
e
c
c
c
c
c
b
b
a
a
a
a
a
a
a
"}
(16,1,1) = {"
a
a
a
a
a
a
a
a
a
b
b
b
b
b
b
b
b
b
b
b
b
c
e
c
g
c
c
i
c
e
c
b
b
b
a
a
a
a
a
a
"}
(17,1,1) = {"
a
a
a
a
a
a
a
a
a
b
b
b
b
b
b
b
b
b
b
b
b
c
c
c
c
c
o
c
c
c
c
c
b
b
b
a
a
a
a
a
"}
(18,1,1) = {"
a
a
a
a
a
a
a
a
a
a
b
b
b
b
b
b
b
b
b
b
b
b
c
c
c
c
c
c
c
y
C
c
c
b
b
b
a
a
a
a
"}
(19,1,1) = {"
a
a
a
a
a
a
a
a
a
a
b
b
b
b
b
b
b
b
b
b
b
b
b
c
c
c
p
r
r
p
p
I
p
p
p
b
b
T
a
a
"}
(20,1,1) = {"
a
a
a
a
a
a
a
a
a
a
a
b
b
b
b
b
b
b
b
b
b
b
b
h
c
c
p
s
w
z
D
w
w
N
p
b
U
W
a
a
"}
(21,1,1) = {"
a
a
a
a
a
a
a
a
a
b
b
b
b
b
b
b
b
b
b
b
b
b
b
c
c
m
p
t
x
z
E
w
w
O
p
p
p
W
a
a
"}
(22,1,1) = {"
a
a
a
a
a
a
a
a
a
a
b
b
b
b
b
b
b
b
b
b
b
b
b
c
c
c
p
u
w
A
E
w
w
w
Q
S
V
W
a
a
"}
(23,1,1) = {"
a
a
a
a
a
a
a
a
a
a
b
b
b
b
b
b
b
b
b
b
b
b
b
c
c
i
p
v
w
z
E
w
w
w
p
p
U
W
a
a
"}
(24,1,1) = {"
a
a
a
a
a
a
a
a
a
a
b
b
b
b
b
b
b
b
b
b
b
b
b
c
c
c
p
p
w
w
w
w
w
w
p
T
p
W
a
a
"}
(25,1,1) = {"
a
a
a
a
a
a
a
a
a
a
b
b
b
b
b
b
b
b
b
b
b
b
b
c
k
c
c
p
w
w
w
J
w
w
r
T
T
T
a
a
"}
(26,1,1) = {"
a
a
a
a
a
a
a
a
a
a
b
b
b
b
b
b
b
b
b
b
b
b
b
c
l
c
c
p
w
x
F
K
F
P
r
a
a
a
a
a
"}
(27,1,1) = {"
a
a
a
a
a
a
a
a
a
b
b
b
b
b
b
b
b
b
b
b
b
b
b
c
c
c
m
p
w
w
F
F
F
w
r
a
a
a
a
a
"}
(28,1,1) = {"
a
a
a
a
a
a
a
a
a
b
b
b
b
b
b
b
b
b
b
b
b
b
b
c
c
c
c
p
w
w
G
L
w
w
p
a
a
a
a
a
"}
(29,1,1) = {"
a
a
a
a
a
a
a
a
a
b
b
b
b
b
b
b
b
b
b
b
b
b
b
c
c
c
c
p
p
p
p
p
p
p
p
a
a
a
a
a
"}
(30,1,1) = {"
a
a
a
a
a
a
a
a
a
b
b
b
b
b
b
b
b
b
b
b
b
b
b
c
c
c
c
c
c
c
H
j
M
b
b
a
a
a
a
a
"}
(31,1,1) = {"
a
a
a
a
a
a
a
a
a
a
b
b
b
b
b
b
b
b
b
b
b
b
b
c
c
c
c
c
c
B
d
c
c
b
b
a
a
a
a
a
"}
(32,1,1) = {"
a
a
a
a
a
a
a
a
a
a
b
b
b
b
b
b
b
b
b
b
b
b
b
c
c
c
c
c
c
c
c
c
c
b
b
a
a
a
a
a
"}
(33,1,1) = {"
a
a
a
a
a
a
a
a
a
a
b
b
b
b
b
b
b
b
b
b
b
b
b
b
b
b
b
b
b
b
b
b
b
b
b
a
a
a
a
a
"}
(34,1,1) = {"
a
a
a
a
a
a
a
a
a
a
a
b
b
b
b
b
b
b
b
b
b
b
b
b
b
b
b
b
b
b
b
b
b
b
a
a
a
a
a
a
"}
(35,1,1) = {"
a
a
a
a
a
a
a
a
a
a
a
a
a
a
b
b
b
b
b
b
b
b
b
b
b
b
b
b
b
b
b
b
a
a
a
a
a
a
a
a
"}
(36,1,1) = {"
a
a
a
a
a
a
a
a
a
a
a
a
a
a
a
b
b
b
b
b
b
b
b
b
b
b
b
b
b
b
b
a
a
a
a
a
a
a
a
a
"}
(37,1,1) = {"
a
a
a
a
a
a
a
a
a
a
a
a
a
a
a
a
b
b
b
b
b
b
b
b
b
b
b
b
b
b
a
a
a
a
a
a
a
a
a
a
"}
(38,1,1) = {"
a
a
a
a
a
a
a
a
a
a
a
a
a
a
a
a
a
b
b
b
b
b
b
b
b
b
b
b
a
a
a
a
a
a
a
a
a
a
a
a
"}
(39,1,1) = {"
a
a
a
a
a
a
a
a
a
a
a
a
a
a
a
a
a
a
b
b
b
b
b
a
a
b
b
a
a
a
a
a
a
a
a
a
a
a
a
a
"}
(40,1,1) = {"
a
a
a
a
a
a
a
a
a
a
a
a
a
a
a
a
a
a
a
a
a
a
a
a
a
a
a
a
a
a
a
a
a
a
a
a
a
a
a
a
"}
