//MAP CONVERTED BY dmm2tgm.py THIS HEADER COMMENT PREVENTS RECONVERSION, DO NOT REMOVE
"a" = (
/obj/structure/window{
	dir = 4
	},
/obj/structure/window{
	dir = 1
	},
/turf/open/floor/monotile/dark,
/area/space)
"b" = (
/obj/structure/window,
/mob/living/simple_animal/slime,
/turf/open/floor/monotile/dark,
/area/space)
"c" = (
/obj/machinery/light{
	dir = 1
	},
/obj/structure/chair{
	dir = 8
	},
/turf/open/floor/monotile,
/area/space)
"d" = (
/turf/open/floor/monotile/dark,
/area/space)
"e" = (
/obj/effect/mapping_helpers/airlock/cyclelink_helper,
/obj/machinery/door/airlock/ship/external/glass,
/turf/open/floor/plating,
/area/space)
"f" = (
/obj/structure/window{
	dir = 4
	},
/turf/open/floor/monotile/dark,
/area/space)
"g" = (
/obj/structure/window,
/turf/open/floor/monotile/dark,
/area/space)
"h" = (
/mob/living/simple_animal/slime,
/turf/open/floor/monotile/dark,
/area/space)
"i" = (
/obj/structure/table,
/turf/open/floor/monotile,
/area/space)
"j" = (
/obj/structure/lattice/catwalk,
/turf/open/space/basic,
/area/space)
"k" = (
/turf/closed/mineral,
/area/space)
"m" = (
/turf/open/floor/monotile,
/area/space)
"n" = (
/obj/structure/window,
/obj/structure/window{
	dir = 4
	},
/turf/open/floor/monotile/dark,
/area/space)
"r" = (
/obj/structure/tank_dispenser,
/turf/open/floor/monotile,
/area/space)
"s" = (
/obj/structure/window,
/obj/structure/window{
	dir = 8
	},
/turf/open/floor/monotile/dark,
/area/space)
"t" = (
/obj/structure/window{
	dir = 1
	},
/turf/open/floor/monotile/dark,
/area/space)
"v" = (
/obj/structure/table/optable,
/turf/open/floor/monotile/dark,
/area/space)
"w" = (
/obj/machinery/light{
	dir = 8
	},
/turf/open/floor/monotile/dark,
/area/space)
"x" = (
/obj/item/shard,
/mob/living/simple_animal/slime,
/turf/open/floor/monotile/dark,
/area/space)
"y" = (
/obj/machinery/light,
/obj/structure/table/glass,
/obj/item/toy/plush/slimeplushie,
/turf/open/floor/monotile,
/area/space)
"z" = (
/obj/item/shard,
/turf/open/floor/monotile/dark,
/area/space)
"C" = (
/obj/machinery/door/airlock/ship{
	req_one_access_txt = "200"
	},
/turf/open/floor/monotile/dark,
/area/space)
"E" = (
/turf/open/space/basic,
/area/space)
"F" = (
/obj/structure/lattice,
/turf/open/space/basic,
/area/space)
"I" = (
/obj/machinery/light/small{
	dir = 8
	},
/turf/open/floor/plating,
/area/space)
"J" = (
/obj/machinery/smartfridge/extract,
/turf/open/floor/monotile,
/area/space)
"M" = (
/obj/structure/window{
	dir = 4
	},
/obj/item/shard,
/turf/open/floor/monotile/dark,
/area/space)
"O" = (
/obj/structure/table/glass,
/obj/item/book/random,
/turf/open/floor/monotile,
/area/space)
"P" = (
/mob/living/simple_animal/slime/random,
/turf/open/floor/monotile/dark,
/area/space)
"Q" = (
/obj/structure/chair{
	dir = 4
	},
/turf/open/floor/monotile,
/area/space)
"R" = (
/obj/structure/sign/poster/official/no_erp{
	pixel_x = 32
	},
/obj/machinery/light{
	dir = 4
	},
/turf/open/floor/monotile/dark,
/area/space)
"S" = (
/obj/structure/table/glass,
/turf/open/floor/monotile,
/area/space)
"T" = (
/turf/closed/wall,
/area/space)
"V" = (
/obj/machinery/door/airlock/ship{
	req_one_access_txt = "200"
	},
/turf/open/floor/monotile,
/area/space)
"Y" = (
/obj/machinery/light{
	dir = 1
	},
/turf/open/floor/monotile/dark,
/area/space)
"Z" = (
/obj/effect/mapping_helpers/airlock/cyclelink_helper{
	dir = 1
	},
/obj/machinery/door/airlock/ship/external/glass,
/turf/open/floor/plating,
/area/space)

(1,1,1) = {"
E
E
E
E
E
E
E
E
E
E
E
E
E
E
E
E
E
E
E
E
E
E
E
E
E
E
E
E
E
E
E
E
E
E
E
E
E
E
E
E
"}
(2,1,1) = {"
E
E
E
E
E
E
E
E
E
E
E
E
E
E
E
E
E
E
E
E
E
E
E
E
E
E
E
E
E
E
E
E
E
E
E
E
E
E
E
E
"}
(3,1,1) = {"
E
E
E
E
E
E
E
E
E
E
E
E
E
E
E
E
E
E
E
E
E
E
E
E
E
E
E
E
E
E
E
E
E
E
E
E
E
E
E
E
"}
(4,1,1) = {"
E
E
E
E
E
E
E
E
E
E
E
E
E
E
E
E
E
E
E
E
E
E
E
E
E
E
E
E
E
E
E
E
E
E
E
E
E
E
E
E
"}
(5,1,1) = {"
E
E
E
E
E
E
E
E
E
E
E
E
E
E
E
E
E
E
E
E
E
k
k
k
k
k
k
k
k
E
E
E
E
E
E
E
E
E
E
E
"}
(6,1,1) = {"
E
E
E
E
E
E
E
E
E
E
E
E
E
E
E
k
k
k
k
k
k
k
k
k
k
k
k
k
k
k
E
E
E
E
E
E
E
E
E
E
"}
(7,1,1) = {"
E
E
E
E
E
E
E
E
E
E
E
E
E
k
k
k
k
k
k
k
k
k
k
k
k
k
k
k
k
k
E
E
E
E
E
E
E
E
E
E
"}
(8,1,1) = {"
E
E
E
E
E
E
E
E
E
E
E
E
k
k
k
k
k
k
k
k
k
k
k
k
k
k
k
k
k
k
k
E
E
E
E
E
E
E
E
E
"}
(9,1,1) = {"
E
E
E
E
E
E
E
E
E
E
E
E
k
k
k
k
k
k
k
k
k
k
k
k
k
k
k
k
k
k
k
k
E
E
E
E
E
E
E
E
"}
(10,1,1) = {"
E
E
E
E
E
E
E
E
E
E
E
k
k
k
k
k
k
k
k
k
k
k
k
k
k
k
k
k
k
k
k
k
E
E
E
E
E
E
E
E
"}
(11,1,1) = {"
E
E
E
E
E
E
E
E
E
E
E
k
k
k
k
k
k
k
k
k
T
T
T
T
T
k
k
k
k
k
k
k
k
E
E
E
E
E
E
E
"}
(12,1,1) = {"
E
E
E
E
E
E
E
E
E
E
E
k
k
k
k
k
k
k
k
k
T
P
g
d
T
T
T
T
T
T
k
k
k
k
E
E
E
E
E
E
"}
(13,1,1) = {"
E
E
E
E
E
E
E
E
E
E
E
k
k
k
k
k
k
k
k
k
T
z
n
d
T
Q
m
m
S
T
T
k
k
k
E
E
E
E
E
E
"}
(14,1,1) = {"
E
E
E
E
E
E
E
E
E
E
E
k
k
k
k
k
k
k
k
k
T
Y
d
d
T
i
m
m
m
r
T
k
k
F
F
E
E
E
E
E
"}
(15,1,1) = {"
E
E
E
E
E
E
E
E
E
E
E
k
k
k
k
k
k
k
k
k
T
d
d
d
T
c
m
m
m
m
T
T
T
j
j
j
E
E
E
E
"}
(16,1,1) = {"
E
E
E
E
E
E
E
E
E
E
E
k
k
k
k
k
k
k
k
k
T
z
s
d
T
m
m
m
m
m
e
I
Z
j
j
j
E
E
E
E
"}
(17,1,1) = {"
E
E
E
E
E
E
E
E
E
E
E
k
k
k
k
k
k
k
k
k
T
P
g
d
V
m
m
m
m
m
T
T
T
j
j
j
E
E
E
E
"}
(18,1,1) = {"
E
E
E
E
E
E
E
E
E
E
E
k
k
k
k
k
k
k
k
k
T
T
T
T
T
T
T
m
m
S
T
k
k
F
F
E
E
E
E
E
"}
(19,1,1) = {"
E
E
E
E
E
E
E
E
E
E
E
k
k
k
k
k
k
k
k
k
k
k
k
k
k
k
T
m
m
y
T
k
k
F
E
E
E
E
E
E
"}
(20,1,1) = {"
E
E
E
E
E
E
E
E
E
E
E
k
k
k
k
k
k
k
k
k
k
k
k
k
k
k
T
m
m
O
T
k
k
k
E
E
E
E
E
E
"}
(21,1,1) = {"
E
E
E
E
E
E
E
E
E
E
E
k
k
k
k
k
k
k
k
k
k
k
k
k
k
k
T
m
m
J
T
k
k
k
k
E
E
E
E
E
"}
(22,1,1) = {"
E
E
E
E
E
E
E
E
E
E
E
k
k
k
k
k
k
k
k
k
k
k
k
T
T
T
T
C
T
T
T
T
T
T
k
E
E
E
E
E
"}
(23,1,1) = {"
E
E
E
E
E
E
E
E
E
E
E
k
k
k
k
k
k
k
k
k
k
k
k
T
h
g
d
d
d
w
d
x
d
T
k
k
E
E
E
E
"}
(24,1,1) = {"
E
E
E
E
E
E
E
E
E
E
E
k
k
k
k
k
k
k
k
k
k
k
k
T
d
b
d
d
d
d
P
t
h
T
k
k
E
E
E
E
"}
(25,1,1) = {"
E
E
E
E
E
E
E
E
E
E
E
k
k
k
k
k
k
k
k
k
k
k
k
T
f
M
d
d
d
d
d
a
f
T
k
k
E
E
E
E
"}
(26,1,1) = {"
E
E
E
E
E
E
E
E
E
E
E
k
k
k
k
k
k
k
k
k
k
k
k
T
h
g
d
h
v
d
d
z
d
T
k
k
E
E
E
E
"}
(27,1,1) = {"
E
E
E
E
E
E
E
E
E
E
E
k
k
k
k
k
k
k
k
k
k
k
k
T
d
b
d
d
d
d
d
t
h
T
k
k
E
E
E
E
"}
(28,1,1) = {"
E
E
E
E
E
E
E
E
E
E
E
k
k
k
k
k
k
k
k
k
k
k
k
T
f
M
f
z
f
f
z
a
f
T
k
k
E
E
E
E
"}
(29,1,1) = {"
E
E
E
E
E
E
E
E
E
E
E
E
k
k
k
k
k
k
k
k
k
k
k
T
d
d
d
d
g
h
d
d
d
T
k
k
E
E
E
E
"}
(30,1,1) = {"
E
E
E
E
E
E
E
E
E
E
E
E
E
k
k
k
k
k
k
k
k
k
k
T
d
h
d
R
g
d
d
h
T
T
k
E
E
E
E
E
"}
(31,1,1) = {"
E
E
E
E
E
E
E
E
E
E
E
E
E
E
k
k
k
k
k
k
k
k
k
T
T
T
T
T
T
T
T
T
T
E
E
E
E
E
E
E
"}
(32,1,1) = {"
E
E
E
E
E
E
E
E
E
E
E
E
E
E
E
k
k
k
k
k
k
k
k
k
k
k
k
k
k
k
k
k
E
E
E
E
E
E
E
E
"}
(33,1,1) = {"
E
E
E
E
E
E
E
E
E
E
E
E
E
E
E
E
k
k
k
k
k
k
k
k
k
k
k
k
k
E
k
E
E
E
E
E
E
E
E
E
"}
(34,1,1) = {"
E
E
E
E
E
E
E
E
E
E
E
E
E
E
E
E
E
E
k
k
k
k
k
k
k
k
k
k
E
E
E
E
E
E
E
E
E
E
E
E
"}
(35,1,1) = {"
E
E
E
E
E
E
E
E
E
E
E
E
E
E
E
E
E
E
E
E
E
E
E
E
E
E
E
E
E
E
E
E
E
E
E
E
E
E
E
E
"}
(36,1,1) = {"
E
E
E
E
E
E
E
E
E
E
E
E
E
E
E
E
E
E
E
E
E
E
E
E
E
E
E
E
E
E
E
E
E
E
E
E
E
E
E
E
"}
(37,1,1) = {"
E
E
E
E
E
E
E
E
E
E
E
E
E
E
E
E
E
E
E
E
E
E
E
E
E
E
E
E
E
E
E
E
E
E
E
E
E
E
E
E
"}
(38,1,1) = {"
E
E
E
E
E
E
E
E
E
E
E
E
E
E
E
E
E
E
E
E
E
E
E
E
E
E
E
E
E
E
E
E
E
E
E
E
E
E
E
E
"}
(39,1,1) = {"
E
E
E
E
E
E
E
E
E
E
E
E
E
E
E
E
E
E
E
E
E
E
E
E
E
E
E
E
E
E
E
E
E
E
E
E
E
E
E
E
"}
(40,1,1) = {"
E
E
E
E
E
E
E
E
E
E
E
E
E
E
E
E
E
E
E
E
E
E
E
E
E
E
E
E
E
E
E
E
E
E
E
E
E
E
E
E
"}
