"d" = (/obj/item/hemostat/alien,/turf/open/floor/plating/abductor{initial_gas_mix = "TEMP=2.7"},/area/ruin/powered)
"g" = (/obj/structure/closet/abductor,/turf/open/floor/plating/abductor{initial_gas_mix = "TEMP=2.7"},/area/ruin/powered)
"q" = (/turf/closed/wall/mineral/abductor,/area/ruin/powered)
"r" = (/turf/closed/mineral,/area/ruin/powered)
"u" = (/obj/structure/table/abductor,/obj/item/storage/box/alienhandcuffs,/turf/open/floor/plating/abductor{initial_gas_mix = "TEMP=2.7"},/area/ruin/powered)
"w" = (/turf/open/floor/plating/asteroid/airless,/area/ruin/powered)
"B" = (/obj/item/scalpel/alien,/obj/item/surgical_drapes,/turf/open/floor/plating/abductor{initial_gas_mix = "TEMP=2.7"},/area/ruin/powered)
"F" = (/obj/structure/bed/abductor,/turf/open/floor/plating/abductor{initial_gas_mix = "TEMP=2.7"},/area/ruin/powered)
"G" = (/obj/machinery/abductor/gland_dispenser,/turf/open/floor/plating/abductor{initial_gas_mix = "TEMP=2.7"},/area/ruin/powered)
"I" = (/obj/machinery/abductor/experiment{team_number = 100},/turf/open/floor/plating/abductor{initial_gas_mix = "TEMP=2.7"},/area/ruin/powered)
"K" = (/obj/machinery/abductor/pad{team_number = 100},/turf/open/floor/plating/abductor{initial_gas_mix = "TEMP=2.7"},/area/ruin/powered)
"L" = (/obj/effect/mob_spawn/human/abductor,/turf/open/floor/plating/abductor{initial_gas_mix = "TEMP=2.7"},/area/ruin/powered)
"N" = (/obj/structure/table/optable/abductor,/obj/item/cautery/alien,/turf/open/floor/plating/abductor{initial_gas_mix = "TEMP=2.7"},/area/ruin/powered)
"O" = (/turf/template_noop,/area/template_noop)
"V" = (/turf/open/floor/plating/abductor{initial_gas_mix = "TEMP=2.7"},/area/ruin/powered)
"Y" = (/obj/structure/table/abductor,/obj/item/surgicaldrill/alien,/obj/item/circular_saw/alien,/turf/open/floor/plating/abductor{initial_gas_mix = "TEMP=2.7"},/area/ruin/powered)
"Z" = (/obj/item/retractor/alien,/obj/item/paper/guides/antag/abductor,/turf/open/floor/plating/abductor{initial_gas_mix = "TEMP=2.7"},/area/ruin/powered)

(1,1,1) = {"
OOOOOOOOOOOOOOOOOOOOOOOOOOOOOOOOOOOOOOOO
OOOOOOOOOOOOOOOOOOOOOOOOOOOOOOOOOOOOOOOO
OOOOOOOOOOOOOOOOOOOOOOOOOOOOOOOOOOOOOOOO
OOOOOOOOOOOOOOOOOOOOOOOOOOOOOOOOOOOOOOOO
OOOOOOOOOOOOOOOOOOOOOOOOOOOOOOOOOOOOOOOO
OOOOOOOOOOOOOOOOOOOOOOOOOOOOOOOOOOOOOOOO
OOOOOOOOOOOOOOOOOOOOOOOOOOOOOOOOOOOOOOOO
OOOOOOOOOOOOOOOOOOOOOOOOOOOOOOOOOOOOOOOO
OOOOOOOOOOOOOOOOOOOOOrrrrrOrrOOOOOOOOOOO
OOOOOOOOOOOOOOOOOOOrrrrrrrrrrrrOOOOOOOOO
OOOOOOOOOOOOOOOrrrrrrrrrrrrrrrrrOOOOOOOO
OOOOOOOOOrrrrrrrrrrrrrrrrrrrrrrrrOOOOOOO
OOOOOOOOrrrrrrrrrrrrrrrrrrrrrrrrrOOOOOOO
OOOOOOOrrrrrrrrrrrrrrrrrrrrrrrrrrrOOOOOO
OOOOOOOrrrrrrrrrrrrrrrrrrrrrrrrrrrOOOOOO
OOOOOOrrrrrrrrrrrrrrrrrrrrrrrrrrrrOOOOOO
OOOOOrrrrrrrrrrrrrrrrrrrrrrrrrrrrrOOOOOO
OOOOOrrrrrrrrrrrrrrrrrrrrrrrrrrrrOOOOOOO
OOOOrrrrrrrrrrrrrrrrrrrrrrrrrrrrrOOOOOOO
OOOOrrrrrrrrrrrrrrrrrrrrrrrrrrrrOOOOOOOO
OOOrrrrrrrrrrrrrrrrrrrrrrrrrrrrrOOOOOOOO
OOOrrrrrrrrrrrrrrrrrrrrrrrrrrrrrOOOOOOOO
OOOOrrrrrrrrrrrrrrrrrrrrrrrrrrrrOOOOOOOO
OOOOOrrrrrrrrrrrrrrrrrrrrrrrrrrOOOOOOOOO
OOOOOrrrrrrrrrrrrrrrrrrrrrrrrrrOOOOOOOOO
OOOOOrrrrrrqqqqqrrrrrrrrrrrrrrOOOOOOOOOO
OOOOOOrrrrqqIdKqqrrrrrrrrrrrrrOOOOOOOOOO
OOOOOOrrrrqVVVLgqrrrrrrrrrrrrrOOOOOOOOOO
OOOOOOOrrrwVVNVuqrrrrrrrrrrrrOOOOOOOOOOO
OOOOOOOwrwwVVBZgqrrrrrrrrrrrOOOOOOOOOOOO
OOOOOOOwwwqqGYFqqrrrrrrrrrrOOOOOOOOOOOOO
OOOOOOOwwwwqqqqqrrrrrrrrrOOOOOOOOOOOOOOO
OOOOOOOOwwwwwwrrrrrrrrrOOOOOOOOOOOOOOOOO
OOOOOOOOOwwwwrrrrrrrrOOOOOOOOOOOOOOOOOOO
OOOOOOOOOOOwwrrrrrrrOOOOOOOOOOOOOOOOOOOO
OOOOOOOOOOOOOOrrrrrOOOOOOOOOOOOOOOOOOOOO
OOOOOOOOOOOOOOOrrOOOOOOOOOOOOOOOOOOOOOOO
OOOOOOOOOOOOOOOOOOOOOOOOOOOOOOOOOOOOOOOO
OOOOOOOOOOOOOOOOOOOOOOOOOOOOOOOOOOOOOOOO
OOOOOOOOOOOOOOOOOOOOOOOOOOOOOOOOOOOOOOOO
"}
