"i" = (/turf/open/floor/plating/asteroid,/area/ruin/powered)
"p" = (/turf/template_noop,/area/template_noop)
"O" = (/obj/item/stack/sheet/mineral/sandstone{desc = "It's a brick.";name = "brick"},/turf/open/floor/plating/asteroid,/area/ruin/powered)
"Y" = (/turf/closed/mineral,/area/ruin/powered)

(1,1,1) = {"
pppppppppppppppppppppppppppppppppppppppp
pppppppppppppppppppppppppppppppppppppppp
pppppppppppppppppppYYYYYpppppppppppppppp
pppppppppppppppppYYYYYYYYYYppppppppppppp
pppppppppppppYYYYYYYYYYYYYYYpppppppppppp
pppppppppppYYYYYYYYYYYYYYYYYYppppppppppp
pppppppppYYYYYYYYiiiYYYYYYYYYYpppppppppp
pppppppYYYYYYYYYYiOiYYYYYYYYYYpppppppppp
ppppppYYYYYYYYYYYiiiYYYYYYYYYYYppppppppp
pppppYYYYYYYYYYYYYYYYYYYYYYYYYYppppppppp
pppppYYYYYYYYYYYYYYYYYYYYYYYYYYppppppppp
pppppYYYYYYYYYYYYYYYYYYYYYYYYYYppppppppp
pppppYYYYYYYYYYYYYYYYYYYYYYYYYYppppppppp
pppppYYYYYYYYYYYYYYYYYYYYYYYYYYppppppppp
pppppYYYYYYYYYYYYYYYYYYYYYYYYYYYpppppppp
pppppYYYYYYYYYYYYYYYYYYYYYYYYYYYpppppppp
pppppYYYYYYYYYYYYYYYYYYYYYYYYYYYpppppppp
pppppYYYYYYYYYYYYYYYYYYYYYYYYYYppppppppp
pppppYYYYYYYYYYYYYYYYYYYYYYYYYYppppppppp
ppppppYYYYYYYYYYYYYYYYYYYYYYYYpppppppppp
ppppppYYYYYYYYYYYYYYYYYYYYYYYppppppppppp
ppppppYYYYYYYYYYYYYYYYYYYYYYpppppppppppp
ppppppYYYYYYYYYYYYYYYYYYYYYYpppppppppppp
pppppppYYYYYYYYYYYYYYYYYYYYYYppppppppppp
pppppppYYYYYYYYYYYYYYYYYYYYYYppppppppppp
pppppppYYYYYYYYYYYYYYYYYYYYYYppppppppppp
ppppppppYYYYYYYYYYYYYYYYYYYYYppppppppppp
pppppppppYYYYYYYYYYYYYYYYYYYYppppppppppp
pppppppppYYYYYYYYYYYYYYYYYYYpppppppppppp
ppppppppppYYYYYYYYYYYYYYYYYYpppppppppppp
ppppppppppYYYYYYYYYYYYYYYYYYYppppppppppp
pppppppppppYYYYYYYYYYYYYYYYYYppppppppppp
ppppppppppppYYYYYYYYYYYYYYYYYYpppppppppp
pppppppppppppYYYYYYYYYYYYYYYYYYppppppppp
ppppppppppppppYYYYYYYYYYYYYYYYYppppppppp
ppppppppppppppppYYYYYYYYYYYYYYpppppppppp
ppppppppppppppppppYYYYYYYYYYYppppppppppp
ppppppppppppppppppppYYYYYYYYpppppppppppp
pppppppppppppppppppppYYYYYYppppppppppppp
pppppppppppppppppppppppppppppppppppppppp
"}
