"aa" = (/obj/structure/lattice,/turf/template_noop,/area/template_noop)
"ab" = (/obj/structure/lattice/catwalk,/turf/template_noop,/area/template_noop)
"aO" = (/obj/structure/chair/comfy/black{dir = 4},/obj/machinery/light{dir = 8},/turf/open/floor/carpet/ship/orange_carpet,/area/ruin/powered)
"bi" = (/obj/structure/table/wood/poker,/obj/machinery/light{dir = 1},/turf/open/floor/carpet/red,/area/ruin/powered)
"bF" = (/turf/closed/wall/steel,/area/ruin/powered)
"dK" = (/obj/structure/chair/sofa,/turf/open/floor/carpet/royalblack,/area/ruin/powered)
"dZ" = (/obj/structure/toilet{dir = 8},/turf/open/floor/carpet/orange,/area/ruin/powered)
"hq" = (/obj/structure/chair/comfy/brown{dir = 4},/turf/open/floor/carpet/green,/area/ruin/powered)
"hs" = (/obj/effect/decal/cleanable/crayon{icon_state = "a"; paint_colour = "#FFFF00"},/turf/closed/wall/steel,/area/ruin/powered)
"hP" = (/obj/structure/chair/wood/wings{dir = 4},/turf/open/floor/carpet/red,/area/ruin/powered)
"hR" = (/obj/structure/table/wood,/turf/open/floor/carpet/orange,/area/ruin/powered)
"in" = (/obj/structure/chair/wood/wings,/turf/open/floor/carpet/ship/red_carpet,/area/ruin/powered)
"kF" = (/obj/structure/table/wood,/turf/open/floor/carpet/ship/red_carpet,/area/ruin/powered)
"kP" = (/turf/open/floor/wood,/area/ruin/powered)
"ld" = (/obj/item/stack/tile/fakespace/loaded,/obj/item/stack/tile/fakespace/loaded,/obj/structure/closet/crate,/turf/open/floor/wood,/area/ruin/powered)
"lm" = (/obj/structure/mineral_door/wood,/turf/open/floor/wood,/area/ruin/powered)
"nt" = (/obj/structure/table/wood/fancy/red,/turf/open/floor/carpet/ship/orange_carpet,/area/ruin/powered)
"nF" = (/obj/item/stack/sheet/plastic/fifty,/obj/item/stack/sheet/plastic/fifty,/obj/structure/closet/crate,/obj/machinery/light{dir = 1},/turf/open/floor/wood,/area/ruin/powered)
"on" = (/obj/structure/table/wood/poker,/turf/open/floor/carpet/red,/area/ruin/powered)
"oH" = (/obj/structure/bed,/obj/item/bedsheet/random,/turf/open/floor/carpet/ship/blue,/area/ruin/powered)
"pz" = (/obj/structure/chair/sofa/left,/turf/open/floor/carpet/royalblack,/area/ruin/powered)
"pW" = (/obj/structure/chair/wood/wings{dir = 8},/turf/open/floor/carpet/red,/area/ruin/powered)
"ra" = (/obj/machinery/door/airlock/ship/external/glass,/obj/effect/mapping_helpers/airlock/cyclelink_helper,/turf/open/floor/plating,/area/ruin/powered)
"rg" = (/turf/template_noop,/area/template_noop)
"rG" = (/obj/effect/decal/cleanable/crayon{icon_state = "k"; paint_colour = "#FFFF00"},/turf/closed/wall/steel,/area/ruin/powered)
"sU" = (/obj/item/stack/sheet/paperframes/fifty,/obj/item/stack/sheet/paperframes/fifty,/obj/structure/closet/crate,/turf/open/floor/wood,/area/ruin/powered)
"sY" = (/obj/structure/chair/wood/wings{dir = 1},/turf/open/floor/carpet/red,/area/ruin/powered)
"tG" = (/obj/item/storage/toolbox/artistic,/obj/structure/rack,/turf/open/floor/wood,/area/ruin/powered)
"ub" = (/obj/structure/toilet{dir = 4},/turf/open/floor/carpet/orange,/area/ruin/powered)
"uQ" = (/obj/item/gavelblock,/obj/structure/table/wood,/turf/open/floor/carpet/ship/red_carpet,/area/ruin/powered)
"ve" = (/obj/machinery/jukebox,/turf/open/floor/wood,/area/ruin/powered)
"wS" = (/turf/open/floor/carpet/black,/area/ruin/powered)
"xr" = (/obj/effect/spawner/structure/window/reinforced,/turf/open/floor/plating,/area/ruin/powered)
"yn" = (/obj/structure/chair/comfy/shuttle,/turf/open/floor/carpet/blue,/area/ruin/powered)
"yy" = (/obj/structure/chair/comfy/brown{dir = 1},/turf/open/floor/carpet/green,/area/ruin/powered)
"Am" = (/obj/structure/table/wood,/turf/open/floor/wood,/area/ruin/powered)
"Bp" = (/obj/item/stack/sheet/mineral/sandstone/thirty,/obj/item/stack/sheet/mineral/sandstone/thirty,/obj/structure/closet/crate,/turf/open/floor/wood,/area/ruin/powered)
"DJ" = (/obj/item/stack/tile/carpet/black/fifty,/obj/item/stack/tile/carpet/blue/fifty,/obj/item/stack/tile/carpet/cyan/fifty,/obj/item/stack/tile/carpet/fifty,/obj/item/stack/tile/carpet/green/fifty,/obj/item/stack/tile/carpet/orange/fifty,/obj/item/stack/tile/carpet/purple/fifty,/obj/item/stack/tile/carpet/red/fifty,/obj/item/stack/tile/carpet/royalblack/fifty,/obj/item/stack/tile/carpet/royalblue/fifty,/obj/structure/closet/crate,/turf/open/floor/wood,/area/ruin/powered)
"DN" = (/obj/item/stack/sheet/nanocarbon_glass/fifty,/obj/item/stack/sheet/nanocarbon_glass/fifty,/obj/structure/closet/crate,/turf/open/floor/wood,/area/ruin/powered)
"EQ" = (/obj/structure/chair/comfy/black{dir = 4},/turf/open/floor/carpet/ship/orange_carpet,/area/ruin/powered)
"FL" = (/obj/vehicle/ridden/wheelchair/motorized{dir = 8},/turf/open/floor/carpet/green,/area/ruin/powered)
"Gm" = (/obj/item/storage/toolbox/electrical,/obj/structure/rack,/turf/open/floor/wood,/area/ruin/powered)
"It" = (/obj/structure/table/glass,/turf/open/floor/carpet/blue,/area/ruin/powered)
"ID" = (/obj/structure/chair/sofa/right,/turf/open/floor/carpet/royalblack,/area/ruin/powered)
"Jm" = (/turf/open/floor/carpet/green,/area/ruin/powered)
"Kc" = (/turf/open/floor/carpet/red,/area/ruin/powered)
"LL" = (/turf/open/floor/plating,/area/ruin/powered)
"LP" = (/obj/item/gavelhammer,/obj/structure/table/wood,/turf/open/floor/carpet/ship/red_carpet,/area/ruin/powered)
"NS" = (/obj/item/storage/toolbox/mechanical,/obj/structure/rack,/turf/open/floor/wood,/area/ruin/powered)
"Oe" = (/turf/open/floor/carpet/ship/blue,/area/ruin/powered)
"Ok" = (/obj/machinery/light{dir = 4},/turf/open/floor/wood,/area/ruin/powered)
"Ox" = (/obj/structure/table/wood/fancy/black,/turf/open/floor/carpet/green,/area/ruin/powered)
"PV" = (/turf/closed/mineral,/area/ruin/powered)
"Qv" = (/obj/structure/table/wood,/obj/machinery/light,/turf/open/floor/carpet/black,/area/ruin/powered)
"Qw" = (/obj/structure/table/glass,/obj/machinery/light,/turf/open/floor/carpet/blue,/area/ruin/powered)
"Sv" = (/obj/structure/fans/tiny/invisible,/obj/machinery/door/airlock/ship/external/glass,/obj/effect/mapping_helpers/airlock/cyclelink_helper{dir = 1},/turf/open/floor/plating,/area/ruin/powered)
"SU" = (/obj/machinery/microwave,/obj/structure/table/wood,/turf/open/floor/wood,/area/ruin/powered)
"TH" = (/obj/structure/table/wood/fancy/royalblack,/turf/open/floor/carpet/royalblack,/area/ruin/powered)
"Vq" = (/obj/item/stack/sheet/mineral/wood/fifty,/obj/item/stack/sheet/mineral/wood/fifty,/obj/structure/closet/crate,/turf/open/floor/wood,/area/ruin/powered)
"VG" = (/obj/machinery/light{dir = 8},/turf/open/floor/carpet/ship/blue,/area/ruin/powered)
"Wl" = (/obj/structure/table/wood,/turf/open/floor/carpet/black,/area/ruin/powered)
"WS" = (/obj/effect/decal/cleanable/crayon{icon_state = "i"; paint_colour = "#FFFF00"},/turf/closed/wall/steel,/area/ruin/powered)
"XD" = (/obj/structure/closet/secure_closet/freezer{name = "DNA vault"},/obj/item/dnainjector/swedishmut,/obj/item/dnainjector/swedishmut,/obj/item/dnainjector/swedishmut,/obj/item/dnainjector/swedishmut,/turf/open/floor/wood,/area/ruin/powered)
"Ya" = (/obj/machinery/light{dir = 8},/turf/open/floor/wood,/area/ruin/powered)
"Ye" = (/turf/open/floor/carpet/royalblack,/area/ruin/powered)
"Zg" = (/obj/structure/chair/office/light,/turf/open/floor/carpet/black,/area/ruin/powered)
"ZH" = (/obj/structure/chair/comfy/black{dir = 8},/turf/open/floor/carpet/ship/orange_carpet,/area/ruin/powered)
"ZR" = (/obj/effect/decal/cleanable/crayon{icon_state = "e"; paint_colour = "#FFFF00"},/turf/closed/wall/steel,/area/ruin/powered)

(1,1,1) = {"
rgrgrgrgrgrgrgrgrgrgrgrgrgrgrgrgrgrgrgrgrgrgrgrgrgrgrgrgrgrgrgrgrgrgrgrgrgrgrgrg
rgrgrgrgrgrgrgrgrgrgrgrgrgrgrgrgrgrgrgrgrgrgrgrgrgrgrgrgrgrgrgrgrgrgrgrgrgrgrgrg
rgrgrgrgrgrgrgrgrgrgrgrgrgrgrgrgrgrgrgrgrgrgrgrgrgrgrgrgrgrgrgrgrgrgrgrgrgrgrgrg
rgrgrgrgrgrgrgrgrgrgrgrgrgrgrgrgrgrgrgrgrgrgrgrgrgrgrgrgrgrgrgrgrgrgrgrgrgrgrgrg
rgrgrgrgrgrgrgrgrgrgrgrgrgrgrgrgrgrgPVrgrgrgrgrgrgrgrgrgrgrgrgrgrgrgrgrgrgrgrgrg
rgrgrgrgrgrgrgrgrgrgrgrgrgrgrgrgrgPVPVPVPVrgrgrgrgrgrgrgrgrgrgrgrgrgrgrgrgrgrgrg
rgrgrgrgrgrgrgrgrgrgrgrgrgrgPVPVPVPVPVPVPVPVrgrgrgrgrgrgrgrgrgrgrgrgrgrgrgrgrgrg
rgrgrgrgrgrgrgrgrgrgrgPVPVPVPVPVPVPVPVPVPVPVPVPVPVrgrgrgrgrgrgrgrgrgrgrgrgrgrgrg
rgrgrgrgrgrgrgrgrgrgPVPVPVPVPVPVPVPVPVPVPVPVPVPVPVPVPVrgrgrgrgrgrgrgrgrgrgrgrgrg
rgrgrgrgrgrgrgrgrgPVPVPVPVPVPVPVPVPVPVPVPVPVPVPVPVPVPVPVrgrgrgrgrgrgrgrgrgrgrgrg
rgrgrgrgrgrgrgPVPVPVPVPVPVPVPVPVPVPVPVPVPVPVPVPVPVPVPVPVPVPVrgrgrgrgrgrgrgrgrgrg
rgrgrgrgrgrgPVPVPVPVPVPVPVPVPVPVPVPVPVPVPVPVPVPVPVPVPVPVPVPVPVrgrgrgrgrgrgrgrgrg
rgrgrgrgrgrgPVPVPVPVPVPVPVPVPVPVPVPVPVPVPVPVPVPVPVPVPVPVPVPVPVPVrgrgrgrgrgrgrgrg
rgrgrgrgrgPVPVPVPVPVPVPVPVPVPVPVPVPVPVPVPVPVPVPVPVPVPVPVPVPVPVPVPVrgrgrgrgrgrgrg
rgrgrgrgrgPVPVPVPVPVPVPVPVPVPVPVPVPVPVPVPVPVPVPVPVPVPVPVPVPVPVPVPVPVrgrgrgrgrgrg
rgrgrgrgPVPVPVPVPVPVPVPVPVPVPVPVPVPVPVPVPVPVPVPVPVPVPVPVPVPVPVPVPVPVPVrgrgrgrgrg
rgrgrgrgPVPVPVPVPVPVPVPVPVPVPVPVPVPVPVPVPVPVPVPVPVPVPVPVPVPVPVPVPVPVPVrgrgrgrgrg
rgrgrgPVPVPVPVPVPVPVPVPVPVPVPVPVPVPVPVPVPVPVPVPVPVPVPVPVPVPVPVPVPVPVPVrgrgrgrgrg
rgrgPVPVPVPVPVPVPVPVPVPVPVPVPVPVPVPVPVPVPVPVPVPVPVPVPVPVPVPVPVPVPVPVPVrgrgrgrgrg
rgrgPVPVPVPVPVPVPVPVPVPVPVPVPVPVPVPVPVPVPVPVPVPVPVPVPVPVPVPVPVPVPVPVrgrgrgrgrgrg
rgrgPVPVPVPVPVPVPVPVPVPVPVPVPVPVPVPVPVPVPVPVPVPVPVPVPVPVPVPVPVPVPVPVPVrgrgrgrgrg
rgrgPVPVPVPVPVPVPVPVPVPVPVPVPVPVPVPVPVPVPVPVPVPVPVPVPVPVPVPVPVPVPVPVPVrgrgrgrgrg
rgrgPVPVPVbFbFbFbFbFbFbFbFbFPVPVPVPVPVPVPVPVPVPVPVPVPVPVPVPVPVPVPVPVPVrgrgrgrgrg
rgrgrgPVbFbFBpVqsUDNnFldDJbFPVPVPVPVPVPVPVPVPVPVPVPVPVPVPVPVPVPVPVPVPVrgrgrgrgrg
rgrgrgrgWSXDkPkPkPkPkPkPkPbFbFbFbFbFbFbFbFbFbFbFbFPVPVPVPVPVPVPVPVPVPVrgrgrgrgrg
rgrgrgrgrGkPkPkFinkFkPkPbFbFYeIDdKpzkPbFhPbionpWbFbFPVPVPVPVPVPVPVPVrgrgrgrgrgrg
rgrgrgrgZRkPkPuQkFLPkPbFbFveYeTHTHTHOkbFhPononpWkPbFbFPVPVPVPVPVPVPVrgrgrgrgrgrg
rgrgrgrghsYakPkPkPkPkPlmkPkPkPkPkPkPkPkPKcsYsYKckPkPbFPVPVPVPVPVPVrgrgrgrgrgrgrg
rgrgrgrgbFtGGmNSNSbFbFbFYaubhRdZkPkPkPkPkPkPkPkPkPkPbFbFbFPVPVPVPVrgrgrgrgrgrgrg
rgrgrgrgbFxrxrxrbFbFkPkPkPubhRdZkPkPkPkPkPJmJmJmJmkPkPkPbFbFPVPVrgrgrgrgrgrgrgrg
rgrgrgrgrgrgrgrgbFSUkPkPkPkPkPkPkPkPOkbFYahqOxOxFLOkbFVGoHbFPVPVrgrgrgrgrgrgrgrg
rgrgrgrgrgrgrgrgxrAmkPkPEQntntZHkPkPkPkPkPhqOxOxJmkPkPOeoHbFPVrgrgrgrgrgrgrgrgrg
rgrgrgrgrgrgrgrgxrAmOkbFaOntntZHkPkPkPkPkPJmyyyyJmkPkPOeoHbFrgrgrgrgrgrgrgrgrgrg
rgrgrgrgrgrgrgrgbFAmkPkPkPkPkPkPkPkPkPkPkPkPkPkPkPkPkPOeoHbFrgrgrgrgrgrgrgrgrgrg
rgrgrgrgrgrgrgrgbFbFkPkPItynynItkPbFrabFkPWlZgwSwSkPkPkPbFbFrgrgrgrgrgrgrgrgrgrg
rgrgrgrgrgrgrgrgrgbFbFkPItItQwItkPbFLLbFkPWlWlQvwSkPkPbFbFrgrgrgrgrgrgrgrgrgrgrg
rgrgrgrgrgrgrgrgrgrgbFbFWSrGZRhsbFbFSvbFWSrGZRhsbFbFbFbFrgrgrgrgrgrgrgrgrgrgrgrg
rgrgrgrgrgrgrgrgrgrgrgrgrgrgrgrgrgaaabaargrgrgrgrgrgrgrgrgrgrgrgrgrgrgrgrgrgrgrg
rgrgrgrgrgrgrgrgrgrgrgrgrgrgrgrgrgrgrgrgrgrgrgrgrgrgrgrgrgrgrgrgrgrgrgrgrgrgrgrg
rgrgrgrgrgrgrgrgrgrgrgrgrgrgrgrgrgrgrgrgrgrgrgrgrgrgrgrgrgrgrgrgrgrgrgrgrgrgrgrg
"}
