//MAP CONVERTED BY dmm2tgm.py THIS HEADER COMMENT PREVENTS RECONVERSION, DO NOT REMOVE
"aa" = (
/turf/template_noop,
/area/template_noop)
"ab" = (
/turf/closed/mineral,
/area/ruin/powered)
"ac" = (
/turf/closed/wall/steel,
/area/ruin/powered)
"ad" = (
/obj/effect/decal/cleanable/blood/old,
/obj/effect/decal/cleanable/dirt,
/turf/open/floor/monotile/dark,
/area/ruin/powered)
"ae" = (
/obj/structure/closet/crate/freezer/surplus_limbs,
/obj/effect/decal/cleanable/dirt,
/turf/open/floor/monotile/dark,
/area/ruin/powered)
"af" = (
/obj/structure/closet/crate/freezer{
	name = "cat tails"
	},
/obj/item/organ/tail/cat,
/obj/item/organ/tail/cat,
/obj/item/organ/tail/cat,
/obj/item/organ/tail/cat,
/obj/item/organ/tail/cat,
/obj/item/organ/tail/cat,
/obj/machinery/light/small{
	dir = 1
	},
/obj/effect/decal/cleanable/dirt,
/turf/open/floor/monotile/dark,
/area/ruin/powered)
"ag" = (
/obj/structure/closet/crate/freezer{
	name = "cat ears"
	},
/obj/item/organ/ears/cat,
/obj/item/organ/ears/cat,
/obj/item/organ/ears/cat,
/obj/item/organ/ears/cat,
/obj/item/organ/ears/cat,
/obj/item/organ/ears/cat,
/obj/effect/decal/cleanable/dirt,
/turf/open/floor/monotile/dark,
/area/ruin/powered)
"ah" = (
/obj/machinery/atmospherics/components/unary/vent_pump/siphon/atmos{
	dir = 1;
	id_tag = "o2_out_cat";
	name = "freezer vent"
	},
/obj/structure/closet/crate/freezer{
	name = "cat hide"
	},
/obj/item/stack/sheet/animalhide/human,
/obj/item/stack/sheet/animalhide/human,
/obj/item/stack/sheet/animalhide/human,
/obj/item/stack/sheet/animalhide/human,
/obj/item/stack/sheet/animalhide/human,
/obj/item/stack/sheet/animalhide/human,
/obj/item/stack/sheet/animalhide/human,
/obj/item/stack/sheet/animalhide/human,
/obj/item/stack/sheet/animalhide/human,
/obj/item/stack/sheet/animalhide/human,
/obj/item/stack/sheet/animalhide/human,
/obj/effect/decal/cleanable/dirt,
/turf/open/floor/monotile/dark,
/area/ruin/powered)
"ai" = (
/obj/effect/decal/cleanable/dirt,
/turf/open/floor/monotile/dark,
/area/ruin/powered)
"aj" = (
/obj/structure/closet/crate/freezer{
	name = "cat meat"
	},
/obj/item/reagent_containers/food/snacks/meat/slab/synthmeat{
	desc = "A slab of cat meat. Tastes like furball.";
	name = "cat meat"
	},
/obj/item/reagent_containers/food/snacks/meat/slab/synthmeat{
	desc = "A slab of cat meat. Tastes like furball.";
	name = "cat meat"
	},
/obj/item/reagent_containers/food/snacks/meat/slab/synthmeat{
	desc = "A slab of cat meat. Tastes like furball.";
	name = "cat meat"
	},
/obj/item/reagent_containers/food/snacks/meat/slab/synthmeat{
	desc = "A slab of cat meat. Tastes like furball.";
	name = "cat meat"
	},
/obj/item/reagent_containers/food/snacks/meat/slab/synthmeat{
	desc = "A slab of cat meat. Tastes like furball.";
	name = "cat meat"
	},
/obj/item/reagent_containers/food/snacks/meat/slab/synthmeat{
	desc = "A slab of cat meat. Tastes like furball.";
	name = "cat meat"
	},
/obj/item/reagent_containers/food/snacks/meat/slab/synthmeat{
	desc = "A slab of cat meat. Tastes like furball.";
	name = "cat meat"
	},
/obj/item/reagent_containers/food/snacks/meat/slab/synthmeat{
	desc = "A slab of cat meat. Tastes like furball.";
	name = "cat meat"
	},
/obj/effect/decal/cleanable/dirt,
/turf/open/floor/monotile/dark,
/area/ruin/powered)
"ak" = (
/obj/machinery/door/airlock/ship/station{
	name = "Surgery storage"
	},
/turf/open/floor/monotile/dark,
/area/ruin/powered)
"al" = (
/turf/open/floor/monotile/light,
/area/ruin/powered)
"am" = (
/obj/effect/spawner/structure/window/reinforced,
/obj/machinery/door/poddoor/preopen{
	id = "anti_dog_door";
	name = "feline protection door"
	},
/turf/open/floor/plating,
/area/ruin/powered)
"an" = (
/obj/effect/decal/cleanable/dirt,
/obj/effect/decal/cleanable/dirt,
/turf/open/floor/monotile/dark,
/area/ruin/powered)
"ao" = (
/obj/item/reagent_containers/glass/bowl,
/obj/item/reagent_containers/food/snacks/meat/slab/synthmeat{
	desc = "A slab of cat meat. Tastes like furball.";
	name = "cat meat"
	},
/obj/machinery/light/small{
	dir = 1
	},
/obj/effect/decal/cleanable/dirt,
/obj/effect/decal/cleanable/dirt,
/turf/open/floor/monotile/dark,
/area/ruin/powered)
"ap" = (
/obj/structure/bed/dogbed{
	name = "kitty bed"
	},
/obj/effect/mob_spawn/human/corpse/damaged{
	head = /obj/item/clothing/head/kitty
	},
/obj/effect/decal/cleanable/dirt,
/obj/effect/decal/cleanable/dirt,
/turf/open/floor/monotile/dark,
/area/ruin/powered)
"aq" = (
/obj/machinery/door/window/westleft{
	name = "kitty door";
	req_access_txt = "200"
	},
/obj/effect/decal/cleanable/dirt,
/obj/effect/decal/cleanable/dirt,
/obj/machinery/door/poddoor/preopen{
	id = "anti_dog_door";
	name = "feline protection door"
	},
/turf/open/floor/monotile/dark,
/area/ruin/powered)
"ar" = (
/obj/structure/closet,
/obj/item/clothing/under/costume/maid,
/obj/item/clothing/head/kitty,
/obj/item/toy/cattoy,
/turf/open/floor/plating/asteroid/airless,
/area/ruin/powered)
"as" = (
/obj/structure/janitorialcart,
/obj/effect/decal/cleanable/cobweb/cobweb2,
/turf/open/floor/plating/asteroid/airless,
/area/ruin/powered)
"at" = (
/obj/structure/table/wood,
/obj/item/reagent_containers/spray/cleaner,
/turf/open/floor/monotile,
/area/ruin/powered)
"au" = (
/obj/structure/dresser,
/obj/machinery/light{
	dir = 1
	},
/turf/open/floor/monotile,
/area/ruin/powered)
"av" = (
/obj/structure/closet/cabinet,
/obj/item/gps{
	gpstag = "kitty"
	},
/turf/open/floor/monotile,
/area/ruin/powered)
"aw" = (
/obj/structure/rack,
/obj/item/melee/baton/cattleprod,
/obj/item/melee/baton/cattleprod,
/obj/item/restraints/handcuffs,
/obj/item/restraints/handcuffs,
/turf/open/floor/monotile,
/area/ruin/powered)
"ax" = (
/obj/machinery/light{
	dir = 8
	},
/obj/machinery/button/door{
	id = "anti_dog_door";
	name = "Emergency Kitty Protection";
	pixel_x = -24
	},
/turf/open/floor/monotile/light,
/area/ruin/powered)
"ay" = (
/mob/living/simple_animal/hostile/cat_butcherer,
/turf/open/floor/monotile/light,
/area/ruin/powered)
"az" = (
/obj/structure/table/optable,
/obj/effect/mob_spawn/human/corpse/damaged{
	head = /obj/item/clothing/head/kitty
	},
/obj/item/organ/ears/cat,
/obj/effect/decal/cleanable/blood/old,
/turf/open/floor/monotile/light,
/area/ruin/powered)
"aA" = (
/obj/structure/table/reinforced,
/obj/item/clothing/gloves/color/latex,
/obj/item/surgical_drapes,
/obj/machinery/light{
	dir = 4
	},
/turf/open/floor/monotile/light,
/area/ruin/powered)
"aB" = (
/obj/structure/reagent_dispensers/watertank,
/turf/open/floor/plating/asteroid/airless,
/area/ruin/powered)
"aC" = (
/obj/item/mop,
/obj/item/reagent_containers/glass/bucket,
/turf/open/floor/plating/asteroid/airless,
/area/ruin/powered)
"aD" = (
/obj/structure/chair/wood/wings{
	icon_state = "wooden_chair_wings";
	dir = 1
	},
/turf/open/floor/monotile,
/area/ruin/powered)
"aE" = (
/turf/open/floor/monotile,
/area/ruin/powered)
"aF" = (
/obj/effect/decal/cleanable/blood/old,
/obj/item/organ/tail/cat,
/turf/open/floor/monotile/light,
/area/ruin/powered)
"aG" = (
/obj/item/reagent_containers/glass/bowl,
/obj/effect/decal/cleanable/dirt,
/turf/open/floor/monotile/dark,
/area/ruin/powered)
"aH" = (
/obj/structure/bed/dogbed{
	name = "kitty bed"
	},
/obj/effect/decal/cleanable/dirt,
/turf/open/floor/monotile/dark,
/area/ruin/powered)
"aI" = (
/obj/structure/bed/dogbed{
	name = "kitty bed"
	},
/mob/living/simple_animal/pet/cat/space,
/turf/open/floor/monotile,
/area/ruin/powered)
"aJ" = (
/obj/structure/table/reinforced,
/obj/item/retractor,
/obj/item/razor,
/turf/open/floor/monotile/light,
/area/ruin/powered)
"aK" = (
/obj/structure/table/reinforced,
/obj/item/scalpel{
	pixel_y = 12
	},
/turf/open/floor/monotile/light,
/area/ruin/powered)
"aL" = (
/obj/structure/table/reinforced,
/obj/item/hemostat,
/obj/item/cautery{
	pixel_x = 4
	},
/turf/open/floor/monotile/light,
/area/ruin/powered)
"aM" = (
/obj/machinery/door/window/westleft{
	name = "kitty door";
	req_access_txt = "200"
	},
/obj/effect/decal/cleanable/dirt,
/obj/machinery/door/poddoor/preopen{
	id = "anti_dog_door";
	name = "feline protection door"
	},
/turf/open/floor/monotile/dark,
/area/ruin/powered)
"aN" = (
/obj/machinery/light/small,
/obj/effect/decal/cleanable/dirt,
/turf/open/floor/monotile/dark,
/area/ruin/powered)
"aO" = (
/obj/structure/table/wood,
/obj/item/flashlight/lamp,
/turf/open/floor/monotile,
/area/ruin/powered)
"aP" = (
/obj/structure/bed,
/turf/open/floor/monotile,
/area/ruin/powered)
"aQ" = (
/obj/machinery/door/airlock/ship/public{
	name = "Private quarters"
	},
/turf/open/floor/monotile,
/area/ruin/powered)
"aR" = (
/obj/machinery/door/airlock/ship/medical{
	name = "Surgery"
	},
/turf/open/floor/monotile/light,
/area/ruin/powered)
"aS" = (
/obj/machinery/door/window/northleft{
	name = "kitty door";
	req_access_txt = "200"
	},
/obj/effect/decal/cleanable/dirt,
/obj/machinery/door/poddoor/preopen{
	id = "anti_dog_door";
	name = "feline protection door"
	},
/turf/open/floor/monotile/dark,
/area/ruin/powered)
"aT" = (
/obj/effect/spawner/structure/window/reinforced,
/turf/open/floor/plating,
/area/ruin/powered)
"aU" = (
/turf/open/floor/plating/asteroid/airless,
/area/ruin/powered)
"aV" = (
/obj/effect/mapping_helpers/airlock/cyclelink_helper,
/obj/machinery/door/airlock/ship/external/glass,
/turf/open/floor/plating,
/area/ruin/powered)
"aW" = (
/obj/machinery/light/small{
	dir = 8
	},
/obj/effect/decal/cleanable/dirt,
/turf/open/floor/monotile/dark,
/area/ruin/powered)
"aX" = (
/obj/structure/sign/warning/vacuum{
	pixel_x = 32
	},
/turf/open/floor/plating,
/area/ruin/powered)
"aY" = (
/obj/effect/mapping_helpers/airlock/cyclelink_helper{
	dir = 1
	},
/obj/structure/fans/tiny/invisible,
/obj/machinery/door/airlock/ship/external/glass,
/turf/open/floor/plating,
/area/ruin/powered)
"aZ" = (
/obj/structure/lattice,
/turf/template_noop,
/area/template_noop)
"ba" = (
/obj/structure/lattice/catwalk,
/turf/template_noop,
/area/template_noop)

(1,1,1) = {"
aa
aa
aa
aa
aa
aa
aa
aa
aa
aa
aa
aa
aa
aa
aa
aa
aa
aa
aa
aa
aa
aa
aa
aa
aa
aa
aa
aa
aa
aa
aa
aa
aa
aa
aa
aa
aa
aa
aa
aa
"}
(2,1,1) = {"
aa
aa
aa
aa
ab
ab
ab
ab
aa
aa
aa
aa
aa
aa
aa
aa
aa
aa
aa
aa
aa
aa
aa
aa
aa
aa
aa
aa
aa
aa
aa
aa
aa
aa
aa
aa
aa
aa
aa
aa
"}
(3,1,1) = {"
aa
aa
aa
ab
ab
ab
ab
ab
ab
aa
aa
aa
aa
aa
aa
aa
aa
aa
aa
aa
aa
aa
aa
aa
aa
aa
ab
ab
aa
aa
aa
aa
aa
aa
aa
aa
aa
aa
aa
aa
"}
(4,1,1) = {"
aa
aa
ab
ab
ab
ab
ab
ab
ab
ab
aa
aa
aa
aa
aa
aa
aa
aa
aa
aa
aa
aa
aa
aa
ab
ab
ab
ab
ab
aa
aa
aa
aa
aa
aa
aa
aa
aa
aa
aa
"}
(5,1,1) = {"
aa
aa
ab
ab
ab
ab
ab
ab
ab
ab
aa
aa
aa
aa
aa
aa
aa
aa
aa
aa
aa
ab
ab
ab
ab
ab
ab
ab
ab
ab
ab
aa
aa
aa
aa
aa
aa
aa
aa
aa
"}
(6,1,1) = {"
aa
ab
ab
ab
ab
ab
ab
ab
ab
ab
aa
aa
aa
aa
aa
aa
aa
aa
aa
ab
ab
ab
ab
ab
ab
ab
ab
ab
ab
ab
ab
ab
aa
aa
aa
aa
aa
aa
aa
aa
"}
(7,1,1) = {"
aa
ab
ab
ab
ab
ab
ab
ab
ab
ab
aa
aa
aa
aa
aa
aa
aa
ab
ab
ab
ab
ab
ab
ab
ab
ab
ab
ab
ab
ab
ab
ab
ab
aa
aa
aa
aa
aa
aa
aa
"}
(8,1,1) = {"
aa
ab
ab
ab
ab
ab
ab
ab
ab
ab
aa
aa
aa
aa
aa
ab
ab
ab
ab
ab
ab
ab
ab
ab
ab
ab
ab
ab
ab
ab
ab
ab
ab
ab
aa
aa
aa
aa
aa
aa
"}
(9,1,1) = {"
aa
aa
ab
ab
ab
ab
ab
ab
ab
ab
aa
aa
aa
aa
aa
ab
ab
ab
ab
ab
ab
ab
ab
ab
ab
ab
ab
ab
ab
ac
ac
ac
ac
ab
ab
aa
aa
aa
aa
aa
"}
(10,1,1) = {"
aa
aa
aa
ab
ab
ab
ab
ab
ab
aa
aa
aa
aa
aa
ab
ab
ab
ab
ab
ab
ab
ab
ab
ab
ab
ab
ab
ab
ab
ac
ar
aB
ac
ab
ab
ab
aa
aa
aa
aa
"}
(11,1,1) = {"
aa
aa
aa
aa
ab
ab
ab
ab
aa
aa
aa
aa
aa
aa
ab
ab
ab
ab
ab
ab
ab
ab
ab
ab
ab
ab
ab
ab
ab
ac
as
aC
ab
ab
ab
ab
aU
aa
aa
aa
"}
(12,1,1) = {"
aa
aa
aa
aa
aa
aa
aa
aa
aa
aa
aa
aa
aa
ab
ab
ab
ab
ab
ab
ab
ab
ab
ab
ab
ab
ab
ab
ab
ab
ac
ac
ac
ac
ac
ac
aU
aU
aa
aa
aa
"}
(13,1,1) = {"
aa
aa
aa
aa
aa
aa
aa
aa
aa
aa
aa
aa
aa
ab
ab
ab
ab
ab
ab
ab
ab
ab
ab
ab
ab
ab
ab
ab
ab
ac
at
aD
aE
aO
aT
aU
aU
aa
aa
aa
"}
(14,1,1) = {"
aa
aa
aa
aa
aa
aa
aa
aa
aa
aa
aa
aa
aa
ab
ab
ab
ab
ab
ab
ab
ab
ab
ab
ab
ab
ab
ab
ab
ab
ac
au
aE
aE
aP
aT
aU
aU
aa
aa
aa
"}
(15,1,1) = {"
aa
aa
aa
aa
aa
aa
aa
aa
aa
aa
aa
aa
aa
ab
ab
ab
ab
ab
ab
ab
ab
ab
ab
ab
ab
ab
ab
ab
ab
ac
av
aE
aI
ac
ac
ac
ab
aU
aa
aa
"}
(16,1,1) = {"
aa
aa
aa
aa
aa
aa
aa
aa
aa
aa
aa
aa
aa
ab
ab
ab
ab
ab
ab
ab
ab
ab
ab
ab
ab
ab
ab
ab
ab
ac
aw
aE
aE
aQ
aE
ac
ab
ab
aa
aa
"}
(17,1,1) = {"
aa
aa
aa
aa
aa
aa
aa
aa
ab
ab
ab
aa
aa
aa
ab
ab
ab
ab
ab
ab
ab
ab
ab
ab
ac
ac
ac
ac
ac
ac
ac
ac
ac
ac
aE
ac
ac
ac
aZ
aa
"}
(18,1,1) = {"
aa
aa
aa
aa
aa
aa
aa
ab
ab
ab
ab
ab
aa
aa
aa
ab
ab
ab
ab
ab
ab
ab
ab
ab
ac
ad
ai
ak
al
al
ax
al
al
aR
aE
aV
aX
aY
ba
aa
"}
(19,1,1) = {"
aa
aa
aa
aa
aa
aa
aa
ab
ab
ab
ab
ab
ab
aa
aa
ab
ab
ab
ab
ab
ab
ab
ab
ab
ac
ae
ai
ac
al
al
al
al
aJ
ac
ac
ac
ac
ac
aZ
aa
"}
(20,1,1) = {"
aa
aa
aa
aa
aa
aa
ab
ab
ab
ab
ab
ab
ab
aa
ab
ab
ab
ab
ab
ab
ab
ab
ab
ab
ac
af
ai
ac
al
al
ay
aF
aK
ac
ab
ab
ab
ab
aa
aa
"}
(21,1,1) = {"
aa
aa
aa
aa
aa
aa
ab
ab
ab
ab
ab
ab
ab
aa
ab
ab
ab
ab
ab
ab
ab
ab
ab
ab
ac
ag
ai
ac
al
al
az
al
aL
ac
ac
ac
ac
ac
aa
aa
"}
(22,1,1) = {"
aa
aa
aa
aa
aa
aa
aa
ab
ab
ab
ab
ab
ab
aa
ab
ab
ab
ab
ab
ab
ab
ab
ab
ab
ac
ah
aj
ac
al
al
al
al
al
aS
ai
aW
ai
ac
aa
aa
"}
(23,1,1) = {"
aa
aa
aa
aa
aa
aa
aa
aa
ab
ab
ab
ab
ab
aa
ab
ab
ab
ab
ab
ab
ab
ab
ab
ab
ac
ac
ac
ac
al
al
aA
al
al
am
ai
aG
aH
ac
aa
aa
"}
(24,1,1) = {"
aa
aa
aa
aa
aa
aa
aa
aa
aa
ab
ab
ab
aa
aa
aa
ab
ab
ab
ab
ab
ab
ab
ab
ab
ab
ab
ab
ac
am
aq
ac
am
aM
ac
ac
ac
ac
ac
aa
aa
"}
(25,1,1) = {"
aa
aa
aa
aa
aa
aa
aa
aa
aa
aa
ab
aa
aa
aa
aa
aa
ab
ab
ab
ab
ab
ab
ab
ab
ab
ab
ab
ac
an
an
ac
ai
ai
ac
ab
ab
ab
ab
aa
aa
"}
(26,1,1) = {"
aa
aa
aa
aa
ab
ab
ab
aa
aa
aa
aa
aa
aa
aa
aa
aa
ab
ab
ab
ab
ab
ab
ab
ab
ab
ab
ab
ac
ao
an
ac
aG
aN
ac
ab
ab
ab
ab
aa
aa
"}
(27,1,1) = {"
aa
aa
aa
ab
ab
ab
ab
ab
aa
aa
aa
aa
aa
aa
aa
aa
aa
ab
ab
ab
ab
ab
ab
ab
ab
ab
ab
ac
ap
an
ac
aH
ai
ac
ab
ab
ab
aa
aa
aa
"}
(28,1,1) = {"
aa
aa
ab
ab
ab
ab
ab
ab
ab
aa
aa
aa
aa
aa
aa
aa
aa
aa
aa
ab
ab
ab
ab
ab
ab
ab
ab
ac
ac
ac
ac
ac
ac
ac
ab
ab
aa
aa
aa
aa
"}
(29,1,1) = {"
aa
ab
ab
ab
ab
ab
ab
ab
ab
ab
aa
aa
aa
aa
aa
aa
aa
aa
aa
aa
aa
ab
ab
ab
ab
ab
ab
ab
ab
ab
ab
ab
ab
ab
ab
aa
aa
aa
aa
aa
"}
(30,1,1) = {"
aa
ab
ab
ab
ab
ab
ab
ab
ab
ab
aa
aa
aa
aa
aa
aa
aa
aa
aa
aa
aa
aa
aa
aa
ab
ab
ab
ab
ab
ab
ab
ab
ab
aa
aa
aa
aa
aa
aa
aa
"}
(31,1,1) = {"
aa
ab
ab
ab
ab
ab
ab
ab
ab
ab
aa
aa
aa
aa
aa
aa
aa
aa
aa
aa
aa
aa
aa
aa
aa
aa
aa
aa
aa
aa
aa
aa
aa
aa
aa
aa
aa
aa
aa
aa
"}
(32,1,1) = {"
aa
ab
ab
ab
ab
ab
ab
ab
ab
ab
aa
aa
aa
aa
aa
aa
aa
aa
aa
aa
aa
aa
aa
aa
aa
aa
aa
aa
aa
aa
aa
aa
aa
aa
aa
aa
aa
aa
aa
aa
"}
(33,1,1) = {"
aa
ab
ab
ab
ab
ab
ab
ab
ab
aa
aa
aa
aa
aa
aa
aa
aa
aa
aa
aa
aa
aa
aa
aa
aa
aa
aa
aa
aa
aa
aa
aa
aa
aa
aa
aa
aa
aa
aa
aa
"}
(34,1,1) = {"
aa
aa
ab
ab
ab
ab
ab
ab
aa
aa
aa
aa
aa
aa
aa
aa
aa
aa
aa
aa
aa
aa
aa
aa
aa
aa
aa
aa
aa
aa
aa
aa
aa
aa
aa
aa
aa
aa
aa
aa
"}
(35,1,1) = {"
aa
aa
aa
ab
ab
ab
ab
aa
aa
aa
aa
aa
aa
aa
aa
aa
aa
aa
aa
aa
aa
aa
aa
aa
aa
aa
aa
aa
aa
aa
aa
aa
aa
aa
aa
aa
aa
aa
aa
aa
"}
(36,1,1) = {"
aa
aa
aa
aa
ab
ab
aa
aa
aa
aa
aa
aa
aa
aa
aa
aa
aa
aa
aa
aa
aa
aa
aa
aa
aa
aa
aa
aa
aa
aa
aa
aa
aa
aa
aa
aa
aa
aa
aa
aa
"}
(37,1,1) = {"
aa
aa
aa
aa
aa
aa
aa
aa
aa
aa
aa
aa
aa
aa
aa
aa
aa
aa
aa
aa
aa
aa
aa
aa
aa
aa
aa
aa
aa
aa
aa
aa
aa
aa
aa
aa
aa
aa
aa
aa
"}
(38,1,1) = {"
aa
aa
aa
aa
aa
aa
aa
aa
aa
aa
aa
aa
aa
aa
aa
aa
aa
aa
aa
aa
aa
aa
aa
aa
aa
aa
aa
aa
aa
aa
aa
aa
aa
aa
aa
aa
aa
aa
aa
aa
"}
(39,1,1) = {"
aa
aa
aa
aa
aa
aa
aa
aa
aa
aa
aa
aa
aa
aa
aa
aa
aa
aa
aa
aa
aa
aa
aa
aa
aa
aa
aa
aa
aa
aa
aa
aa
aa
aa
aa
aa
aa
aa
aa
aa
"}
(40,1,1) = {"
aa
aa
aa
aa
aa
aa
aa
aa
aa
aa
aa
aa
aa
aa
aa
aa
aa
aa
aa
aa
aa
aa
aa
aa
aa
aa
aa
aa
aa
aa
aa
aa
aa
aa
aa
aa
aa
aa
aa
aa
"}
