//MAP CONVERTED BY dmm2tgm.py THIS HEADER COMMENT PREVENTS RECONVERSION, DO NOT REMOVE
"a" = (
/turf/open/space/basic,
/area/space)
"b" = (
/turf/open/floor/plating/asteroid,
/area/ruin/powered)
"c" = (
/obj/effect/spawner/structure/window/reinforced,
/turf/open/floor/plating,
/area/ruin/powered)
"d" = (
/obj/structure/frame/computer,
/turf/open/floor/plating/asteroid,
/area/ruin/powered)
"e" = (
/obj/item/crowbar,
/obj/structure/table,
/obj/item/pinpointer/crew,
/turf/open/floor/plating/asteroid,
/area/ruin/powered)
"f" = (
/obj/structure/mineral_door/transparent/diamond,
/turf/open/floor/plating/asteroid,
/area/ruin/powered)
"g" = (
/obj/structure/fans/tiny/invisible,
/obj/machinery/door/airlock/ship/external{
	name = "Asteroid transport"
	},
/turf/open/floor/plating/asteroid,
/area/ruin/powered)
"h" = (
/obj/machinery/door/airlock/ship/external{
	name = "Asteroid transport"
	},
/turf/open/floor/plating/asteroid,
/area/ruin/powered)
"i" = (
/turf/closed/mineral,
/area/ruin/powered)
"j" = (
/obj/structure/mineral_door/iron,
/turf/open/floor/plating/asteroid,
/area/ruin/powered)
"k" = (
/obj/structure/chair,
/turf/open/floor/plating/asteroid,
/area/ruin/powered)
"l" = (
/obj/structure/chair{
	dir = 4
	},
/turf/open/floor/plating/asteroid,
/area/ruin/powered)
"m" = (
/turf/open/floor/plating/asteroid/airless,
/area/ruin/powered)
"n" = (
/obj/structure/rack,
/obj/item/bedsheet/rainbow,
/obj/item/book/random,
/turf/open/floor/plating/asteroid,
/area/ruin/powered)
"o" = (
/obj/structure/rack,
/obj/item/bedsheet/patriot,
/obj/item/book/random,
/turf/open/floor/plating/asteroid,
/area/ruin/powered)
"p" = (
/obj/structure/rack,
/obj/item/bedsheet/syndie,
/obj/item/book/random,
/turf/open/floor/plating/asteroid,
/area/ruin/powered)
"q" = (
/obj/structure/mineral_door/wood,
/turf/open/floor/plating/asteroid,
/area/ruin/powered)
"r" = (
/obj/structure/table,
/obj/item/clipboard,
/turf/open/floor/plating/asteroid,
/area/ruin/powered)
"s" = (
/obj/structure/table,
/turf/open/floor/plating/asteroid,
/area/ruin/powered)
"t" = (
/obj/structure/table,
/obj/item/extendohand,
/turf/open/floor/plating/asteroid,
/area/ruin/powered)
"u" = (
/obj/structure/tank_dispenser,
/turf/open/floor/plating/asteroid,
/area/ruin/powered)
"v" = (
/obj/structure/chair{
	dir = 8
	},
/turf/open/floor/plating/asteroid,
/area/ruin/powered)
"w" = (
/obj/item/paint/anycolor,
/obj/structure/rack,
/turf/open/floor/plating/asteroid,
/area/ruin/powered)
"x" = (
/obj/structure/chair{
	dir = 4
	},
/obj/structure/window/reinforced,
/obj/structure/window/reinforced{
	dir = 4
	},
/turf/open/floor/plating/asteroid,
/area/ruin/powered)
"y" = (
/obj/structure/mineral_door/gold,
/turf/open/floor/plating/asteroid,
/area/ruin/powered)
"z" = (
/obj/structure/shuttle/engine/heater,
/obj/structure/window/reinforced{
	dir = 1;
	pixel_y = 1
	},
/turf/open/floor/plating/airless,
/area/ruin/powered)
"A" = (
/obj/structure/shuttle/engine/propulsion/burst,
/turf/open/floor/plating/airless,
/area/ruin/powered)
"B" = (
/obj/structure/chair{
	dir = 4
	},
/obj/structure/windoor_assembly{
	dir = 4
	},
/turf/open/floor/plating/asteroid,
/area/ruin/powered)
"H" = (
/obj/structure/table,
/obj/item/analyzer,
/turf/open/floor/plating/asteroid,
/area/ruin/powered)
"N" = (
/obj/structure/chair{
	dir = 1
	},
/turf/open/floor/plating/asteroid,
/area/ruin/powered)

(1,1,1) = {"
a
a
a
a
a
a
a
a
a
a
a
a
a
a
a
a
a
a
a
a
a
a
a
a
a
a
a
a
a
a
a
a
a
a
a
a
a
a
a
a
"}
(2,1,1) = {"
a
a
a
a
a
a
a
a
a
a
a
a
a
a
a
a
a
a
a
a
a
a
a
a
a
a
a
a
a
a
a
a
a
a
a
a
a
a
a
a
"}
(3,1,1) = {"
a
a
a
a
a
a
a
a
a
a
a
a
a
a
a
a
a
a
a
a
a
a
a
a
a
a
a
a
a
a
a
a
a
a
a
a
a
a
a
a
"}
(4,1,1) = {"
a
a
a
a
a
a
a
a
a
a
a
a
a
a
a
a
a
a
a
a
a
a
a
a
a
a
a
a
a
a
a
a
a
a
a
a
a
a
a
a
"}
(5,1,1) = {"
a
a
a
a
a
a
a
a
a
a
a
a
a
a
a
a
a
a
a
a
a
a
a
a
a
a
a
a
a
a
a
a
a
a
a
a
a
a
a
a
"}
(6,1,1) = {"
a
a
a
a
a
a
a
a
a
i
i
i
a
a
a
i
a
a
a
a
i
i
i
i
a
a
i
i
i
i
i
i
a
a
a
a
a
a
a
a
"}
(7,1,1) = {"
a
a
a
a
a
a
a
a
i
i
i
i
i
a
i
i
i
a
i
i
i
i
i
i
i
g
i
i
i
i
i
i
i
i
a
a
a
a
a
a
"}
(8,1,1) = {"
a
a
a
a
a
a
a
i
i
i
i
i
i
i
i
i
i
i
i
i
i
i
i
i
i
b
i
i
i
i
i
i
i
i
i
a
a
a
a
a
"}
(9,1,1) = {"
a
a
a
a
a
a
i
i
i
i
i
i
i
i
i
i
i
i
i
i
i
i
i
i
i
h
i
i
i
i
i
i
i
i
i
a
a
a
a
a
"}
(10,1,1) = {"
a
a
a
a
a
a
i
i
i
i
i
i
i
b
b
b
b
b
b
b
b
b
b
b
b
b
i
i
l
l
i
i
i
i
i
i
i
a
a
a
"}
(11,1,1) = {"
a
a
a
a
a
a
i
i
i
i
i
i
i
b
i
i
i
i
i
i
i
i
i
i
i
b
i
s
b
b
N
i
i
i
u
w
i
i
a
a
"}
(12,1,1) = {"
a
a
a
a
a
a
i
i
i
i
i
i
i
b
i
i
i
i
i
i
i
i
i
i
i
b
j
b
b
b
N
i
i
b
b
b
b
z
A
a
"}
(13,1,1) = {"
a
a
a
a
a
a
a
i
i
i
i
i
i
b
i
i
i
i
i
i
i
i
i
i
i
i
i
k
b
b
N
i
n
b
b
b
b
z
A
a
"}
(14,1,1) = {"
a
a
a
a
a
a
a
i
i
i
i
i
i
b
i
i
i
i
i
i
i
i
i
i
i
i
i
k
b
b
N
i
i
b
b
b
b
z
A
a
"}
(15,1,1) = {"
a
a
a
a
a
a
a
c
b
b
b
f
b
b
i
i
i
i
i
i
i
i
i
i
i
i
i
k
b
b
N
i
i
b
b
b
b
z
A
a
"}
(16,1,1) = {"
a
a
a
a
a
a
c
c
b
b
i
i
i
b
i
i
i
i
i
i
i
i
i
i
i
i
i
i
b
b
b
i
o
b
b
b
b
z
A
a
"}
(17,1,1) = {"
a
a
a
a
a
m
c
d
N
b
i
i
k
b
i
i
i
i
i
i
i
i
i
i
i
i
i
i
i
b
b
i
p
b
b
b
b
i
a
a
"}
(18,1,1) = {"
a
a
a
a
a
m
c
d
N
b
i
i
k
b
i
i
i
i
i
i
i
i
i
i
i
i
i
i
i
i
j
i
i
b
b
b
b
i
i
a
"}
(19,1,1) = {"
a
a
a
a
a
a
c
d
N
b
i
i
k
b
i
i
i
i
i
i
i
i
i
i
i
i
i
i
i
i
b
i
i
q
i
i
i
i
i
a
"}
(20,1,1) = {"
a
a
a
a
a
a
c
e
s
s
i
i
H
b
i
i
i
i
i
i
i
i
i
i
i
i
i
i
i
i
b
b
b
b
b
h
b
g
a
a
"}
(21,1,1) = {"
a
a
a
a
a
a
i
i
i
i
i
i
i
b
i
i
i
i
i
i
i
i
i
i
i
i
i
i
i
i
i
i
i
b
i
i
i
i
i
a
"}
(22,1,1) = {"
a
a
a
a
a
a
a
i
i
i
i
i
i
i
i
i
i
i
i
i
i
i
i
i
i
i
i
i
i
i
i
i
i
b
i
i
i
i
i
a
"}
(23,1,1) = {"
a
a
a
a
a
a
i
i
i
i
i
i
i
i
i
i
i
i
i
i
i
i
i
i
i
i
i
i
i
i
i
i
i
b
b
b
b
i
i
a
"}
(24,1,1) = {"
a
a
a
a
a
i
i
i
i
i
i
i
i
i
i
i
i
i
i
i
i
i
i
i
i
i
i
i
i
i
i
i
i
i
i
i
y
i
a
a
"}
(25,1,1) = {"
a
a
a
a
a
i
i
i
i
i
i
i
i
i
i
i
i
i
i
i
i
i
i
i
i
i
i
i
i
i
i
i
i
i
B
x
b
z
A
a
"}
(26,1,1) = {"
a
a
a
a
a
i
i
i
i
i
i
i
i
i
i
i
i
i
i
i
i
i
i
i
i
i
i
i
i
i
i
i
i
r
b
b
b
z
A
a
"}
(27,1,1) = {"
a
a
a
a
a
i
i
i
i
i
i
i
i
i
i
i
i
i
i
i
i
i
i
i
i
i
i
i
i
i
i
i
i
s
b
b
b
z
A
a
"}
(28,1,1) = {"
a
a
a
a
a
a
i
i
i
i
i
i
i
i
i
i
i
i
i
i
i
i
i
i
i
i
i
i
i
i
i
i
i
t
b
b
b
z
A
a
"}
(29,1,1) = {"
a
a
a
a
a
a
a
i
i
i
i
i
i
i
i
i
i
i
i
i
i
i
i
i
i
i
i
i
i
i
i
i
i
i
v
v
v
z
A
a
"}
(30,1,1) = {"
a
a
a
a
a
a
a
a
i
i
i
i
i
i
i
i
i
i
i
i
i
i
i
i
i
i
i
i
i
i
i
i
i
i
i
i
i
i
a
a
"}
(31,1,1) = {"
a
a
a
a
a
a
a
a
a
i
i
i
i
i
i
i
i
i
i
i
i
i
i
i
i
i
i
i
i
i
i
i
i
i
i
i
i
a
a
a
"}
(32,1,1) = {"
a
a
a
a
a
a
a
a
a
a
a
i
i
i
i
i
i
i
i
i
i
i
i
i
i
i
i
i
i
i
i
i
i
i
i
i
a
a
a
a
"}
(33,1,1) = {"
a
a
a
a
a
a
a
a
a
a
a
a
a
i
i
i
a
i
i
i
i
i
i
i
i
i
i
i
i
i
i
i
i
i
i
i
a
a
a
a
"}
(34,1,1) = {"
a
a
a
a
a
a
a
a
a
a
a
a
a
a
a
a
a
a
a
i
i
i
i
i
i
i
i
i
i
i
i
i
i
i
i
a
a
a
a
a
"}
(35,1,1) = {"
a
a
a
a
a
a
a
a
a
a
a
a
a
a
a
a
a
a
a
a
a
i
i
i
i
i
i
i
a
a
i
i
i
a
a
a
a
a
a
a
"}
(36,1,1) = {"
a
a
a
a
a
a
a
a
a
a
a
a
a
a
a
a
a
a
a
a
a
a
a
i
i
i
a
a
a
a
a
a
a
a
a
a
a
a
a
a
"}
(37,1,1) = {"
a
a
a
a
a
a
a
a
a
a
a
a
a
a
a
a
a
a
a
a
a
a
a
a
a
a
a
a
a
a
a
a
a
a
a
a
a
a
a
a
"}
(38,1,1) = {"
a
a
a
a
a
a
a
a
a
a
a
a
a
a
a
a
a
a
a
a
a
a
a
a
a
a
a
a
a
a
a
a
a
a
a
a
a
a
a
a
"}
(39,1,1) = {"
a
a
a
a
a
a
a
a
a
a
a
a
a
a
a
a
a
a
a
a
a
a
a
a
a
a
a
a
a
a
a
a
a
a
a
a
a
a
a
a
"}
(40,1,1) = {"
a
a
a
a
a
a
a
a
a
a
a
a
a
a
a
a
a
a
a
a
a
a
a
a
a
a
a
a
a
a
a
a
a
a
a
a
a
a
a
a
"}
