//MAP CONVERTED BY dmm2tgm.py THIS HEADER COMMENT PREVENTS RECONVERSION, DO NOT REMOVE
"a" = (
/turf/open/space/basic,
/area/space)
"b" = (
/turf/open/water{
	initial_gas_mix = "TEMP=2.7"
	},
/area/ruin/powered)
"c" = (
/obj/structure/light_prism,
/turf/open/floor/plating/asteroid/airless,
/area/ruin/powered)
"d" = (
/obj/item/reagent_containers/glass/waterbottle{
	list_reagents = list(/datum/reagent/snail = 10);
	name = "bottle of snail juice"
	},
/obj/structure/table/wood,
/turf/open/floor/plating/asteroid/airless,
/area/ruin/powered)
"g" = (
/turf/closed/mineral,
/area/ruin/powered)
"h" = (
/turf/open/floor/plating/asteroid/airless,
/area/ruin/powered)

(1,1,1) = {"
a
a
a
a
a
a
a
a
a
a
a
a
a
a
a
a
a
a
a
a
a
a
a
a
a
a
a
a
a
a
a
a
a
a
a
a
a
a
a
a
"}
(2,1,1) = {"
a
a
a
a
a
a
a
a
a
a
a
a
a
a
a
a
a
a
a
a
a
a
a
a
a
a
a
a
a
a
a
a
a
a
a
a
a
a
a
a
"}
(3,1,1) = {"
a
a
a
a
a
a
a
a
a
a
a
a
a
a
a
a
a
a
a
a
a
a
a
a
a
a
a
a
a
a
a
a
a
a
a
a
a
a
a
a
"}
(4,1,1) = {"
a
a
a
a
a
a
a
a
a
a
a
a
a
a
a
a
g
g
g
g
a
a
a
a
g
g
g
a
a
a
a
a
a
a
a
a
a
a
a
a
"}
(5,1,1) = {"
a
a
a
a
a
a
a
a
a
a
a
a
a
a
g
g
g
g
g
g
g
a
a
g
g
g
g
g
g
a
a
a
a
a
a
a
a
a
a
a
"}
(6,1,1) = {"
a
a
a
a
a
a
a
a
a
a
a
a
a
g
g
g
g
g
g
g
g
g
g
g
g
g
g
g
g
g
g
a
a
a
a
a
a
a
a
a
"}
(7,1,1) = {"
a
a
a
a
a
a
a
a
a
a
a
a
a
g
g
g
g
g
g
g
g
g
g
g
g
g
g
g
g
g
g
g
a
a
a
a
a
a
a
a
"}
(8,1,1) = {"
a
a
a
a
a
a
a
a
a
a
a
a
a
g
b
b
g
g
g
g
g
b
g
g
g
g
g
b
g
g
g
g
g
a
a
a
a
a
a
a
"}
(9,1,1) = {"
a
a
a
a
a
a
a
a
a
a
a
a
g
g
b
b
b
b
g
g
g
b
g
g
g
b
g
b
g
g
g
g
g
g
a
a
a
a
a
a
"}
(10,1,1) = {"
a
a
a
a
a
a
a
a
a
a
a
g
g
g
g
b
b
b
b
b
b
b
b
g
g
b
b
b
b
b
g
g
g
g
a
a
a
a
a
a
"}
(11,1,1) = {"
a
a
a
a
a
a
a
a
a
g
g
g
g
b
b
b
b
b
g
g
g
b
b
g
g
g
b
b
b
b
g
g
g
g
g
a
a
a
a
a
"}
(12,1,1) = {"
a
a
a
a
a
a
a
g
g
g
g
g
g
b
g
g
g
g
g
g
b
b
b
b
b
b
b
b
b
b
g
g
g
g
g
a
a
a
a
a
"}
(13,1,1) = {"
a
a
a
a
a
a
g
g
g
g
g
g
g
b
g
g
g
g
g
g
g
g
g
g
g
g
b
b
b
b
g
g
g
g
g
a
a
a
a
a
"}
(14,1,1) = {"
a
a
a
a
a
a
g
g
g
g
g
g
g
b
b
b
b
g
g
g
g
g
g
g
g
g
b
b
b
b
g
g
g
g
g
g
a
a
a
a
"}
(15,1,1) = {"
a
a
a
a
a
a
g
g
g
g
g
g
g
g
g
g
b
g
g
g
g
g
g
g
g
g
g
g
g
b
g
g
g
g
g
g
a
a
a
a
"}
(16,1,1) = {"
a
a
a
a
a
a
a
g
g
g
g
g
b
g
g
g
b
g
b
g
g
g
g
g
g
g
g
b
g
b
g
g
g
g
g
g
a
a
a
a
"}
(17,1,1) = {"
a
a
a
a
a
a
a
a
g
g
g
g
b
g
g
b
b
b
b
g
g
g
g
g
g
g
g
b
b
b
g
g
g
g
g
g
a
a
a
a
"}
(18,1,1) = {"
a
a
a
a
a
a
a
g
g
g
g
g
b
b
b
b
b
b
g
g
g
g
g
g
g
g
g
g
g
b
b
b
g
g
g
a
a
a
a
a
"}
(19,1,1) = {"
a
a
a
a
a
a
a
g
g
g
g
g
g
g
g
b
b
b
g
g
g
g
g
g
g
g
g
g
g
b
g
b
g
g
g
g
a
a
a
a
"}
(20,1,1) = {"
a
a
a
a
a
a
g
g
g
g
g
g
g
g
g
b
g
g
g
g
g
g
g
g
g
g
g
g
g
b
g
b
g
g
g
g
a
a
a
a
"}
(21,1,1) = {"
a
a
a
a
a
a
g
g
g
g
g
g
g
b
b
b
g
b
b
g
g
g
g
g
g
b
b
g
b
b
g
b
g
g
g
g
g
a
a
a
"}
(22,1,1) = {"
a
a
a
a
a
g
g
g
g
g
g
g
g
b
g
b
b
b
g
g
g
g
g
g
g
g
b
g
g
g
g
b
g
g
g
g
g
a
a
a
"}
(23,1,1) = {"
a
a
a
a
a
g
g
g
g
g
g
g
g
b
g
b
g
g
g
g
g
g
g
g
g
g
b
g
g
g
g
b
g
g
g
g
g
a
a
a
"}
(24,1,1) = {"
a
a
a
a
a
g
g
g
g
g
g
g
g
g
g
b
g
g
g
g
g
g
g
g
g
b
b
b
b
b
b
b
g
g
g
g
g
a
a
a
"}
(25,1,1) = {"
a
a
a
a
a
a
g
g
g
g
g
g
g
g
g
b
g
g
g
g
g
g
g
g
g
b
b
b
b
g
g
g
g
g
g
g
a
a
a
a
"}
(26,1,1) = {"
a
a
a
a
a
a
a
g
g
g
g
g
g
g
g
b
g
g
g
g
g
b
b
g
g
b
g
g
b
g
g
g
g
g
g
g
a
a
a
a
"}
(27,1,1) = {"
a
a
a
a
a
a
a
a
g
g
g
g
g
g
g
b
g
g
g
g
g
b
b
g
g
b
g
g
b
g
g
g
g
g
g
g
g
a
a
a
"}
(28,1,1) = {"
a
a
a
a
a
a
a
a
g
g
g
g
g
g
b
b
b
g
b
b
b
b
b
b
b
b
b
g
b
g
g
g
g
g
g
g
g
a
a
a
"}
(29,1,1) = {"
a
a
a
a
a
a
a
a
g
g
g
g
g
g
b
b
b
b
b
g
g
b
b
g
b
g
g
g
b
b
b
b
b
g
g
g
g
a
a
a
"}
(30,1,1) = {"
a
a
a
a
a
a
a
a
a
g
g
g
g
g
g
g
g
g
g
g
g
g
g
g
b
g
g
g
g
g
b
b
b
g
g
g
g
a
a
a
"}
(31,1,1) = {"
a
a
a
a
a
a
a
a
a
g
g
g
g
g
g
g
g
g
g
g
g
g
g
g
b
g
g
g
g
g
b
b
b
g
g
g
a
a
a
a
"}
(32,1,1) = {"
a
a
a
a
a
a
a
a
a
g
g
g
g
g
g
g
g
g
g
g
g
g
g
h
h
h
g
g
g
g
g
g
g
g
a
a
a
a
a
a
"}
(33,1,1) = {"
a
a
a
a
a
a
a
a
a
a
g
g
g
g
g
g
g
g
g
g
g
g
g
c
d
c
g
g
g
g
g
g
g
a
a
a
a
a
a
a
"}
(34,1,1) = {"
a
a
a
a
a
a
a
a
a
a
a
g
g
g
g
g
g
g
g
g
g
g
g
g
g
g
g
g
g
g
g
g
g
a
a
a
a
a
a
a
"}
(35,1,1) = {"
a
a
a
a
a
a
a
a
a
a
a
g
g
g
g
g
g
g
g
g
g
g
g
g
g
g
g
g
g
g
g
g
a
a
a
a
a
a
a
a
"}
(36,1,1) = {"
a
a
a
a
a
a
a
a
a
a
a
g
g
g
g
g
a
a
g
g
g
g
a
g
g
g
g
g
g
g
a
a
a
a
a
a
a
a
a
a
"}
(37,1,1) = {"
a
a
a
a
a
a
a
a
a
a
a
a
g
g
a
a
a
a
a
a
a
a
a
a
g
g
g
g
a
a
a
a
a
a
a
a
a
a
a
a
"}
(38,1,1) = {"
a
a
a
a
a
a
a
a
a
a
a
a
a
a
a
a
a
a
a
a
a
a
a
a
a
a
a
a
a
a
a
a
a
a
a
a
a
a
a
a
"}
(39,1,1) = {"
a
a
a
a
a
a
a
a
a
a
a
a
a
a
a
a
a
a
a
a
a
a
a
a
a
a
a
a
a
a
a
a
a
a
a
a
a
a
a
a
"}
(40,1,1) = {"
a
a
a
a
a
a
a
a
a
a
a
a
a
a
a
a
a
a
a
a
a
a
a
a
a
a
a
a
a
a
a
a
a
a
a
a
a
a
a
a
"}
