"g" = (/turf/closed/wall/r_wall,/area/ruin/powered)
"h" = (/turf/closed/mineral,/area/ruin/powered)
"C" = (/obj/effect/mine/sound/bwoink{opacity = 255},/turf/closed/mineral,/area/ruin/powered)
"E" = (/turf/template_noop,/area/template_noop)

(1,1,1) = {"
EEEEEEEEEEEEEEEEEEEEEEEEEEEEEEEEEEEEEEEE
EEEEEEEEEEEEEEEEEEEEEEEEEEEEEEEEEEEEEEEE
EEEEEEEEEEEEEEEEEEEEEEEEEEEEEEEEEEEEEEEE
EEEEEEEEEEEEEEEEEEEEEEEEEEEEEEEEEEEEEEEE
EEEEEEEEEEEEEEhhhhhhhhhhhEEEEEEEEEEEEEEE
EEEEEEEEEEEEhhhhhhhhhhhhhhhhhEEEEEEEEEEE
EEEEEEEEEEEhhhhhhhhhhhhhhhhhhhhEEEEEEEEE
EEEEEEEEEEhhhhhhhhhhhhhhhhhhhhhhhEEEEEEE
EEEEEEEEEhhhhhhhhhhhhhhhhhhhhhhhhhEEEEEE
EEEEEEEEhhhhhhhhhhhhhhhhhhhhhhhhhhhEEEEE
EEEEEEEEhhhChhhhhhhhhhhhhhhhhhhhhhhhEEEE
EEEEEEEhhhhhhhhChhhhhhhhhhhChhhhhhhhEEEE
EEEEEEhhhhhhgggghhhhhhhhhgggghhhhhhhhEEE
EEEEEhhhhhhghhhhghhhhhhhghhhhghhhhhhhEEE
EEEEhhhhhhghhhhhhghhhhhghhhhhhghhhhhhEEE
EEEEhhhhhhhhggghhhhhhhhhChgghhhhhhhhhEEE
EEEEhhhhhhhgghgghhhhhhhhgghhgghhhhhhhEEE
EEEhhhhhhhghhhhhghhhhhhghhhhhhghhhhhhEEE
EEEhhChhhhghhhhhghhhhhhghhhhhhghChhhhhEE
EEEhhhhhhhhgghgghhhhChhhgghhgghhhhhhhhEE
EEEhhhhhhhhhggghhhhhghhhhhggChhhhhhhhhEE
EEEEhhhhhhhhhhhhhhhhghhhhhhhhhhhhhhhhhEE
EEEEhhhhhhhhhhhhhhhhCghhhhhhhhhhhhhhhhEE
EEEEEhhhhhhhhhhhhhhhghhhhhhhhhhhhhhhhhEE
EEEEEhhhhhhhhhhhhhhChhhhhhhhhhhhhhhhChEE
EEEEEEhhhhgggggggggggggggggggggghhhhhhEE
EEEEEEhhhCghhghhghhghhghhghhghhghhhhhhEE
EEEEEEEhhghhhghhghhghhghhghhghhghhhhhhEE
EEEEEEEhhhghhghhghhghhghhghhghhghhhhhEEE
EEEEEEEEhhhggggggggggggggggggggghhhhhEEE
EEEEEEEEhhhhgghhhhhhhhhhhhhhhhgghhhhhEEE
EEEEEEEEEEhhhCgggggggggggggggggChhhhhEEE
EEEEEEEEEEEEhhhhgghghhghhghhghghhhhhhEEE
EEEEEEEEEEEEEEhhhhgghhghhghhggghhhhhEEEE
EEEEEEEEEEEEEEhhhhhhggggggggghhhhhhhEEEE
EEEEEEEEEEEEEEEEEhhhhhhhhhChhhhhhChEEEEE
EEEEEEEEEEEEEEEEEEEEEhhhhhhhhhhhhhEEEEEE
EEEEEEEEEEEEEEEEEEEEEEEEEEEEEhhhhEEEEEEE
EEEEEEEEEEEEEEEEEEEEEEEEEEEEEEEEEEEEEEEE
EEEEEEEEEEEEEEEEEEEEEEEEEEEEEEEEEEEEEEEE
"}
