//MAP CONVERTED BY dmm2tgm.py THIS HEADER COMMENT PREVENTS RECONVERSION, DO NOT REMOVE
"a" = (
/turf/open/space/basic,
/area/space)
"b" = (
/turf/closed/mineral,
/area/ruin/powered)
"c" = (
/turf/open/floor/plating/asteroid/basalt/lava_land_surface{
	initial_gas_mix = "TEMP=2.7"
	},
/area/ruin/powered)
"d" = (
/mob/living/simple_animal/hostile/asteroid/goliath/beast,
/turf/open/floor/plating/asteroid/basalt/lava_land_surface{
	initial_gas_mix = "TEMP=2.7"
	},
/area/ruin/powered)
"e" = (
/turf/open/floor/plating/asteroid/airless,
/area/ruin/powered)
"f" = (
/turf/closed/wall/mineral/titanium/survival/pod,
/area/ruin/powered)
"g" = (
/obj/structure/fans,
/turf/open/floor/pod/dark,
/area/ruin/powered)
"h" = (
/obj/machinery/smartfridge/survival_pod/empty,
/turf/open/floor/pod/dark,
/area/ruin/powered)
"i" = (
/obj/item/gps/computer,
/obj/structure/tubes,
/turf/open/floor/pod/dark,
/area/ruin/powered)
"j" = (
/obj/structure/sign/mining/survival{
	dir = 8;
	pixel_x = -32
	},
/turf/open/floor/plating/asteroid/basalt/lava_land_surface{
	initial_gas_mix = "TEMP=2.7"
	},
/area/ruin/powered)
"k" = (
/obj/machinery/sleeper/survival_pod,
/turf/open/floor/pod/dark,
/area/ruin/powered)
"l" = (
/obj/item/pickaxe,
/obj/effect/decal/cleanable/blood,
/turf/open/floor/pod/dark,
/area/ruin/powered)
"m" = (
/obj/structure/bed/pod,
/obj/item/bedsheet/black,
/obj/structure/tubes,
/obj/machinery/light/small{
	dir = 4
	},
/turf/open/floor/pod/dark,
/area/ruin/powered)
"n" = (
/obj/structure/table/survival_pod,
/obj/item/kitchen/knife/combat/survival,
/turf/open/floor/pod/dark,
/area/ruin/powered)
"o" = (
/obj/effect/mob_spawn/human/miner/explorer{
	brute_damage = 150;
	oxy_damage = 50
	},
/obj/effect/decal/cleanable/blood,
/obj/effect/decal/cleanable/blood/drip,
/obj/effect/decal/cleanable/blood/footprints{
	dir = 1
	},
/turf/open/floor/pod/dark,
/area/ruin/powered)
"p" = (
/obj/structure/tubes,
/obj/item/crowbar,
/obj/effect/decal/cleanable/blood/drip,
/turf/open/floor/pod/dark,
/area/ruin/powered)
"q" = (
/obj/structure/sign/mining/survival{
	dir = 8;
	pixel_x = -32
	},
/obj/effect/decal/cleanable/blood,
/turf/open/floor/plating/asteroid/basalt/lava_land_surface{
	initial_gas_mix = "TEMP=2.7"
	},
/area/ruin/powered)
"r" = (
/obj/effect/decal/cleanable/blood/footprints{
	dir = 1
	},
/obj/machinery/door/airlock/survival_pod/glass,
/obj/structure/fans/tiny,
/turf/open/floor/pod/dark,
/area/ruin/powered)
"s" = (
/obj/effect/decal/cleanable/blood/footprints,
/turf/open/floor/plating/asteroid/basalt/lava_land_surface{
	initial_gas_mix = "TEMP=2.7"
	},
/area/ruin/powered)
"t" = (
/obj/structure/sign/mining/survival{
	pixel_y = 32
	},
/turf/open/floor/plating/asteroid/basalt/lava_land_surface{
	initial_gas_mix = "TEMP=2.7"
	},
/area/ruin/powered)
"u" = (
/obj/effect/decal/cleanable/blood/drip,
/obj/effect/decal/cleanable/blood/footprints{
	dir = 1
	},
/turf/open/floor/plating/asteroid/basalt/lava_land_surface{
	initial_gas_mix = "TEMP=2.7"
	},
/area/ruin/powered)
"v" = (
/obj/structure/sign/mining{
	pixel_y = 32
	},
/obj/effect/decal/cleanable/blood/footprints{
	dir = 8
	},
/turf/open/floor/plating/asteroid/basalt/lava_land_surface{
	initial_gas_mix = "TEMP=2.7"
	},
/area/ruin/powered)
"w" = (
/obj/effect/decal/cleanable/blood/footprints{
	dir = 8
	},
/turf/open/floor/plating/asteroid/basalt/lava_land_surface{
	initial_gas_mix = "TEMP=2.7"
	},
/area/ruin/powered)
"x" = (
/obj/effect/decal/cleanable/blood/footprints,
/obj/effect/decal/cleanable/blood/drip,
/turf/open/floor/plating/asteroid/basalt/lava_land_surface{
	initial_gas_mix = "TEMP=2.7"
	},
/area/ruin/powered)

(1,1,1) = {"
a
a
a
a
a
a
a
a
a
a
a
a
a
a
a
a
a
a
a
a
a
a
a
a
a
a
a
a
a
a
a
a
a
a
a
a
a
a
a
a
"}
(2,1,1) = {"
a
a
a
a
a
a
a
a
a
a
a
a
a
a
a
a
a
a
a
a
a
a
a
a
a
a
a
a
a
a
a
a
a
a
a
a
a
a
a
a
"}
(3,1,1) = {"
a
a
a
a
a
a
a
a
a
a
a
a
a
a
a
a
a
a
a
a
a
a
a
a
a
a
a
a
a
a
a
a
a
a
a
a
a
a
a
a
"}
(4,1,1) = {"
a
a
a
a
a
a
a
a
a
a
a
a
a
a
a
a
a
a
a
a
a
a
a
a
e
e
e
e
e
a
a
a
a
a
a
a
a
a
a
a
"}
(5,1,1) = {"
a
a
a
a
a
a
a
a
a
a
a
a
a
a
a
a
a
a
a
a
a
a
a
e
e
e
e
e
e
e
b
b
a
a
a
a
a
a
a
a
"}
(6,1,1) = {"
a
a
a
a
a
a
a
a
a
a
a
a
a
a
b
b
a
a
a
b
b
b
b
e
e
e
e
e
e
b
b
b
b
a
a
a
a
a
a
a
"}
(7,1,1) = {"
a
a
a
a
a
a
a
a
a
a
a
a
b
b
b
b
b
b
b
b
b
b
b
b
e
e
c
c
b
b
b
b
b
b
a
a
a
a
a
a
"}
(8,1,1) = {"
a
a
a
a
a
a
a
a
a
a
a
b
c
b
b
b
b
b
b
b
b
b
b
b
b
c
c
c
b
b
b
b
b
b
b
a
a
a
a
a
"}
(9,1,1) = {"
a
a
a
a
a
a
a
a
a
b
b
b
c
b
b
b
b
b
b
b
b
b
b
b
b
c
c
c
b
b
b
b
b
b
b
b
a
a
a
a
"}
(10,1,1) = {"
a
a
a
a
a
a
a
a
a
b
b
b
c
b
b
b
b
b
b
b
b
b
b
b
b
c
c
c
c
b
b
b
b
b
b
b
b
a
a
a
"}
(11,1,1) = {"
a
a
a
a
a
a
a
a
b
b
b
c
c
c
c
b
b
b
b
b
b
b
b
b
b
b
c
c
c
b
b
b
b
b
b
b
b
a
a
a
"}
(12,1,1) = {"
a
a
a
a
a
a
a
b
b
b
b
c
c
c
d
c
c
c
b
b
b
b
b
b
b
b
c
c
c
c
c
b
b
b
b
b
b
a
a
a
"}
(13,1,1) = {"
a
a
a
a
a
a
b
b
b
b
b
b
c
c
c
c
c
b
b
b
b
b
b
b
b
b
b
b
c
c
c
c
c
b
b
b
b
a
a
a
"}
(14,1,1) = {"
a
a
a
a
a
a
b
b
b
b
b
c
c
b
c
c
b
b
b
b
b
b
b
b
b
b
b
b
b
c
c
c
c
c
b
b
a
a
a
a
"}
(15,1,1) = {"
a
a
a
a
a
a
b
b
b
b
b
b
b
b
c
c
b
b
b
b
b
b
b
b
b
b
b
f
f
f
f
f
c
c
b
b
b
a
a
a
"}
(16,1,1) = {"
a
a
a
a
a
b
b
b
b
b
b
b
b
b
b
b
b
b
b
b
b
b
b
b
b
b
b
f
g
k
n
f
t
b
b
b
b
a
a
a
"}
(17,1,1) = {"
a
a
a
a
a
b
b
b
b
b
b
b
b
b
b
b
b
b
b
b
b
b
b
b
b
b
b
f
h
l
o
r
u
c
b
b
b
b
a
a
"}
(18,1,1) = {"
a
a
a
a
b
b
b
b
b
b
b
b
b
b
b
b
b
b
b
b
b
b
b
b
b
b
b
f
i
m
p
f
v
b
b
b
b
b
a
a
"}
(19,1,1) = {"
a
a
a
a
b
b
b
b
b
b
b
b
b
b
b
b
b
b
b
b
b
b
b
b
b
b
b
f
f
f
f
f
w
b
b
b
b
b
b
a
"}
(20,1,1) = {"
a
a
a
a
b
b
b
b
b
b
b
b
b
b
b
b
b
b
b
b
b
b
b
b
b
b
b
c
j
d
q
s
x
b
b
b
b
b
b
a
"}
(21,1,1) = {"
a
a
a
a
b
b
b
b
b
b
b
b
b
b
b
b
b
b
b
b
b
b
b
b
b
b
b
b
b
b
b
b
b
b
b
b
b
b
b
a
"}
(22,1,1) = {"
a
a
a
a
b
b
b
b
b
b
b
b
b
b
b
b
b
b
b
b
b
b
b
b
b
b
b
b
b
b
b
b
b
b
b
b
b
b
b
a
"}
(23,1,1) = {"
a
a
a
a
b
b
b
b
b
b
b
b
b
b
b
b
b
b
b
b
b
b
b
b
b
b
b
b
b
b
b
b
b
b
b
b
b
b
b
a
"}
(24,1,1) = {"
a
a
a
a
b
b
b
b
b
b
b
b
b
b
b
b
b
b
b
b
b
b
b
b
b
b
b
b
b
b
b
b
b
b
b
b
b
b
b
a
"}
(25,1,1) = {"
a
a
a
a
b
b
b
b
b
b
b
c
b
b
b
b
b
b
b
b
b
b
b
b
b
b
b
b
b
b
b
b
b
b
b
b
b
b
b
a
"}
(26,1,1) = {"
a
a
a
a
b
b
b
b
b
b
b
c
c
b
b
b
b
b
b
b
b
b
b
b
b
b
b
b
b
b
b
b
b
b
b
b
b
b
a
a
"}
(27,1,1) = {"
a
a
a
a
b
b
b
b
b
c
b
c
c
c
b
b
b
b
b
b
b
b
b
b
b
b
b
b
b
b
b
b
b
b
b
b
b
a
a
a
"}
(28,1,1) = {"
a
a
a
a
a
b
b
b
b
c
c
d
c
b
b
b
b
b
b
b
b
b
b
b
b
b
b
b
b
b
b
b
b
b
b
b
b
a
a
a
"}
(29,1,1) = {"
a
a
a
a
a
b
b
b
b
c
c
c
c
b
b
b
b
b
b
b
b
b
b
b
b
b
b
b
b
b
b
b
b
b
b
b
a
a
a
a
"}
(30,1,1) = {"
a
a
a
a
a
a
b
b
b
c
c
b
c
c
b
b
b
b
b
b
b
b
b
b
b
b
b
b
b
b
b
b
b
b
b
b
a
a
a
a
"}
(31,1,1) = {"
a
a
a
a
a
a
b
b
b
b
b
b
b
b
b
b
b
b
b
b
b
b
b
b
b
b
b
b
a
a
b
b
b
b
b
a
a
a
a
a
"}
(32,1,1) = {"
a
a
a
a
a
a
a
b
b
b
b
b
b
b
b
b
b
b
b
b
b
b
b
b
b
b
b
a
a
a
a
b
b
b
a
a
a
a
a
a
"}
(33,1,1) = {"
a
a
a
a
a
a
a
a
b
b
b
b
b
b
b
b
b
b
b
b
b
b
b
b
b
b
a
a
a
a
a
a
a
a
a
a
a
a
a
a
"}
(34,1,1) = {"
a
a
a
a
a
a
a
a
a
b
b
b
a
b
b
b
b
b
b
b
b
b
b
b
b
a
a
a
a
a
a
a
a
a
a
a
a
a
a
a
"}
(35,1,1) = {"
a
a
a
a
a
a
a
a
a
a
a
a
a
a
a
b
b
b
b
b
b
b
b
a
a
a
a
a
a
a
a
a
a
a
a
a
a
a
a
a
"}
(36,1,1) = {"
a
a
a
a
a
a
a
a
a
a
a
a
a
a
a
a
a
b
b
b
b
a
a
a
a
a
a
a
a
a
a
a
a
a
a
a
a
a
a
a
"}
(37,1,1) = {"
a
a
a
a
a
a
a
a
a
a
a
a
a
a
a
a
a
a
a
a
a
a
a
a
a
a
a
a
a
a
a
a
a
a
a
a
a
a
a
a
"}
(38,1,1) = {"
a
a
a
a
a
a
a
a
a
a
a
a
a
a
a
a
a
a
a
a
a
a
a
a
a
a
a
a
a
a
a
a
a
a
a
a
a
a
a
a
"}
(39,1,1) = {"
a
a
a
a
a
a
a
a
a
a
a
a
a
a
a
a
a
a
a
a
a
a
a
a
a
a
a
a
a
a
a
a
a
a
a
a
a
a
a
a
"}
(40,1,1) = {"
a
a
a
a
a
a
a
a
a
a
a
a
a
a
a
a
a
a
a
a
a
a
a
a
a
a
a
a
a
a
a
a
a
a
a
a
a
a
a
a
"}
