"g" = (/mob/living/simple_animal/hostile/retaliate/goose{atmos_requirements = list("min_oxy" = 0, "max_oxy" = 0, "min_tox" = 0, "max_tox" = 1, "min_co2" = 0, "max_co2" = 5, "min_n2" = 0, "max_n2" = 0); desc = "A normal goose, though capable of surviving in space. A true space vermin. Don't let it loose!"; name = "space goose"},/turf/open/floor/plating/asteroid,/area/ruin/powered)
"A" = (/turf/open/floor/plating/asteroid,/area/ruin/powered)
"X" = (/turf/closed/mineral,/area/ruin/powered)
"Z" = (/turf/template_noop,/area/template_noop)

(1,1,1) = {"
ZZZZZZZZZZZZZZZZZZZZZZZZZZZZZZZZZZZZZZZZ
ZZZZZZZZZZZZZZZZZZZZZZZZZZZZZZZZZZZZZZZZ
ZZZZZZZZZZZZZZZZZZZZZZZZZZZZZZZZZZZZZZZZ
ZZZZZZZZZZZZZZZZZZZXXXXZZZZZZZZZZZZZZZZZ
ZZZZZZZZZZZZZZZZZXXXXXXXXXXZZZZZZZZZZZZZ
ZZZZZZZZZZZZZZZZZXXXXXXXXXXXZZZZZZZZZZZZ
ZZZZZZZZZZZZZZZZXXXXXXXXXXXXXZZZZZZZZZZZ
ZZZZZZZZZZZZZZZXXXXXXXXXXXXXXXZZZZZZZZZZ
ZZZZZZZZZZZZZXXXXXXXXXXXXXXXXXXZZZZZZZZZ
ZZZZZZZZZZZZXXXXXXXXXXXXXXXXXXXZZZZZZZZZ
ZZZZZZZZZZZZXXXXXXXXXXXXXXXXXXXXZZZZZZZZ
ZZZZZZZZZZZXXXXXXXXXXXXXXXXXXXXXZZZZZZZZ
ZZZZZZZZZXXXXXXXXXXXXXXXXXXXXXXZZZZZZZZZ
ZZZZZZZZZXXXXXXXXXXXXXXXXXXXXXXZZZZZZZZZ
ZZZZZZZZXXXXXXXXXXXXXXXXXXXXXXZZZZZZZZZZ
ZZZZZZZZXXXXXXXXXXXXXXXXXXXXXXZZZZZZZZZZ
ZZZZZZZXXXXXXXXXXXXXXXXXXXXXXZZZZZZZZZZZ
ZZZZZZZXXXXXXXXXXXXXXXXXXXXXXZZZZZZZZZZZ
ZZZZZZZXXXXXXXXXXXXXXXXXXXXXXXZZZZZZZZZZ
ZZZZZZZXXXXXXXXXXXXXXXXXXXXXXXXZZZZZZZZZ
ZZZZZZZXXXXXXXXXXXXXXXXXXXXXXXXZZZZZZZZZ
ZZZZZZZXXXXXXXXXXXXXXXXXXXXXXXXZZZZZZZZZ
ZZZZZZZXXXXXXXXXXXXXXXXXXXXXXXXXZZZZZZZZ
ZZZZZZZXXXXXXXXXXXXXXXXXXXXXXXXXZZZZZZZZ
ZZZZZZZZXXXXXXXXXXXXXXXXXXXXXXXXZZZZZZZZ
ZZZZZZZZXAAXXXAgAXXXXXXAAAXXXAXZZZZZZZZZ
ZZZZZZZZXXAAXXXXAgAXXXAAXXXXgAXZZZZZZZZZ
ZZZZZZZZZXXgAXXXXXAXXAAXXXXXAXXZZZZZZZZZ
ZZZZZZZZZXXXAAXXXXAAAAgAAXXXAXXZZZZZZZZZ
ZZZZZZZZZZXXXAgAAgAgAgAAAAXgAXZZZZZZZZZZ
ZZZZZZZZZZZXXXgAAAAAgAAggAAAXXZZZZZZZZZZ
ZZZZZZZZZZZXXXgggAAAAAAggAXXXZZZZZZZZZZZ
ZZZZZZZZZZZZXXXAAAAAgAAAAXXXZZZZZZZZZZZZ
ZZZZZZZZZZZZZXXXXXXXXXXXXXXZZZZZZZZZZZZZ
ZZZZZZZZZZZZZZXXXXXXXXXXZZZZZZZZZZZZZZZZ
ZZZZZZZZZZZZZZZZZZZZZZZZZZZZZZZZZZZZZZZZ
ZZZZZZZZZZZZZZZZZZZZZZZZZZZZZZZZZZZZZZZZ
ZZZZZZZZZZZZZZZZZZZZZZZZZZZZZZZZZZZZZZZZ
ZZZZZZZZZZZZZZZZZZZZZZZZZZZZZZZZZZZZZZZZ
ZZZZZZZZZZZZZZZZZZZZZZZZZZZZZZZZZZZZZZZZ
"}
