//MAP CONVERTED BY dmm2tgm.py THIS HEADER COMMENT PREVENTS RECONVERSION, DO NOT REMOVE
"a" = (
/obj/structure/lattice,
/turf/template_noop,
/area/template_noop)
"b" = (
/obj/machinery/door/airlock/ship/external{
	name = "Portable zoo"
	},
/obj/effect/mapping_helpers/airlock/cyclelink_helper{
	dir = 1
	},
/turf/open/floor/plating,
/area/ruin/powered)
"c" = (
/obj/machinery/light/small{
	dir = 4
	},
/turf/open/floor/plating,
/area/ruin/powered)
"d" = (
/turf/open/floor/grass/fakebasalt,
/area/ruin/powered)
"e" = (
/obj/structure/lattice/catwalk,
/turf/template_noop,
/area/template_noop)
"f" = (
/obj/effect/overlay/palmtree_l,
/turf/open/floor/plating/beach/sand,
/area/ruin/powered)
"g" = (
/obj/structure/flora/rock,
/turf/open/floor/grass,
/area/ruin/powered)
"h" = (
/obj/structure/flora/ausbushes/lavendergrass,
/mob/living/simple_animal/butterfly,
/turf/open/floor/grass,
/area/ruin/powered)
"i" = (
/obj/structure/flora/ausbushes/lavendergrass,
/turf/open/floor/grass,
/area/ruin/powered)
"j" = (
/obj/structure/flora/rock/pile,
/turf/open/floor/grass/fakebasalt,
/area/ruin/powered)
"k" = (
/obj/machinery/light{
	dir = 8
	},
/turf/open/floor/grass/fakebasalt,
/area/ruin/powered)
"l" = (
/mob/living/simple_animal/parrot,
/turf/open/floor/grass,
/area/ruin/powered)
"m" = (
/obj/machinery/door/airlock/ship/external{
	name = "Portable zoo"
	},
/obj/effect/mapping_helpers/airlock/cyclelink_helper{
	dir = 8
	},
/turf/open/floor/plating,
/area/ruin/powered)
"s" = (
/obj/effect/overlay/coconut,
/turf/open/floor/plating/beach/sand,
/area/ruin/powered)
"t" = (
/mob/living/simple_animal/crab,
/turf/open/floor/plating/beach/sand,
/area/ruin/powered)
"u" = (
/mob/living/carbon/monkey,
/turf/open/floor/grass,
/area/ruin/powered)
"v" = (
/obj/machinery/light,
/turf/open/floor/plating/beach/sand,
/area/ruin/powered)
"w" = (
/turf/closed/mineral,
/area/ruin/powered)
"x" = (
/turf/open/floor/grass,
/area/ruin/powered)
"y" = (
/obj/structure/flora/ausbushes/sparsegrass,
/turf/open/floor/grass,
/area/ruin/powered)
"z" = (
/obj/machinery/door/airlock/ship/external{
	name = "Portable zoo"
	},
/obj/effect/mapping_helpers/airlock/cyclelink_helper,
/turf/open/floor/plating,
/area/ruin/powered)
"A" = (
/obj/structure/flora/rock,
/turf/open/floor/grass/fakebasalt,
/area/ruin/powered)
"B" = (
/obj/structure/flora/ausbushes/grassybush,
/turf/open/floor/grass,
/area/ruin/powered)
"D" = (
/obj/machinery/light{
	dir = 4
	},
/turf/open/floor/grass,
/area/ruin/powered)
"E" = (
/obj/structure/flora/tree/jungle,
/turf/open/floor/grass,
/area/ruin/powered)
"F" = (
/turf/template_noop,
/area/template_noop)
"H" = (
/mob/living/simple_animal/cow,
/turf/open/floor/grass,
/area/ruin/powered)
"I" = (
/obj/machinery/light/small{
	dir = 8
	},
/turf/open/floor/plating,
/area/ruin/powered)
"K" = (
/obj/machinery/light/small,
/turf/open/floor/plating,
/area/ruin/powered)
"L" = (
/obj/structure/flora/tree/jungle/small,
/turf/open/floor/grass,
/area/ruin/powered)
"M" = (
/obj/effect/spawner/structure/window/reinforced,
/turf/open/floor/plating,
/area/ruin/powered)
"N" = (
/obj/structure/flora/ausbushes/fullgrass,
/turf/open/floor/grass,
/area/ruin/powered)
"O" = (
/turf/open/floor/plating/beach/sand,
/area/ruin/powered)
"P" = (
/obj/effect/overlay/palmtree_r,
/turf/open/floor/plating/beach/sand,
/area/ruin/powered)
"S" = (
/mob/living/simple_animal/hostile/bear,
/turf/open/floor/grass/fakebasalt,
/area/ruin/powered)
"T" = (
/mob/living/simple_animal/hostile/gorilla,
/turf/open/floor/grass,
/area/ruin/powered)
"U" = (
/obj/machinery/light,
/turf/open/floor/grass,
/area/ruin/powered)
"W" = (
/turf/closed/wall/steel,
/area/ruin/powered)
"X" = (
/obj/machinery/door/airlock/ship/external{
	name = "Portable zoo"
	},
/obj/effect/mapping_helpers/airlock/cyclelink_helper{
	dir = 4
	},
/turf/open/floor/plating,
/area/ruin/powered)
"Y" = (
/obj/machinery/light/small{
	dir = 1
	},
/turf/open/floor/plating,
/area/ruin/powered)
"Z" = (
/turf/open/floor/plating,
/area/ruin/powered)

(1,1,1) = {"
F
F
F
F
F
F
F
F
F
F
F
F
F
F
F
F
F
F
F
F
F
F
F
F
F
F
F
F
F
F
F
F
F
F
F
F
F
F
F
F
"}
(2,1,1) = {"
F
F
F
F
F
F
F
F
F
F
F
F
F
F
F
F
F
F
F
F
F
F
F
F
F
F
F
F
F
F
F
F
F
F
F
F
F
F
F
F
"}
(3,1,1) = {"
F
F
F
F
F
F
F
F
F
F
F
F
F
F
F
F
F
F
F
F
F
F
F
F
F
F
F
F
F
F
F
F
F
F
F
F
F
F
F
F
"}
(4,1,1) = {"
F
F
F
F
F
F
F
F
F
F
F
F
F
F
F
F
F
F
F
F
F
F
F
F
F
F
F
F
F
F
F
F
F
F
F
F
F
F
F
F
"}
(5,1,1) = {"
F
F
a
W
a
F
F
F
F
F
F
F
F
F
F
F
F
F
F
F
F
F
F
F
F
F
F
F
F
F
F
F
F
F
F
a
W
a
F
F
"}
(6,1,1) = {"
F
F
W
W
W
M
M
M
W
W
F
F
F
F
F
F
F
F
F
F
F
F
F
F
F
F
F
F
F
F
W
W
M
M
M
W
W
W
F
F
"}
(7,1,1) = {"
F
F
a
W
l
x
x
x
L
W
W
W
F
F
F
F
F
F
F
F
F
F
F
F
F
F
F
F
W
W
W
x
i
x
i
x
W
a
F
F
"}
(8,1,1) = {"
F
F
F
M
x
E
T
x
u
W
Z
W
a
a
a
a
a
a
a
a
a
a
a
a
a
a
a
a
W
I
W
B
H
B
N
i
M
F
F
F
"}
(9,1,1) = {"
F
F
F
M
x
x
x
x
x
z
Z
b
e
e
e
e
e
e
e
e
e
e
e
e
e
e
e
e
z
Z
b
i
N
h
N
g
M
F
F
F
"}
(10,1,1) = {"
F
F
F
M
x
T
x
u
U
W
c
W
a
a
a
a
a
a
a
w
w
w
w
w
w
a
a
a
W
Z
W
H
y
B
x
N
M
F
F
F
"}
(11,1,1) = {"
F
F
F
W
x
x
x
E
x
W
W
W
a
F
F
F
w
w
w
w
w
w
w
w
w
w
F
a
W
W
W
B
D
i
H
y
W
F
F
F
"}
(12,1,1) = {"
F
F
F
W
W
W
X
W
W
W
F
a
a
F
w
w
w
w
w
w
w
w
w
w
w
w
w
a
F
a
W
W
W
X
W
W
W
F
F
F
"}
(13,1,1) = {"
F
F
F
F
W
Y
Z
Z
W
F
F
a
w
w
w
w
w
w
w
w
w
w
w
w
w
w
w
w
a
a
a
W
Y
Z
Z
W
F
F
F
F
"}
(14,1,1) = {"
F
F
F
F
W
W
m
W
W
a
a
w
w
w
w
w
w
w
w
w
w
w
w
w
w
w
w
w
w
a
a
W
W
m
W
W
F
F
F
F
"}
(15,1,1) = {"
F
F
F
F
F
a
e
a
a
F
a
w
w
w
w
w
w
w
w
w
w
w
w
w
w
w
w
w
w
a
a
a
a
e
a
F
F
F
F
F
"}
(16,1,1) = {"
F
F
F
F
F
a
e
a
F
F
w
w
w
w
w
w
w
w
w
w
w
w
w
w
w
w
w
w
w
w
a
a
F
e
F
F
F
F
F
F
"}
(17,1,1) = {"
F
F
F
F
F
a
e
a
a
w
w
w
w
w
w
w
w
w
w
w
w
w
w
w
w
w
w
w
w
w
F
F
F
e
F
F
F
F
F
F
"}
(18,1,1) = {"
F
F
F
F
F
a
e
a
F
w
w
w
w
w
w
w
w
w
w
w
w
w
w
w
w
w
w
w
w
w
w
F
F
e
F
F
F
F
F
F
"}
(19,1,1) = {"
F
F
F
F
F
a
e
a
w
w
w
w
w
w
w
w
w
w
w
w
w
w
w
w
w
w
w
w
w
w
w
w
F
e
F
F
F
F
F
F
"}
(20,1,1) = {"
F
F
F
F
F
a
e
a
w
w
w
w
w
w
w
w
w
w
w
w
w
w
w
w
w
w
w
w
w
w
w
w
F
e
F
F
F
F
F
F
"}
(21,1,1) = {"
F
F
F
F
F
a
e
a
w
w
w
w
w
w
w
w
w
w
w
w
w
w
w
w
w
w
w
w
w
w
w
w
F
e
F
F
F
F
F
F
"}
(22,1,1) = {"
F
F
F
F
F
a
e
a
w
w
w
w
w
w
w
w
w
w
w
w
w
w
w
w
w
w
w
w
w
w
w
w
F
e
F
F
F
F
F
F
"}
(23,1,1) = {"
F
F
F
F
F
a
e
a
w
w
w
w
w
w
w
w
w
w
w
w
w
w
w
w
w
w
w
w
w
w
w
w
F
e
F
F
F
F
F
F
"}
(24,1,1) = {"
F
F
F
F
F
a
e
a
w
w
w
w
w
w
w
w
w
w
w
w
w
w
w
w
w
w
w
w
w
w
w
F
F
e
F
F
F
F
F
F
"}
(25,1,1) = {"
F
F
F
F
F
a
e
a
F
w
w
w
w
w
w
w
w
w
w
w
w
w
w
w
w
w
w
w
w
w
w
F
F
e
F
F
F
F
F
F
"}
(26,1,1) = {"
F
F
F
F
F
a
e
a
F
F
w
w
w
w
w
w
w
w
w
w
w
w
w
w
w
w
w
w
w
w
F
F
F
e
F
F
F
F
F
F
"}
(27,1,1) = {"
F
F
F
F
F
a
e
a
F
F
w
w
w
w
w
w
w
w
w
w
w
w
w
w
w
w
w
w
w
F
F
F
a
e
a
F
F
F
F
F
"}
(28,1,1) = {"
F
F
F
F
W
W
X
W
W
F
w
w
w
w
w
w
w
w
w
w
w
w
w
w
w
w
w
w
F
F
F
W
W
X
W
W
F
F
F
F
"}
(29,1,1) = {"
F
F
F
F
W
Z
Z
K
W
F
F
w
w
w
w
w
w
w
w
w
w
w
w
w
w
w
w
F
F
F
F
W
Y
Z
Z
W
F
F
F
F
"}
(30,1,1) = {"
F
F
F
W
W
W
m
W
W
W
F
F
F
F
w
w
w
w
w
w
w
w
w
w
w
F
F
F
F
F
W
W
W
m
W
W
W
F
F
F
"}
(31,1,1) = {"
F
F
F
W
O
O
O
P
s
W
W
W
F
F
F
F
F
w
w
w
w
w
w
F
F
F
F
F
W
W
W
d
k
d
d
d
W
F
F
F
"}
(32,1,1) = {"
F
F
F
M
O
t
O
t
v
W
I
W
a
a
a
a
a
a
a
w
w
w
a
a
a
a
a
a
W
Z
W
j
d
A
S
d
M
F
F
F
"}
(33,1,1) = {"
F
F
F
M
O
f
s
O
O
z
Z
b
e
e
e
e
e
e
e
e
e
e
e
e
e
e
e
e
z
Z
b
d
S
d
d
d
M
F
F
F
"}
(34,1,1) = {"
F
F
F
M
s
O
O
P
s
W
Z
W
a
a
a
a
a
a
a
a
a
a
a
a
a
a
a
a
W
c
W
d
d
j
S
d
M
F
F
F
"}
(35,1,1) = {"
F
F
a
W
O
O
f
t
O
W
W
W
F
F
F
F
F
F
F
F
F
F
F
F
F
F
F
F
W
W
W
d
d
d
d
d
W
a
F
F
"}
(36,1,1) = {"
F
F
W
W
W
M
M
M
W
W
F
F
F
F
F
F
F
F
F
F
F
F
F
F
F
F
F
F
F
F
W
W
M
M
M
W
W
W
F
F
"}
(37,1,1) = {"
F
F
a
W
a
F
F
F
F
F
F
F
F
F
F
F
F
F
F
F
F
F
F
F
F
F
F
F
F
F
F
F
F
F
F
a
W
a
F
F
"}
(38,1,1) = {"
F
F
F
F
F
F
F
F
F
F
F
F
F
F
F
F
F
F
F
F
F
F
F
F
F
F
F
F
F
F
F
F
F
F
F
F
F
F
F
F
"}
(39,1,1) = {"
F
F
F
F
F
F
F
F
F
F
F
F
F
F
F
F
F
F
F
F
F
F
F
F
F
F
F
F
F
F
F
F
F
F
F
F
F
F
F
F
"}
(40,1,1) = {"
F
F
F
F
F
F
F
F
F
F
F
F
F
F
F
F
F
F
F
F
F
F
F
F
F
F
F
F
F
F
F
F
F
F
F
F
F
F
F
F
"}
