"a" = (/turf/template_noop,/area/template_noop)
"b" = (/turf/closed/mineral,/area/ruin/powered)
"c" = (/turf/open/floor/plating/asteroid/basalt/lava_land_surface{initial_gas_mix = "TEMP=2.7"},/area/ruin/powered)
"d" = (/mob/living/simple_animal/hostile/asteroid/goliath/beast,/turf/open/floor/plating/asteroid/basalt/lava_land_surface{initial_gas_mix = "TEMP=2.7"},/area/ruin/powered)
"e" = (/turf/open/floor/plating/asteroid/airless,/area/ruin/powered)
"f" = (/turf/closed/wall/mineral/titanium/survival/pod,/area/ruin/powered)
"g" = (/obj/structure/fans,/turf/open/floor/pod/dark,/area/ruin/powered)
"h" = (/obj/machinery/smartfridge/survival_pod/empty,/turf/open/floor/pod/dark,/area/ruin/powered)
"i" = (/obj/item/gps/computer,/obj/structure/tubes,/turf/open/floor/pod/dark,/area/ruin/powered)
"j" = (/obj/structure/sign/mining/survival{dir = 8;pixel_x = -32},/turf/open/floor/plating/asteroid/basalt/lava_land_surface{initial_gas_mix = "TEMP=2.7"},/area/ruin/powered)
"k" = (/obj/machinery/sleeper/survival_pod,/turf/open/floor/pod/dark,/area/ruin/powered)
"l" = (/obj/item/pickaxe,/obj/effect/decal/cleanable/blood,/turf/open/floor/pod/dark,/area/ruin/powered)
"m" = (/obj/structure/bed/pod,/obj/item/bedsheet/black,/obj/structure/tubes,/obj/machinery/light/small{dir = 4},/turf/open/floor/pod/dark,/area/ruin/powered)
"n" = (/obj/structure/table/survival_pod,/obj/item/kitchen/knife/combat/survival,/turf/open/floor/pod/dark,/area/ruin/powered)
"o" = (/obj/effect/mob_spawn/human/miner/explorer{brute_damage = 150;oxy_damage = 50},/obj/effect/decal/cleanable/blood,/obj/effect/decal/cleanable/blood/drip,/obj/effect/decal/cleanable/blood/footprints{dir = 1},/turf/open/floor/pod/dark,/area/ruin/powered)
"p" = (/obj/structure/tubes,/obj/item/crowbar,/obj/effect/decal/cleanable/blood/drip,/turf/open/floor/pod/dark,/area/ruin/powered)
"q" = (/obj/structure/sign/mining/survival{dir = 8;pixel_x = -32},/obj/effect/decal/cleanable/blood,/turf/open/floor/plating/asteroid/basalt/lava_land_surface{initial_gas_mix = "TEMP=2.7"},/area/ruin/powered)
"r" = (/obj/effect/decal/cleanable/blood/footprints{dir = 1},/obj/machinery/door/airlock/survival_pod/glass,/obj/structure/fans/tiny,/turf/open/floor/pod/dark,/area/ruin/powered)
"s" = (/obj/effect/decal/cleanable/blood/footprints,/turf/open/floor/plating/asteroid/basalt/lava_land_surface{initial_gas_mix = "TEMP=2.7"},/area/ruin/powered)
"t" = (/obj/structure/sign/mining/survival{pixel_y = 32},/turf/open/floor/plating/asteroid/basalt/lava_land_surface{initial_gas_mix = "TEMP=2.7"},/area/ruin/powered)
"u" = (/obj/effect/decal/cleanable/blood/drip,/obj/effect/decal/cleanable/blood/footprints{dir = 1},/turf/open/floor/plating/asteroid/basalt/lava_land_surface{initial_gas_mix = "TEMP=2.7"},/area/ruin/powered)
"v" = (/obj/structure/sign/mining{pixel_y = 32},/obj/effect/decal/cleanable/blood/footprints{dir = 8},/turf/open/floor/plating/asteroid/basalt/lava_land_surface{initial_gas_mix = "TEMP=2.7"},/area/ruin/powered)
"w" = (/obj/effect/decal/cleanable/blood/footprints{dir = 8},/turf/open/floor/plating/asteroid/basalt/lava_land_surface{initial_gas_mix = "TEMP=2.7"},/area/ruin/powered)
"x" = (/obj/effect/decal/cleanable/blood/footprints,/obj/effect/decal/cleanable/blood/drip,/turf/open/floor/plating/asteroid/basalt/lava_land_surface{initial_gas_mix = "TEMP=2.7"},/area/ruin/powered)

(1,1,1) = {"
aaaaaaaaaaaaaaaaaaaaaaaaaaaaaaaaaaaaaaaa
aaaaaaaaaaaaaaaaaaaaaaaaaaaaaaaaaaaaaaaa
aaaaaaaaaaaaaaaaaaaaaaaaaaaaaaaaaaaaaaaa
aaaaaaaaaaaaaaaaaaaaaaaaaaaaaaaaaaaaaaaa
aaaaaaaaaaaaaaaaabbbbbbbbbbaaaaaaaaaaaaa
aaaaaaaaaaaaaaabbbbbbbbbbbbbbaaaaaaaaaaa
aaaaaaaaaaaabbbbbbbbbbbbbbbbbbbaaaaaaaaa
aaaaaaaaaaabbbbbbbbbbbbbbbbbbbbbaaaaaaaa
aaaaaaaaaabbbbbbbbbbbbbbbbbbbbbbbaaaaaaa
aaaaaaaabbbbbbbbbbbbbbbbbbccccbbbbaaaaaa
aaaaaaaabbbbbbbbbbbbbbbbbbbcccbbbbaaaaaa
aaaaaaabbbccbcbbbbbbbbbbcccdcbbbbbaaaaaa
aaaaaabcccccccbbbbbbbbbbbcccccbbbaaaaaaa
aaaaaabbbbcccbbbbbbbbbbbbbcbbcbbbbaaaaaa
aaaaabbbbbcdcccbbbbbbbbbbbbbbbbbbbaaaaaa
aaaaabbbbbbccccbbbbbbbbbbbbbbbbbbbbaaaaa
aaaaaabbbbbccbbbbbbbbbbbbbbbbbbbbbbaaaaa
aaaaaabbbbbcbbbbbbbbbbbbbbbbbbbbbbbbaaaa
aaaaaabbbbbbbbbbbbbbbbbbbbbbbbbbbbbbaaaa
aaaaabbbbbbbbbbbbbbbbbbbbbbbbbbbbbbbaaaa
aaaaabbbbbbbbbbbbbbbbbbbbbbbbbbbbbbbaaaa
aaaaabbbbbbbbbbbbbbbbbbbbbbbbbbbbbbaaaaa
aaaaabbbbbbbbbbbbbbbbbbbbbbbbbbbbbbaaaaa
aaaaeebbbbbbbbbbbbbbbbbbbbbbbbbbbbaaaaaa
aaaeeeebbbbbbbbbbbbbbbbbbbbbbbbbbbaaaaaa
aaaeeeecccbbbbbbbbbbbbbbbbbbbbbbbaaaaaaa
aaaeeeccccccbbbbbbbbbbbbbbbbbbbbaaaaaaaa
aaaeeeccccccbbfffffcbbbbbbbbbbbaaaaaaaaa
aaaeeebbbccccbfghifjbbbbbbbbbbaaaaaaaaaa
aaaaebbbbbbcccfklmfdbbbbbbbbbbaaaaaaaaaa
aaaabbbbbbbcccfnopfqbbbbbbbbbbbaaaaaaaaa
aaaabbbbbbbbccffrffsbbbbbbbbbbbbaaaaaaaa
aaaaabbbbbbbccctuvwxbbbbbbbbbbbbaaaaaaaa
aaaaaabbbbbbbccbcbbbbbbbbbbbbbbbaaaaaaaa
aaaaaaabbbbbbbbbbbbbbbbbbbbbbbbaaaaaaaaa
aaaaaaaabbbbbbbbbbbbbbbbbbbbbbaaaaaaaaaa
aaaaaaaaabbbbabbbbbbbbbbbbbbaaaaaaaaaaaa
aaaaaaaaaaaaaaaabbbbbbbbbbaaaaaaaaaaaaaa
aaaaaaaaaaaaaaaaaabbbbbbbaaaaaaaaaaaaaaa
aaaaaaaaaaaaaaaaaaaaaaaaaaaaaaaaaaaaaaaa
"}
