"a" = (/turf/open/space/basic,/area/space)
"b" = (/turf/open/floor/plating/asteroid,/area/ruin/powered)
"c" = (/obj/effect/spawner/structure/window/reinforced,/turf/open/floor/plating,/area/ruin/powered)
"d" = (/obj/structure/frame/computer,/turf/open/floor/plating/asteroid,/area/ruin/powered)
"e" = (/obj/item/crowbar,/obj/structure/table,/obj/item/pinpointer/crew,/turf/open/floor/plating/asteroid,/area/ruin/powered)
"f" = (/obj/structure/mineral_door/transparent/diamond,/turf/open/floor/plating/asteroid,/area/ruin/powered)
"g" = (/obj/structure/fans/tiny/invisible,/obj/machinery/door/airlock/ship/external{name = "Asteroid transport"},/turf/open/floor/plating/asteroid,/area/ruin/powered)
"h" = (/obj/machinery/door/airlock/ship/external{name = "Asteroid transport"},/turf/open/floor/plating/asteroid,/area/ruin/powered)
"i" = (/turf/closed/mineral,/area/ruin/powered)
"j" = (/obj/structure/mineral_door/iron,/turf/open/floor/plating/asteroid,/area/ruin/powered)
"k" = (/obj/structure/chair,/turf/open/floor/plating/asteroid,/area/ruin/powered)
"l" = (/obj/structure/chair{icon_state = "chair"; dir = 4},/turf/open/floor/plating/asteroid,/area/ruin/powered)
"m" = (/obj/structure/chair{icon_state = "chair"; dir = 1},/turf/open/floor/plating/asteroid,/area/ruin/powered)
"n" = (/obj/structure/rack,/obj/item/bedsheet/rainbow,/obj/item/book/random,/turf/open/floor/plating/asteroid,/area/ruin/powered)
"o" = (/obj/structure/rack,/obj/item/bedsheet/patriot,/obj/item/book/random,/turf/open/floor/plating/asteroid,/area/ruin/powered)
"p" = (/obj/structure/rack,/obj/item/bedsheet/syndie,/obj/item/book/random,/turf/open/floor/plating/asteroid,/area/ruin/powered)
"q" = (/obj/structure/mineral_door/wood,/turf/open/floor/plating/asteroid,/area/ruin/powered)
"r" = (/obj/structure/table,/obj/item/clipboard,/turf/open/floor/plating/asteroid,/area/ruin/powered)
"s" = (/obj/structure/table,/turf/open/floor/plating/asteroid,/area/ruin/powered)
"t" = (/obj/structure/table,/obj/item/extendohand,/turf/open/floor/plating/asteroid,/area/ruin/powered)
"u" = (/obj/structure/tank_dispenser,/turf/open/floor/plating/asteroid,/area/ruin/powered)
"v" = (/obj/structure/chair{icon_state = "chair"; dir = 8},/turf/open/floor/plating/asteroid,/area/ruin/powered)
"w" = (/obj/item/paint/anycolor,/obj/structure/rack,/turf/open/floor/plating/asteroid,/area/ruin/powered)
"x" = (/obj/structure/chair{icon_state = "chair"; dir = 4},/obj/structure/window/reinforced,/obj/structure/window/reinforced{icon_state = "rwindow"; dir = 4},/turf/open/floor/plating/asteroid,/area/ruin/powered)
"y" = (/obj/structure/mineral_door/gold,/turf/open/floor/plating/asteroid,/area/ruin/powered)
"z" = (/obj/structure/shuttle/engine/heater,/obj/structure/window/reinforced{dir = 1; pixel_y = 1},/turf/open/floor/plating/airless,/area/ruin/powered)
"A" = (/obj/structure/shuttle/engine/propulsion/burst,/turf/open/floor/plating/airless,/area/ruin/powered)

(1,1,1) = {"
aaaaaaaaaaaaaaaaaaaaaaaaaaaaaaaaaaaaaaaa
aaaaaaaaaaaaaaaaaaaaaaaaaaaaaaaaaaaaaaaa
aaaaaaaaaaaaaaaaaaaaaaaaaaaaaaaaaaaaaaaa
aaaaaaaaaaaaaaaaaaaaaaaaaaaaaaaaaaaaaaaa
aaaaaaaaaaaaaaaaaaaaaaaaaaaaaaaaaaaaaaaa
aaaaaaaaaaaaaaaabbaaaaaiiiiaaaaaaaaaaaaa
aaaaaaaaiiiiaaaccccciaiiiiiiaaaaaaaaaaaa
aaaaaaaiiiiiiiccdddeiiiiiiiiiaaaaaaaaaaa
aaaaaaiiiiiiiibbbbbbiiiiiiiiiiaaaaaaaaaa
aaaaaiiiiiiiiibbbbbbiiiiiiiiiiiaaaaaaaaa
aaaaaiiiiiiiiibiiiiiiiiiiiiiiiiaaaaaaaaa
aaaaaiiiiiiiiifiiiiiiiiiiiiiiiiiaaaaaaaa
aaaaaaiiiiiiiibiiiiiiiiiiiiiiiiiaaaaaaaa
aaaaaaaiibbbbbbiiiiiiiiiiiiiiiiiiaaaaaaa
aaaaaaiiibiiiiiiiiiiiiiiiiiiiiiiiaaaaaaa
aaaaaiiiibiiiiiiiiiiiiiiiiiiiiiiiaaaaaaa
aaaaaaiiibiiiiiiiiiiiiiiiiiiiiiiaaaaaaaa
aaaaaaaiibiiiiiiiiiiiiiiiiiiiiiiiaaaaaaa
aaaaaaiiibiiiiiiiiiiiiiiiiiiiiiiiaaaaaaa
aaaaaaiiibiiiiiiiiiiiiiiiiiiiiiiiiaaaaaa
aaaaaiiiibiiiiiiiiiiiiiiiiiiiiiiiiaaaaaa
aaaaaiiiibiiiiiiiiiiiiiiiiiiiiiiiiiaaaaa
aaaaaiiiibiiiiiiiiiiiiiiiiiiiiiiiiiaaaaa
aaaaaiiiibiiiiiiiiiiiiiiiiiiiiiiiiiiaaaa
aaaaaaiiibiiiiiiiiiiiiiiiiiiiiiiiiiiaaaa
aaaaaagbhbbbiiiiiiiiiiiiiiiiiiiiiiiiaaaa
aaaaaiiiiiijiiiiiiiiiiiiiiiiiiiiiiiaaaaa
aaaaaiiiiibbkkkiiiiiiiiiiiiiiiiiiiiaaaaa
aaaaaiiiilbbbbbbiiiiiiiiiiiiiiiiiiaaaaaa
aaaaaiiiilbbbbbbbiiiiiiiiiiiiiiiiiaaaaaa
aaaaaiiiiimmmmmbbjbbiiiiiiiiiiiiiiiaaaaa
aaaaaiiiiiiiiiiiiiibiiiiiiiiiiiiiiiaaaaa
aaaaaaiiiiiiniiopiibiiiiiiiiiiiiiiiaaaaa
aaaaaaiiiiibbbbbbbqbbbbiirstiiiiiiaaaaaa
aaaaaaaiiiubbbbbbbibiibilbbbviiiiiaaaaaa
aaaaaaaaaiwbbbbbbbihiibixbbbviiiiaaaaaaa
aaaaaaaaaiibbbbbbbibiibybbbbviiaaaaaaaaa
aaaaaaaaaaizzzzziiigiiiizzzzziaaaaaaaaaa
aaaaaaaaaaaAAAAAaiiaiiiaAAAAAaaaaaaaaaaa
aaaaaaaaaaaaaaaaaaaaaaaaaaaaaaaaaaaaaaaa
"}
