//MAP CONVERTED BY dmm2tgm.py THIS HEADER COMMENT PREVENTS RECONVERSION, DO NOT REMOVE
"b" = (
/obj/machinery/door/airlock/ship/external{
	name = "Portable zoo"
	},
/obj/effect/mapping_helpers/airlock/cyclelink_helper{
	dir = 1
	},
/turf/open/floor/plating,
/area/ruin/powered)
"c" = (
/obj/machinery/light/small{
	dir = 4
	},
/turf/open/floor/plating,
/area/ruin/powered)
"d" = (
/turf/open/floor/grass/fakebasalt,
/area/ruin/powered)
"e" = (
/obj/structure/lattice/catwalk,
/turf/open/space/basic,
/area/space)
"f" = (
/obj/effect/overlay/palmtree_l,
/turf/open/floor/plating/beach/sand,
/area/ruin/powered)
"g" = (
/obj/structure/flora/rock,
/turf/open/floor/grass,
/area/ruin/powered)
"i" = (
/obj/structure/flora/ausbushes/lavendergrass,
/turf/open/floor/grass,
/area/ruin/powered)
"j" = (
/obj/structure/flora/rock/pile,
/turf/open/floor/grass/fakebasalt,
/area/ruin/powered)
"k" = (
/obj/machinery/light{
	dir = 8
	},
/turf/open/floor/grass/fakebasalt,
/area/ruin/powered)
"l" = (
/mob/living/simple_animal/parrot,
/turf/open/floor/grass,
/area/ruin/powered)
"m" = (
/obj/machinery/door/airlock/ship/external{
	name = "Portable zoo"
	},
/obj/effect/mapping_helpers/airlock/cyclelink_helper{
	dir = 8
	},
/turf/open/floor/plating,
/area/ruin/powered)
"n" = (
/mob/living/simple_animal/butterfly,
/obj/structure/flora/ausbushes/lavendergrass,
/turf/open/floor/grass,
/area/ruin/powered)
"s" = (
/obj/effect/overlay/coconut,
/turf/open/floor/plating/beach/sand,
/area/ruin/powered)
"t" = (
/mob/living/simple_animal/crab,
/turf/open/floor/plating/beach/sand,
/area/ruin/powered)
"u" = (
/mob/living/carbon/monkey,
/turf/open/floor/grass,
/area/ruin/powered)
"v" = (
/obj/machinery/light,
/turf/open/floor/plating/beach/sand,
/area/ruin/powered)
"w" = (
/turf/closed/mineral,
/area/ruin/powered)
"x" = (
/turf/open/floor/grass,
/area/ruin/powered)
"y" = (
/obj/structure/flora/ausbushes/sparsegrass,
/turf/open/floor/grass,
/area/ruin/powered)
"z" = (
/obj/machinery/door/airlock/ship/external{
	name = "Portable zoo"
	},
/obj/effect/mapping_helpers/airlock/cyclelink_helper,
/turf/open/floor/plating,
/area/ruin/powered)
"A" = (
/obj/structure/flora/rock,
/turf/open/floor/grass/fakebasalt,
/area/ruin/powered)
"B" = (
/obj/structure/flora/ausbushes/grassybush,
/turf/open/floor/grass,
/area/ruin/powered)
"D" = (
/obj/machinery/light{
	dir = 4
	},
/turf/open/floor/grass,
/area/ruin/powered)
"E" = (
/obj/structure/flora/tree/jungle,
/turf/open/floor/grass,
/area/ruin/powered)
"F" = (
/turf/open/space/basic,
/area/space)
"H" = (
/mob/living/simple_animal/cow,
/turf/open/floor/grass,
/area/ruin/powered)
"I" = (
/obj/machinery/light/small{
	dir = 8
	},
/turf/open/floor/plating,
/area/ruin/powered)
"K" = (
/obj/machinery/light/small,
/turf/open/floor/plating,
/area/ruin/powered)
"L" = (
/obj/structure/flora/tree/jungle/small,
/turf/open/floor/grass,
/area/ruin/powered)
"M" = (
/obj/effect/spawner/structure/window/reinforced,
/turf/open/floor/plating,
/area/ruin/powered)
"N" = (
/obj/structure/flora/ausbushes/fullgrass,
/turf/open/floor/grass,
/area/ruin/powered)
"O" = (
/turf/open/floor/plating/beach/sand,
/area/ruin/powered)
"P" = (
/obj/effect/overlay/palmtree_r,
/turf/open/floor/plating/beach/sand,
/area/ruin/powered)
"R" = (
/obj/structure/lattice,
/turf/open/space/basic,
/area/space)
"S" = (
/mob/living/simple_animal/hostile/bear,
/turf/open/floor/grass/fakebasalt,
/area/ruin/powered)
"T" = (
/mob/living/simple_animal/hostile/gorilla,
/turf/open/floor/grass,
/area/ruin/powered)
"U" = (
/obj/machinery/light,
/turf/open/floor/grass,
/area/ruin/powered)
"W" = (
/turf/closed/wall/steel,
/area/ruin/powered)
"X" = (
/obj/machinery/door/airlock/ship/external{
	name = "Portable zoo"
	},
/obj/effect/mapping_helpers/airlock/cyclelink_helper{
	dir = 4
	},
/turf/open/floor/plating,
/area/ruin/powered)
"Y" = (
/obj/machinery/light/small{
	dir = 1
	},
/turf/open/floor/plating,
/area/ruin/powered)
"Z" = (
/turf/open/floor/plating,
/area/ruin/powered)

(1,1,1) = {"
F
F
F
F
F
F
F
F
F
F
F
F
F
F
F
F
F
F
F
F
F
F
F
F
F
F
F
F
F
F
F
F
F
F
F
F
F
F
F
F
"}
(2,1,1) = {"
F
F
F
F
F
F
F
F
F
F
F
F
F
F
F
F
F
F
F
F
F
F
F
F
F
F
F
F
F
F
F
F
F
F
F
F
F
F
F
F
"}
(3,1,1) = {"
F
F
F
F
F
F
F
F
F
F
F
F
F
F
F
F
F
F
F
F
F
F
F
F
F
F
F
F
F
F
F
F
F
F
F
F
F
F
F
F
"}
(4,1,1) = {"
F
F
F
F
F
F
F
F
F
F
F
F
F
F
F
F
F
F
F
F
F
F
F
F
F
F
F
F
F
F
F
F
F
F
F
F
F
F
F
F
"}
(5,1,1) = {"
F
F
R
W
R
F
F
F
F
F
F
F
F
F
F
F
F
F
F
F
F
F
F
F
F
F
F
F
F
F
F
F
F
F
F
R
W
R
F
F
"}
(6,1,1) = {"
F
F
W
W
W
M
M
M
W
W
F
F
F
F
F
F
F
F
F
F
F
F
F
F
F
F
F
F
F
F
W
W
M
M
M
W
W
W
F
F
"}
(7,1,1) = {"
F
F
R
W
l
x
x
x
L
W
W
W
F
F
F
F
F
F
F
F
F
F
F
F
F
F
F
F
W
W
W
x
i
x
i
x
W
R
F
F
"}
(8,1,1) = {"
F
F
F
M
x
E
T
x
u
W
Z
W
R
R
R
R
R
R
R
R
R
R
R
R
R
R
R
R
W
I
W
B
H
B
N
i
M
F
F
F
"}
(9,1,1) = {"
F
F
F
M
x
x
x
x
x
z
Z
b
e
e
e
e
e
e
e
e
e
e
e
e
e
e
e
e
z
Z
b
i
N
n
N
g
M
F
F
F
"}
(10,1,1) = {"
F
F
F
M
x
T
x
u
U
W
c
W
R
R
R
R
R
R
R
w
w
w
w
w
w
R
R
R
W
Z
W
H
y
B
x
N
M
F
F
F
"}
(11,1,1) = {"
F
F
F
W
x
x
x
E
x
W
W
W
R
F
F
F
w
w
w
w
w
w
w
w
w
w
F
R
W
W
W
B
D
i
H
y
W
F
F
F
"}
(12,1,1) = {"
F
F
F
W
W
W
X
W
W
W
F
R
R
F
w
w
w
w
w
w
w
w
w
w
w
w
w
R
F
R
W
W
W
X
W
W
W
F
F
F
"}
(13,1,1) = {"
F
F
F
F
W
Y
Z
Z
W
F
F
R
w
w
w
w
w
w
w
w
w
w
w
w
w
w
w
w
R
R
R
W
Y
Z
Z
W
F
F
F
F
"}
(14,1,1) = {"
F
F
F
F
W
W
m
W
W
R
R
w
w
w
w
w
w
w
w
w
w
w
w
w
w
w
w
w
w
R
R
W
W
m
W
W
F
F
F
F
"}
(15,1,1) = {"
F
F
F
F
F
R
e
R
R
F
R
w
w
w
w
w
w
w
w
w
w
w
w
w
w
w
w
w
w
R
R
R
R
e
R
F
F
F
F
F
"}
(16,1,1) = {"
F
F
F
F
F
R
e
R
F
F
w
w
w
w
w
w
w
w
w
w
w
w
w
w
w
w
w
w
w
w
R
R
F
e
F
F
F
F
F
F
"}
(17,1,1) = {"
F
F
F
F
F
R
e
R
R
w
w
w
w
w
w
w
w
w
w
w
w
w
w
w
w
w
w
w
w
w
F
F
F
e
F
F
F
F
F
F
"}
(18,1,1) = {"
F
F
F
F
F
R
e
R
F
w
w
w
w
w
w
w
w
w
w
w
w
w
w
w
w
w
w
w
w
w
w
F
F
e
F
F
F
F
F
F
"}
(19,1,1) = {"
F
F
F
F
F
R
e
R
w
w
w
w
w
w
w
w
w
w
w
w
w
w
w
w
w
w
w
w
w
w
w
w
F
e
F
F
F
F
F
F
"}
(20,1,1) = {"
F
F
F
F
F
R
e
R
w
w
w
w
w
w
w
w
w
w
w
w
w
w
w
w
w
w
w
w
w
w
w
w
F
e
F
F
F
F
F
F
"}
(21,1,1) = {"
F
F
F
F
F
R
e
R
w
w
w
w
w
w
w
w
w
w
w
w
w
w
w
w
w
w
w
w
w
w
w
w
F
e
F
F
F
F
F
F
"}
(22,1,1) = {"
F
F
F
F
F
R
e
R
w
w
w
w
w
w
w
w
w
w
w
w
w
w
w
w
w
w
w
w
w
w
w
w
F
e
F
F
F
F
F
F
"}
(23,1,1) = {"
F
F
F
F
F
R
e
R
w
w
w
w
w
w
w
w
w
w
w
w
w
w
w
w
w
w
w
w
w
w
w
w
F
e
F
F
F
F
F
F
"}
(24,1,1) = {"
F
F
F
F
F
R
e
R
w
w
w
w
w
w
w
w
w
w
w
w
w
w
w
w
w
w
w
w
w
w
w
F
F
e
F
F
F
F
F
F
"}
(25,1,1) = {"
F
F
F
F
F
R
e
R
F
w
w
w
w
w
w
w
w
w
w
w
w
w
w
w
w
w
w
w
w
w
w
F
F
e
F
F
F
F
F
F
"}
(26,1,1) = {"
F
F
F
F
F
R
e
R
F
F
w
w
w
w
w
w
w
w
w
w
w
w
w
w
w
w
w
w
w
w
F
F
F
e
F
F
F
F
F
F
"}
(27,1,1) = {"
F
F
F
F
F
R
e
R
F
F
w
w
w
w
w
w
w
w
w
w
w
w
w
w
w
w
w
w
w
F
F
F
R
e
R
F
F
F
F
F
"}
(28,1,1) = {"
F
F
F
F
W
W
X
W
W
F
w
w
w
w
w
w
w
w
w
w
w
w
w
w
w
w
w
w
F
F
F
W
W
X
W
W
F
F
F
F
"}
(29,1,1) = {"
F
F
F
F
W
Z
Z
K
W
F
F
w
w
w
w
w
w
w
w
w
w
w
w
w
w
w
w
F
F
F
F
W
Y
Z
Z
W
F
F
F
F
"}
(30,1,1) = {"
F
F
F
W
W
W
m
W
W
W
F
F
F
F
w
w
w
w
w
w
w
w
w
w
w
F
F
F
F
F
W
W
W
m
W
W
W
F
F
F
"}
(31,1,1) = {"
F
F
F
W
O
O
O
P
s
W
W
W
F
F
F
F
F
w
w
w
w
w
w
F
F
F
F
F
W
W
W
d
k
d
d
d
W
F
F
F
"}
(32,1,1) = {"
F
F
F
M
O
t
O
t
v
W
I
W
R
R
R
R
R
R
R
w
w
w
R
R
R
R
R
R
W
Z
W
j
d
A
S
d
M
F
F
F
"}
(33,1,1) = {"
F
F
F
M
O
f
s
O
O
z
Z
b
e
e
e
e
e
e
e
e
e
e
e
e
e
e
e
e
z
Z
b
d
S
d
d
d
M
F
F
F
"}
(34,1,1) = {"
F
F
F
M
s
O
O
P
s
W
Z
W
R
R
R
R
R
R
R
R
R
R
R
R
R
R
R
R
W
c
W
d
d
j
S
d
M
F
F
F
"}
(35,1,1) = {"
F
F
R
W
O
O
f
t
O
W
W
W
F
F
F
F
F
F
F
F
F
F
F
F
F
F
F
F
W
W
W
d
d
d
d
d
W
R
F
F
"}
(36,1,1) = {"
F
F
W
W
W
M
M
M
W
W
F
F
F
F
F
F
F
F
F
F
F
F
F
F
F
F
F
F
F
F
W
W
M
M
M
W
W
W
F
F
"}
(37,1,1) = {"
F
F
R
W
R
F
F
F
F
F
F
F
F
F
F
F
F
F
F
F
F
F
F
F
F
F
F
F
F
F
F
F
F
F
F
R
W
R
F
F
"}
(38,1,1) = {"
F
F
F
F
F
F
F
F
F
F
F
F
F
F
F
F
F
F
F
F
F
F
F
F
F
F
F
F
F
F
F
F
F
F
F
F
F
F
F
F
"}
(39,1,1) = {"
F
F
F
F
F
F
F
F
F
F
F
F
F
F
F
F
F
F
F
F
F
F
F
F
F
F
F
F
F
F
F
F
F
F
F
F
F
F
F
F
"}
(40,1,1) = {"
F
F
F
F
F
F
F
F
F
F
F
F
F
F
F
F
F
F
F
F
F
F
F
F
F
F
F
F
F
F
F
F
F
F
F
F
F
F
F
F
"}
