"a" = (/obj/item/cardboard_cutout{desc = "At closer inspection, this is infact just a cardboard cutout with LEDs glued on."; icon = 'icons/mob/swarmer.dmi'; icon_state = "trap"; name = "swarmer trap"},/obj/item/grown/bananapeel/bluespace{alpha = 25},/turf/open/floor/plating/asteroid,/area/ruin/powered)
"b" = (/turf/template_noop,/area/template_noop)
"c" = (/obj/item/cardboard_cutout{desc = "At closer inspection, this is infact just a cardboard cutout with LEDs glued on."; icon = 'icons/mob/swarmer.dmi'; icon_state = "trap"; name = "swarmer trap"},/obj/item/grown/bananapeel/bluespace{alpha = 25},/turf/open/floor/mineral/plastitanium/red{initial_gas_mix = "o2=22;n2=82;TEMP=293.15"},/area/ruin/powered)
"g" = (/obj/item/cardboard_cutout{desc = "At closer inspection, this is infact just a cardboard cutout with LEDs glued on."; icon = 'icons/mob/swarmer.dmi'; icon_state = "swarmer"; name = "swarmer"},/turf/open/floor/mineral/plastitanium/red{initial_gas_mix = "o2=22;n2=82;TEMP=293.15"},/area/ruin/powered)
"p" = (/obj/item/cardboard_cutout{desc = "At closer inspection, this is infact just a cardboard cutout with LEDs glued on."; icon = 'icons/mob/swarmer.dmi'; icon_state = "barricade"; name = "swarmer barricade"},/turf/open/floor/mineral/plastitanium/red{initial_gas_mix = "o2=22;n2=82;TEMP=293.15"},/area/ruin/powered)
"E" = (/obj/item/cardboard_cutout{desc = "At closer inspection, this is infact just a cardboard cutout with LEDs glued on."; icon = 'icons/mob/swarmer.dmi'; icon_state = "swarmer_ranged"; name = "swarmer"},/turf/open/floor/mineral/plastitanium/red{initial_gas_mix = "o2=22;n2=82;TEMP=293.15"},/area/ruin/powered)
"G" = (/turf/open/floor/mineral/plastitanium/red{initial_gas_mix = "o2=22;n2=82;TEMP=293.15"},/area/ruin/powered)
"H" = (/obj/item/cardboard_cutout{desc = "At closer inspection, this is infact just a cardboard cutout with LEDs glued on."; icon = 'icons/mob/swarmer.dmi'; icon_state = "swarmer_console"; name = "swarmer beacon"},/turf/open/floor/mineral/plastitanium/red{initial_gas_mix = "o2=22;n2=82;TEMP=293.15"},/area/ruin/powered)
"L" = (/turf/closed/mineral,/area/ruin/powered)
"O" = (/obj/item/cardboard_cutout{desc = "At closer inspection, this is infact just a cardboard cutout with LEDs glued on."; icon = 'icons/mob/swarmer.dmi'; icon_state = "barricade"; name = "swarmer barricade"},/turf/open/floor/plating/asteroid,/area/ruin/powered)
"Q" = (/obj/item/cardboard_cutout{desc = "At closer inspection, this is infact just a cardboard cutout with LEDs glued on."; icon = 'icons/mob/swarmer.dmi'; icon_state = "swarmer_melee"; name = "swarmer"},/turf/open/floor/mineral/plastitanium/red{initial_gas_mix = "o2=22;n2=82;TEMP=293.15"},/area/ruin/powered)
"T" = (/obj/structure/shuttle/engine/propulsion{dir = 4},/turf/open/floor/plating/asteroid,/area/ruin/powered)
"W" = (/turf/closed/wall/mineral/plastitanium,/area/ruin/powered)
"Z" = (/turf/open/floor/plating/asteroid,/area/ruin/powered)

(1,1,1) = {"
bbbbbbbbbbbbbbbbbbbbbbbbbbbbbbbbbbbbbbbb
bbbbbbbbbbbbbbbbbbbbbbbbbbbbbbbbbbbbbbbb
bbbbbbbbbbbbbbbbbbbbbbbbbbbbbbbbbbbbbbbb
bbbbbbbbbbbbbbbbbbbbbbbbbbbbbbbbbbbbbbbb
bbbbbbbbbbbbbbbbbbbbbbbbbLLLLLLLLbbbbbbb
bbbbbbbbbbbbbbbbbbbLLLLLLLLLLLLLLbbbbbbb
bbbbbbbbbbbbbLLLLLLLLLLLLLLLLLLLLLbbbbbb
bbbbbbbbbbbbLLLLLLLLLLLLLLLLLLLLLLbbbbbb
bbbbbbbbbbbLLLLLLLLLLLLLLLLLLLLLLLLbbbbb
bbbbbbbbbbbLLLLLLLLLLLLLLLLLLLLLLLLbbbbb
bbbbbbbbbbLLLLLLLLLLLLLLLLLLLLLLLLLbbbbb
bbbbbbbbbbLLLLLLLLLLLLLLLLLLLLLLLLLbbbbb
bbbbbbbbbLLLLLLLLLLLLLLLLLLLLLLLLLLbbbbb
bbbbbbbbbLLLLLLLLLLLLLLLLLLLLLLLLLLbbbbb
bbbbbbbbLLLLLLLLLLLLLLLLLLLLLLLLLLLbbbbb
bbbbbbbbLLLLLLLLLLLLLLLLLLLLLLLLLLLLbbbb
bbbbbbbLLLLLLLLLLLLLLLLLLLLLLLLLLLLLbbbb
bbbbbbLLLLLLLLLLLLLLLLLLLLLLLLLLLLLLbbbb
bbbbbbLLLLLLLLLLLLLLLLLLLLLLLLLLLLLLbbbb
bbbbbbLLLLLLLLLLLLLLLLLLLLLLLLLLLLLLbbbb
bbbbbbLLLLLLLLLLLLLLLLLLLLLLLLLLLLLLbbbb
bbbbbbLLLLLLLLLLLLLLLLLLLLLLLLLLLLLLbbbb
bbbbbbLLLLLLLLLLLLLLLLLLLLLLLLLLLLLLLbbb
bbbbbbLLLLLLLLLLLLLLLLLLLLLLLLLLLLLLLbbb
bbbbbbLLLLLLLLLLLLLLLLLLLLLLLLLLLLLLLbbb
bbbbbbLLLLLLLLLLLLLLLLLLLLLLLLLLLLLLLbbb
bbbbbbLLLLLLLLLLLLLLLLLLLLLLLLLLLLLLLbbb
bbbbbbbLLLLLLLLLLLLLLLLLLLLLLLLLLLLLLbbb
bbbbbbbLLLLLLLLLLLLLWWgpaWWLLLLLLLLLLbbb
bbbbbbbLLLLLLLWOGWWZWGGGZZWTLLLLLLLLLbbb
bbbbbbbbLLLLLLZGGgcGQGcHGGWTLLLLLLLLbbbb
bbbbbbbbbLLLLLOEGGGGpGEGGGWTLLLLLLLLbbbb
bbbbbbbbbbLLLLWWpWWcWGGcgGWTLLLLLLLbbbbb
bbbbbbbbbbbbLLLLLLLLWWOZpWWLLLLLLLbbbbbb
bbbbbbbbbbbbbLLLLLLLLLLLLLLLLLLLLbbbbbbb
bbbbbbbbbbbbbbbbLLLLLLLLLLLLLLLbbbbbbbbb
bbbbbbbbbbbbbbbbbbbLLLLLLLLLLbbbbbbbbbbb
bbbbbbbbbbbbbbbbbbbbbbbbbbbbbbbbbbbbbbbb
bbbbbbbbbbbbbbbbbbbbbbbbbbbbbbbbbbbbbbbb
bbbbbbbbbbbbbbbbbbbbbbbbbbbbbbbbbbbbbbbb
"}
