"a" = (/turf/template_noop,/area/template_noop)
"b" = (/obj/structure/sign/warning/radiation/rad_area{pixel_y = -32},/turf/template_noop,/area/template_noop)
"c" = (/turf/closed/mineral,/area/ruin/powered)
"d" = (/turf/closed/wall/steel,/area/ruin/powered)
"e" = (/obj/structure/sign/warning/radiation/rad_area{pixel_x = -32},/turf/template_noop,/area/template_noop)
"f" = (/obj/structure/sign/warning/radiation/rad_area{pixel_x = 32},/turf/template_noop,/area/template_noop)
"g" = (/turf/open/floor/monotile/airless,/area/ruin/powered)
"h" = (/obj/effect/decal/nuclear_waste,/turf/open/floor/monotile/airless,/area/ruin/powered)
"i" = (/obj/structure/closet/radiation,/turf/open/floor/monotile/airless,/area/ruin/powered)
"j" = (/obj/machinery/vending/tool,/turf/open/floor/monotile/airless,/area/ruin/powered)
"k" = (/obj/machinery/vending/engivend,/turf/open/floor/monotile/airless,/area/ruin/powered)
"l" = (/obj/machinery/door/airlock/ship/engineering,/turf/open/floor/monotile/airless,/area/ruin/powered)
"m" = (/obj/machinery/light/broken,/obj/structure/closet/crate,/turf/open/floor/monotile/airless,/area/ruin/powered)
"n" = (/obj/structure/closet/crate,/turf/open/floor/monotile/airless,/area/ruin/powered)
"o" = (/turf/open/floor/plating/asteroid/airless,/area/ruin/powered)
"p" = (/obj/effect/decal/nuclear_waste,/turf/open/floor/plating/asteroid/airless,/area/ruin/powered)
"q" = (/obj/machinery/light/broken{dir = 4},/turf/open/floor/monotile/airless,/area/ruin/powered)
"r" = (/turf/open/floor/engine/airless,/area/ruin/powered)
"s" = (/obj/effect/decal/nuclear_waste,/turf/open/floor/engine/airless,/area/ruin/powered)
"t" = (/obj/machinery/smartfridge/drinks{desc = "Abandoned for ages. Could probably be used to store your beer."; icon = 'nsv13/goonstation/icons/reactor.dmi'; icon_state = "broken"; name = "Ruined stormdrive"; pixel_x = -16},/turf/open/floor/engine/airless,/area/ruin/powered)
"u" = (/obj/machinery/light/broken{dir = 4},/turf/open/floor/engine/airless,/area/ruin/powered)
"v" = (/turf/open/floor/plating/airless,/area/ruin/powered)
"w" = (/obj/machinery/light/broken{dir = 8},/turf/open/floor/monotile/airless,/area/ruin/powered)
"x" = (/obj/effect/spawner/structure/window/reinforced,/turf/open/floor/plating,/area/ruin/powered)
"y" = (/obj/machinery/light/broken{dir = 1},/turf/open/floor/monotile/airless,/area/ruin/powered)
"z" = (/obj/structure/frame,/turf/open/floor/monotile/airless,/area/ruin/powered)
"A" = (/obj/machinery/door/airlock/ship/external{name = "Nuclear lab"},/obj/effect/mapping_helpers/airlock/cyclelink_helper{dir = 4},/turf/open/floor/plating/airless,/area/ruin/powered)
"B" = (/obj/structure/sign/warning/vacuum/external{pixel_y = 32},/turf/open/floor/plating/airless,/area/ruin/powered)
"C" = (/obj/machinery/door/airlock/ship/external{name = "Nuclear lab"},/obj/effect/mapping_helpers/airlock/cyclelink_helper{dir = 8},/turf/open/floor/plating/airless,/area/ruin/powered)
"D" = (/obj/machinery/light/broken,/turf/open/floor/monotile/airless,/area/ruin/powered)
"E" = (/obj/structure/sign/warning/radiation/rad_area{pixel_y = 32},/turf/template_noop,/area/template_noop)

(1,1,1) = {"
aaaaaaaaaaaaaaaaaaaaaaaaaaaaaaaaaaaaaaaa
aaaaaaaaaaaaaaaaaaaaaaaaaaaaaaaaaaaaaaaa
aaaaaaaaaaaaaaaaaaaaaaaaaaaaaaaaaaaaaaaa
aaaaaaaaaaaaaaaaaaaaaaaaaaaaaaaaaaaaaaaa
aaaaaaaaaaaaaaaaaaaaaaaaaaaaaaaaaaaaaaaa
aaaaaaaaaaaaaaaaaaaaaaaaaaabaaaaaaaaaaaa
aaaaaaaaaaaaaabaaaaaaaaaaacdcaaaaaaaaaaa
aaaaaaaaaaaaccdcccaaaaaaacccccaaaaaaaaaa
aaaaaaaaaaacccccccccabacccccccccaaaaaaaa
aaaaaaaaaacccccccccccdcccccccccccaaaaaaa
aaaaaaaaccccccccccccccccccccccccccaaaaaa
aaaaaaaacccccccccccccccccccccccccccaaaaa
aaaaaaaaccccccccccccccccccccccccccdeaaaa
aaaaaaafdccccccccccccccccccccccccccaaaaa
aaaaaaaacdddddddddcccccccccccccccccaaaaa
aaaaaaaacdghhdijkdccccccccccccccccccaaaa
aaaaaacccdggglgggdccccccccccccccccccaaaa
aaaaaacccdghgdhmndccccccccccccccccccaaaa
aaaaaccccdhggdddddcoooocccccccccccccaaaa
aaaaaccccdgggdccccooopoccccccccccccdeaaa
aaaafdcccdghqdcccddoooddcoooccccccccaaaa
aaaaaccccdgggdccoorsrrroooooccccccccaaaa
aaaacccccdhggdcoporrrrrooooccccccccaaaaa
aaaccccccdhggdcooorrtrudoocccccccccaaaaa
aaaccccccdgggvoooprrrrrooocccccccccaaaaa
aaaccccccdwghvoooorrrsrdccccccccccaaaaaa
aaaaccddddgggdddxxddvdxddddddddcccaaaaaa
aaafdddidhghggghhhygggghghghgzdccccaaaaa
aaaaABCgggggghggghggghghgggggndccccaaaaa
aaafdddgghDghgghggghhgggDhhgghdcccdeaaaa
aaaaccdddddddddddddddddddddddddccccaaaaa
aaaaacccccccccccccccccccccccccccccaaaaaa
aaaaaacdcccccccccccccccccccccccccaaaaaaa
aaaaaaaEacccccccccccccccccccccccaaaaaaaa
aaaaaaaaaaccccccccccccccccccccccaaaaaaaa
aaaaaaaaaaacdccccccccccccccccdcaaaaaaaaa
aaaaaaaaaaaaEccccccccccccccccEaaaaaaaaaa
aaaaaaaaaaaaaaaccccdccccccccaaaaaaaaaaaa
aaaaaaaaaaaaaaaacccEccccdccaaaaaaaaaaaaa
aaaaaaaaaaaaaaaaaaaaaaaaEaaaaaaaaaaaaaaa
"}
