"a" = (/turf/template_noop,/area/template_noop)
"b" = (/turf/closed/wall/steel,/area/ruin/powered)
"c" = (/obj/item/storage/toolbox/syndicate,/obj/structure/rack,/turf/open/floor/plating,/area/ruin/powered)
"d" = (/obj/structure/window/reinforced{icon_state = "rwindow"; dir = 4},/turf/open/floor/plating,/area/ruin/powered)
"e" = (/obj/structure/table,/obj/structure/bedsheetbin,/turf/open/floor/plating,/area/ruin/powered)
"f" = (/obj/machinery/light/small{dir = 1},/turf/open/floor/plating,/area/ruin/powered)
"g" = (/obj/structure/sink{dir = 4; icon_state = "sink"; pixel_x = 12},/obj/structure/mirror{pixel_x = 30},/turf/open/floor/plating,/area/ruin/powered)
"h" = (/obj/structure/closet,/turf/open/floor/plating,/area/ruin/powered)
"i" = (/turf/open/floor/plating,/area/ruin/powered)
"j" = (/turf/closed/mineral,/area/ruin/powered)
"k" = (/obj/structure/toilet{icon_state = "toilet00"; dir = 8},/turf/open/floor/plating,/area/ruin/powered)
"l" = (/obj/structure/mineral_door/wood,/turf/open/floor/plating,/area/ruin/powered)
"m" = (/obj/structure/lattice,/turf/template_noop,/area/template_noop)
"n" = (/obj/machinery/computer/crew,/turf/open/floor/carpet/red,/area/ruin/powered)
"o" = (/obj/machinery/computer/security,/turf/open/floor/carpet/red,/area/ruin/powered)
"p" = (/obj/structure/table/wood,/obj/structure/extinguisher_cabinet{pixel_y = 32},/obj/item/paper_bin,/obj/item/pen/fourcolor,/obj/item/clothing/glasses/regular,/turf/open/floor/carpet/red,/area/ruin/powered)
"q" = (/obj/machinery/light{dir = 1},/obj/item/twohanded/required/kirbyplants,/turf/open/floor/carpet/red,/area/ruin/powered)
"r" = (/turf/open/floor/carpet/red,/area/ruin/powered)
"s" = (/obj/structure/table/wood,/obj/item/flashlight/lamp,/turf/open/floor/carpet/red,/area/ruin/powered)
"t" = (/obj/structure/lattice/catwalk,/turf/template_noop,/area/template_noop)
"u" = (/obj/machinery/door/airlock/ship/external/glass{name = "Abandoned outpost"; req_one_access_txt = "150"},/obj/effect/mapping_helpers/airlock/cyclelink_helper{icon_state = "airlock_cyclelink_helper"; dir = 4},/obj/structure/fans/tiny,/turf/open/floor/plating,/area/ruin/powered)
"v" = (/obj/machinery/door/airlock/ship/external/glass{name = "Abandoned outpost"; req_one_access_txt = "150"},/obj/effect/mapping_helpers/airlock/cyclelink_helper{icon_state = "airlock_cyclelink_helper"; dir = 8},/turf/open/floor/plating,/area/ruin/powered)
"w" = (/obj/structure/chair/office{dir = 1},/turf/open/floor/carpet/red,/area/ruin/powered)
"x" = (/obj/item/malf_upgrade{pixel_x = 6; pixel_y = -4},/obj/structure/bed,/obj/item/bedsheet/syndie,/turf/open/floor/carpet/red,/area/ruin/powered)
"y" = (/obj/structure/closet/secure_closet/medical2,/turf/open/floor/carpet/red,/area/ruin/powered)
"z" = (/obj/machinery/light_switch/east,/turf/open/floor/carpet/red,/area/ruin/powered)
"A" = (/obj/structure/table,/obj/item/hemostat,/obj/item/retractor,/turf/open/floor/monotile,/area/ruin/powered)
"B" = (/obj/structure/table/optable,/obj/item/surgical_drapes,/turf/open/floor/monotile,/area/ruin/powered)
"C" = (/obj/structure/table,/obj/item/scalpel{pixel_y = 12},/obj/item/circular_saw,/turf/open/floor/monotile,/area/ruin/powered)

(1,1,1) = {"
aaaaaaaaaaaaaaaaaaaaaaaaaaaaaaaaaaaaaaaa
aaaaaaaaaaaaaaaaaaaaaaaaaaaajjjaaaaaaaaa
aaaaaaaaaaaaaaaaaaaaaaaaaaajjjjjaaaaaaaa
aaaaaaaaaaaaaaaaaaaaaaaaaajjjjjjjaaaaaaa
aaaaajjjjaaaaaaaaaaaaaaajjjjjjjjjjjaaaaa
aaaajjjjjjjaaaaaaaaaaaajjjjjjjjjjjjjaaaa
aaajjjjjjjjjaaaaaaaaaajjjjjjjjjjjjjjjaaa
aaajjjjjjjjjaaaaaaaajjjjjjjjjjjjjjjjjaaa
aaaajjjjjjjaaaaaaajjjjjjjjjjjjjjjjjjjjaa
aaaaajjjjjaaaaaaajjjjjjjjjjjjjjjjjjjjjaa
aaaaaaajjaaaaaaajjjjjjjjjjjjjjjjjjjjjaaa
aaaaaaaaaaaaaaajjjjjjjjjjjjjjjjjjjjjaaaa
aaaaaaaaaaaaaajjjjjjjjjjjjjjjjjjjjjaaaaa
aaaaaaaaaaaaajjjjjjjjjjjjjjjjjjjjjaaaaaa
aaaaaaaaaaaajjjjjjjjjjjjjjjjjjjjjaaaaaaa
aaaaaaaaaajjjjjjjjjjjjjjjjjjjjjjaaaaaaaa
aaaaaaaaajjjjjjjjjjjjjjjjjjjjjaaaaaaaaaa
aaaaaaaaajbbbbbbbjjjjjjjjjjjjaaaaaaaaaaa
aaaaaaaajjbcdefgbjjjjjjjjjjaaaaaaaaaaaaa
aaaaaaaajjbhiiikbjjjjjjjjjaaaaaaaaaaaaaa
aaaaaaajjbbbbblbbbjjjjjjjaaaaaaaaaaaaaaa
aaaaaambbbnopqrrsbbjjjjjaaaaaaaaaaaaaaaa
aaaaaatuivrwrrrrrxbjjjjaaaaaaaaaaaaaaaaa
aaaaaambbbyrrrrrzbbjjjaaaaaaaaaaaaaaaaaa
aaaaaaajjbbbABCbbbjjjaaaaaaaaaaaaaaaaaaa
aaaaaaaajjjbbbbbjjjjaaaaaaaaaaaaaaaaaaaa
aaaaaaaaajjjjjjjjjjaaaaaaaajjjaaaaaaaaaa
aaaaaaaaaajjjjjjjjaaaaaaaajjjjjaaaaaaaaa
aaaaaaaaaaajjjjjaaaaaaaaajjjjjjjaaaaaaaa
aaaaaaaaaaaaaaaaaaaaaaaaajjjjjjjaaaaaaaa
aaaaaaaaaaaaaaaaaaaaaaaajjjjjjjjjaaaaaaa
aaaaaaaaaaaaaaaaaaaaaaaajjjjjjjjjjaaaaaa
aaaaaaaaaaaaaaaaaaaaaaaajjjjjjjjjjaaaaaa
aaaaaaaaaaaaaaaaaaaaaaaajjjjjjjjjjjaaaaa
aaaaaaaaaaaaaaaaaaaaaaaaajjjjjjjjjaaaaaa
aaaaaaaaaaaaaaaaaaaaaaaaaajjjjjjjaaaaaaa
aaaaaaaaaaaaaaaaaaaaaaaaaaajjjjjaaaaaaaa
aaaaaaaaaaaaaaaaaaaaaaaaaaaaaaaaaaaaaaaa
aaaaaaaaaaaaaaaaaaaaaaaaaaaaaaaaaaaaaaaa
aaaaaaaaaaaaaaaaaaaaaaaaaaaaaaaaaaaaaaaa
"}
