//MAP CONVERTED BY dmm2tgm.py THIS HEADER COMMENT PREVENTS RECONVERSION, DO NOT REMOVE
"a" = (
/turf/template_noop,
/area/template_noop)
"f" = (
/turf/closed/mineral/random/low_chance,
/area/ruin/powered)
"g" = (
/obj/effect/landmark/dropship_entry,
/turf/template_noop,
/area/template_noop)
"i" = (
/turf/closed/mineral,
/area/ruin/powered)
"l" = (
/obj/item/stack/sheet/bone,
/obj/item/stack/sheet/bone,
/obj/item/stack/sheet/bone,
/obj/item/stack/sheet/bone,
/turf/open/floor/plating/asteroid{
	initial_gas_mix = "plasma=10000;TEMP=293.15"
	},
/area/ruin/powered)
"p" = (
/turf/closed/mineral/random,
/area/ruin/powered)
"r" = (
/obj/item/stack/sheet/bone,
/obj/item/stack/sheet/bone,
/turf/open/floor/plating/asteroid{
	initial_gas_mix = "plasma=10000;TEMP=293.15"
	},
/area/ruin/powered)
"s" = (
/turf/open/floor/plating/asteroid{
	initial_gas_mix = "plasma=10000;TEMP=293.15"
	},
/area/ruin/powered)
"x" = (
/obj/item/stack/sheet/bone,
/turf/closed/mineral,
/area/ruin/powered)
"y" = (
/obj/item/stack/sheet/sinew,
/obj/item/stack/sheet/sinew,
/obj/item/stack/sheet/sinew,
/obj/item/stack/sheet/sinew,
/turf/open/floor/plating/asteroid{
	initial_gas_mix = "plasma=10000;TEMP=293.15"
	},
/area/ruin/powered)
"A" = (
/obj/item/organ/tongue/bone,
/turf/open/floor/plating/asteroid{
	initial_gas_mix = "plasma=10000;TEMP=293.15"
	},
/area/ruin/powered)
"H" = (
/obj/item/stack/sheet/sinew,
/obj/item/stack/sheet/sinew,
/obj/item/stack/sheet/sinew,
/obj/item/stack/sheet/sinew,
/obj/item/stack/sheet/sinew,
/turf/open/floor/plating/asteroid{
	initial_gas_mix = "plasma=10000;TEMP=293.15"
	},
/area/ruin/powered)
"M" = (
/obj/item/stack/sheet/sinew,
/obj/item/stack/sheet/sinew,
/turf/open/floor/plating/asteroid{
	initial_gas_mix = "plasma=10000;TEMP=293.15"
	},
/area/ruin/powered)
"O" = (
/obj/item/stack/sheet/sinew,
/obj/item/stack/sheet/sinew,
/obj/item/stack/sheet/sinew,
/turf/open/floor/plating/asteroid{
	initial_gas_mix = "plasma=10000;TEMP=293.15"
	},
/area/ruin/powered)
"T" = (
/turf/closed/mineral/random/high_chance,
/area/ruin/powered)
"V" = (
/obj/item/stack/sheet/bone,
/turf/open/floor/plating/asteroid{
	initial_gas_mix = "plasma=10000;TEMP=293.15"
	},
/area/ruin/powered)
"W" = (
/obj/item/stack/sheet/bone,
/obj/item/stack/sheet/bone,
/obj/item/stack/sheet/bone,
/turf/open/floor/plating/asteroid{
	initial_gas_mix = "plasma=10000;TEMP=293.15"
	},
/area/ruin/powered)

(1,1,1) = {"
a
a
a
a
a
a
a
a
a
a
a
a
a
a
a
a
a
a
a
a
a
a
a
a
a
a
a
a
a
a
a
a
a
a
a
a
a
a
a
a
"}
(2,1,1) = {"
a
a
a
a
a
a
a
a
a
a
a
a
a
a
a
a
a
a
a
a
a
a
a
a
a
a
a
a
a
a
a
a
a
a
a
a
a
a
a
a
"}
(3,1,1) = {"
a
a
a
a
a
a
a
a
a
a
a
a
a
a
a
a
a
a
a
a
a
a
a
a
a
a
a
a
a
a
a
a
a
a
a
a
a
a
a
a
"}
(4,1,1) = {"
a
a
a
a
a
a
a
a
a
a
a
a
a
a
a
a
a
a
a
i
i
i
a
i
i
i
i
a
a
a
a
a
a
a
a
a
a
a
a
a
"}
(5,1,1) = {"
a
a
a
a
a
a
a
a
a
a
a
a
a
a
a
a
a
a
i
i
i
i
i
f
i
i
i
i
a
a
a
a
a
a
a
a
a
a
a
a
"}
(6,1,1) = {"
a
a
a
a
a
a
a
a
a
a
a
a
a
a
a
a
i
i
i
i
f
i
i
f
i
i
i
i
i
a
a
a
a
a
a
a
a
a
a
a
"}
(7,1,1) = {"
a
a
a
a
a
a
a
a
a
a
a
a
i
i
i
i
i
i
i
i
i
i
i
i
i
i
r
s
i
a
a
a
a
a
a
a
a
a
a
a
"}
(8,1,1) = {"
a
a
a
a
a
a
a
a
a
a
a
i
i
i
i
i
s
i
i
i
i
i
i
i
i
M
r
i
i
a
a
a
a
a
a
a
a
a
a
a
"}
(9,1,1) = {"
a
a
a
a
a
a
a
a
i
i
i
i
i
i
i
i
W
r
i
i
i
i
V
r
V
W
i
i
i
i
a
a
a
a
a
a
a
a
a
a
"}
(10,1,1) = {"
a
a
a
a
a
a
a
i
i
i
i
i
i
i
i
i
i
s
i
i
y
r
W
i
i
i
i
i
i
i
i
a
a
a
a
a
a
a
a
a
"}
(11,1,1) = {"
a
a
a
a
a
a
i
i
i
i
i
i
i
i
i
i
i
s
i
i
i
i
i
i
i
i
i
V
s
i
i
i
a
a
a
a
a
a
a
a
"}
(12,1,1) = {"
a
a
a
a
a
a
i
i
i
i
i
i
i
i
i
i
i
r
W
i
i
i
i
i
i
i
W
O
i
i
p
i
a
a
a
a
a
a
a
a
"}
(13,1,1) = {"
a
a
a
a
a
i
i
i
i
i
i
i
i
H
r
s
i
i
r
i
i
i
i
i
V
r
M
i
i
x
p
i
a
a
a
a
a
a
a
a
"}
(14,1,1) = {"
a
a
a
a
a
i
i
p
p
i
i
r
r
V
i
i
i
i
W
i
i
i
W
r
i
p
i
i
i
i
i
i
i
a
a
a
a
a
a
a
"}
(15,1,1) = {"
a
a
a
a
a
i
i
i
p
i
V
i
i
i
i
i
i
i
s
s
i
r
i
i
p
p
i
i
i
s
i
i
i
a
a
a
a
a
a
a
"}
(16,1,1) = {"
a
a
a
a
a
i
i
i
i
i
i
i
i
i
i
i
i
i
i
W
i
i
i
i
i
i
i
r
s
i
i
i
i
i
a
a
a
a
a
a
"}
(17,1,1) = {"
a
a
a
a
a
i
i
i
i
i
i
i
i
i
i
i
i
i
i
W
i
i
s
l
V
V
r
y
i
i
i
i
i
i
a
a
a
a
a
a
"}
(18,1,1) = {"
a
a
a
a
a
i
i
i
i
i
i
i
i
i
i
i
i
i
i
r
r
V
s
i
i
i
i
i
i
i
i
i
i
i
a
a
a
a
a
a
"}
(19,1,1) = {"
a
a
a
a
a
a
i
i
i
i
i
i
i
s
r
r
s
s
V
s
r
i
i
i
i
i
i
r
M
r
i
i
i
i
a
a
a
a
a
a
"}
(20,1,1) = {"
a
a
a
a
a
a
i
i
i
i
i
M
r
r
r
y
O
i
i
i
r
i
i
i
i
r
V
V
i
i
i
i
i
i
a
a
a
a
a
a
"}
(21,1,1) = {"
a
a
a
a
a
a
i
i
i
s
V
s
i
i
i
i
i
i
i
i
s
i
i
i
r
i
i
i
i
i
r
i
i
i
a
a
a
a
a
a
"}
(22,1,1) = {"
a
a
a
a
a
i
i
i
i
i
i
i
i
i
i
i
i
i
i
i
i
r
i
i
i
i
i
i
i
i
r
i
i
a
a
a
a
a
a
a
"}
(23,1,1) = {"
a
a
a
a
a
i
i
i
i
i
i
i
i
i
i
i
i
i
i
i
i
r
i
i
f
i
i
i
i
V
i
i
a
a
a
a
a
a
a
a
"}
(24,1,1) = {"
a
a
a
a
a
i
i
i
i
i
i
i
i
i
i
i
i
i
s
V
i
s
i
i
i
i
i
i
i
O
i
i
a
a
a
a
a
a
a
a
"}
(25,1,1) = {"
a
a
a
a
a
i
i
i
i
i
i
i
i
i
i
M
V
r
s
i
i
i
s
i
i
i
f
i
i
r
i
i
a
a
a
a
a
a
a
a
"}
(26,1,1) = {"
a
a
a
a
a
i
i
i
i
i
i
i
r
V
O
i
i
i
i
i
i
i
r
i
i
i
i
i
i
V
i
a
a
a
a
a
a
a
a
a
"}
(27,1,1) = {"
a
a
a
a
a
i
i
i
i
i
i
i
i
i
i
i
i
i
i
i
i
i
r
i
i
i
i
f
i
i
i
a
a
a
a
a
a
a
a
a
"}
(28,1,1) = {"
a
a
a
a
a
a
i
i
i
i
i
i
i
i
i
i
i
i
i
i
i
i
W
i
i
i
i
f
i
i
i
a
a
a
a
a
a
a
a
a
"}
(29,1,1) = {"
a
a
a
a
a
a
a
i
i
i
i
i
i
i
i
i
i
i
i
r
r
i
i
r
i
i
i
i
i
i
a
a
a
a
a
a
a
a
a
a
"}
(30,1,1) = {"
a
a
a
a
a
a
a
i
i
i
i
T
T
i
i
i
i
V
y
i
i
i
i
W
i
i
i
i
i
a
a
a
a
a
a
a
a
a
a
a
"}
(31,1,1) = {"
a
a
a
a
a
a
a
i
i
i
i
i
T
T
i
i
i
i
i
i
i
i
i
s
i
i
i
i
i
a
a
a
a
a
a
a
a
a
a
a
"}
(32,1,1) = {"
a
a
a
a
a
a
a
i
i
i
i
i
i
i
i
i
i
i
i
i
i
i
i
r
i
i
i
i
a
a
a
a
a
a
a
a
a
a
a
a
"}
(33,1,1) = {"
a
a
a
a
a
a
a
i
i
i
i
i
i
i
i
i
i
i
i
i
i
i
i
r
i
i
i
a
a
a
a
a
a
a
g
a
a
a
a
a
"}
(34,1,1) = {"
a
a
a
a
a
a
a
a
i
i
i
i
i
i
i
i
i
i
i
i
i
i
i
A
i
i
a
a
a
a
a
a
a
a
a
a
a
a
a
a
"}
(35,1,1) = {"
a
a
a
a
a
a
a
a
a
i
i
i
i
i
i
i
i
i
i
i
i
i
i
i
i
a
a
a
a
a
a
a
a
a
a
a
a
a
a
a
"}
(36,1,1) = {"
a
a
a
a
a
a
a
a
a
a
i
i
i
i
i
i
i
i
i
a
i
i
i
i
a
a
a
a
a
a
a
a
a
a
a
a
a
a
a
a
"}
(37,1,1) = {"
a
a
a
a
a
a
a
a
a
a
a
a
a
a
a
a
a
a
a
a
a
a
a
a
a
a
a
a
a
a
a
a
a
a
a
a
a
a
a
a
"}
(38,1,1) = {"
a
a
a
a
a
a
a
a
a
a
a
a
a
a
a
a
a
a
a
a
a
a
a
a
a
a
a
a
a
a
a
a
a
a
a
a
a
a
a
a
"}
(39,1,1) = {"
a
a
a
a
a
a
a
a
a
a
a
a
a
a
a
a
a
a
a
a
a
a
a
a
a
a
a
a
a
a
a
a
a
a
a
a
a
a
a
a
"}
(40,1,1) = {"
a
a
a
a
a
a
a
a
a
a
a
a
a
a
a
a
a
a
a
a
a
a
a
a
a
a
a
a
a
a
a
a
a
a
a
a
a
a
a
a
"}
