//MAP CONVERTED BY dmm2tgm.py THIS HEADER COMMENT PREVENTS RECONVERSION, DO NOT REMOVE
"a" = (
/turf/template_noop,
/area/template_noop)
"b" = (
/turf/closed/wall/steel,
/area/ruin/powered)
"c" = (
/obj/item/storage/toolbox/syndicate,
/obj/structure/rack,
/turf/open/floor/plating,
/area/ruin/powered)
"d" = (
/obj/structure/window/reinforced{
	icon_state = "rwindow";
	dir = 4
	},
/turf/open/floor/plating,
/area/ruin/powered)
"e" = (
/obj/structure/table,
/obj/structure/bedsheetbin,
/turf/open/floor/plating,
/area/ruin/powered)
"f" = (
/obj/machinery/light/small{
	dir = 1
	},
/turf/open/floor/plating,
/area/ruin/powered)
"g" = (
/obj/structure/sink{
	dir = 4;
	icon_state = "sink";
	pixel_x = 12
	},
/obj/structure/mirror{
	pixel_x = 30
	},
/turf/open/floor/plating,
/area/ruin/powered)
"h" = (
/obj/structure/closet,
/turf/open/floor/plating,
/area/ruin/powered)
"i" = (
/turf/open/floor/plating,
/area/ruin/powered)
"j" = (
/turf/closed/mineral,
/area/ruin/powered)
"k" = (
/obj/structure/toilet{
	icon_state = "toilet00";
	dir = 8
	},
/turf/open/floor/plating,
/area/ruin/powered)
"l" = (
/obj/structure/mineral_door/wood,
/turf/open/floor/plating,
/area/ruin/powered)
"m" = (
/obj/structure/lattice,
/turf/template_noop,
/area/template_noop)
"n" = (
/obj/machinery/computer/crew,
/turf/open/floor/carpet/red,
/area/ruin/powered)
"o" = (
/obj/machinery/computer/security,
/turf/open/floor/carpet/red,
/area/ruin/powered)
"p" = (
/obj/structure/table/wood,
/obj/structure/extinguisher_cabinet{
	pixel_y = 32
	},
/obj/item/paper_bin,
/obj/item/pen/fourcolor,
/obj/item/clothing/glasses/regular,
/turf/open/floor/carpet/red,
/area/ruin/powered)
"q" = (
/obj/machinery/light{
	dir = 1
	},
/obj/item/twohanded/required/kirbyplants,
/turf/open/floor/carpet/red,
/area/ruin/powered)
"r" = (
/turf/open/floor/carpet/red,
/area/ruin/powered)
"s" = (
/obj/structure/table/wood,
/obj/item/flashlight/lamp,
/turf/open/floor/carpet/red,
/area/ruin/powered)
"t" = (
/obj/structure/lattice/catwalk,
/turf/template_noop,
/area/template_noop)
"u" = (
/obj/machinery/door/airlock/ship/external/glass{
	name = "Abandoned outpost";
	req_one_access_txt = "150"
	},
/obj/effect/mapping_helpers/airlock/cyclelink_helper{
	icon_state = "airlock_cyclelink_helper";
	dir = 4
	},
/obj/structure/fans/tiny,
/turf/open/floor/plating,
/area/ruin/powered)
"v" = (
/obj/machinery/door/airlock/ship/external/glass{
	name = "Abandoned outpost";
	req_one_access_txt = "150"
	},
/obj/effect/mapping_helpers/airlock/cyclelink_helper{
	icon_state = "airlock_cyclelink_helper";
	dir = 8
	},
/turf/open/floor/plating,
/area/ruin/powered)
"w" = (
/obj/structure/chair/office{
	dir = 1
	},
/turf/open/floor/carpet/red,
/area/ruin/powered)
"x" = (
/obj/item/malf_upgrade{
	pixel_x = 6;
	pixel_y = -4
	},
/obj/structure/bed,
/obj/item/bedsheet/syndie,
/turf/open/floor/carpet/red,
/area/ruin/powered)
"y" = (
/obj/structure/closet/secure_closet/medical2,
/turf/open/floor/carpet/red,
/area/ruin/powered)
"z" = (
/obj/machinery/light_switch/east,
/turf/open/floor/carpet/red,
/area/ruin/powered)
"A" = (
/obj/structure/table,
/obj/item/hemostat,
/obj/item/retractor,
/turf/open/floor/monotile,
/area/ruin/powered)
"B" = (
/obj/structure/table/optable,
/obj/item/surgical_drapes,
/turf/open/floor/monotile,
/area/ruin/powered)
"C" = (
/obj/structure/table,
/obj/item/scalpel{
	pixel_y = 12
	},
/obj/item/circular_saw,
/turf/open/floor/monotile,
/area/ruin/powered)

(1,1,1) = {"
a
a
a
a
a
a
a
a
a
a
a
a
a
a
a
a
a
a
a
a
a
a
a
a
a
a
a
a
a
a
a
a
a
a
a
a
a
a
a
a
"}
(2,1,1) = {"
a
a
a
a
a
a
a
a
a
a
a
a
a
a
a
a
a
a
a
a
a
a
a
a
a
a
a
a
a
a
a
a
a
a
a
a
a
a
a
a
"}
(3,1,1) = {"
a
a
a
a
a
a
a
a
a
a
a
a
a
a
a
a
a
a
a
a
a
a
a
a
a
a
a
a
a
a
a
a
a
a
a
a
a
a
a
a
"}
(4,1,1) = {"
a
a
a
a
a
a
j
j
a
a
a
a
a
a
a
a
a
a
a
a
a
a
a
a
a
a
a
a
a
a
a
a
a
a
a
a
a
a
a
a
"}
(5,1,1) = {"
a
a
a
a
a
j
j
j
j
a
a
a
a
a
a
a
a
a
a
a
a
a
a
a
a
a
a
a
a
a
a
a
a
a
a
a
a
a
a
a
"}
(6,1,1) = {"
a
a
a
a
j
j
j
j
j
j
a
a
a
a
a
a
a
a
a
a
a
a
a
a
a
a
a
a
a
a
a
a
a
a
a
a
a
a
a
a
"}
(7,1,1) = {"
a
a
a
a
j
j
j
j
j
j
a
a
a
a
a
a
a
a
a
a
a
m
t
m
a
a
a
a
a
a
a
a
a
a
a
a
a
a
a
a
"}
(8,1,1) = {"
a
a
a
a
j
j
j
j
j
j
j
a
a
a
a
a
a
a
a
a
j
b
u
b
j
a
a
a
a
a
a
a
a
a
a
a
a
a
a
a
"}
(9,1,1) = {"
a
a
a
a
j
j
j
j
j
j
j
a
a
a
a
a
a
a
j
j
j
b
i
b
j
j
a
a
a
a
a
a
a
a
a
a
a
a
a
a
"}
(10,1,1) = {"
a
a
a
a
a
j
j
j
j
j
a
a
a
a
a
a
j
j
j
j
b
b
v
b
b
j
j
a
a
a
a
a
a
a
a
a
a
a
a
a
"}
(11,1,1) = {"
a
a
a
a
a
j
j
j
j
a
a
a
a
a
a
j
j
b
b
b
b
n
r
y
b
j
j
j
a
a
a
a
a
a
a
a
a
a
a
a
"}
(12,1,1) = {"
a
a
a
a
a
a
j
j
a
a
a
a
a
a
a
j
j
b
c
h
b
o
w
r
b
b
j
j
j
a
a
a
a
a
a
a
a
a
a
a
"}
(13,1,1) = {"
a
a
a
a
a
a
a
a
a
a
a
a
a
a
j
j
j
b
d
i
b
p
r
r
A
b
j
j
j
a
a
a
a
a
a
a
a
a
a
a
"}
(14,1,1) = {"
a
a
a
a
a
a
a
a
a
a
a
a
a
j
j
j
j
b
e
i
b
q
r
r
B
b
j
j
j
a
a
a
a
a
a
a
a
a
a
a
"}
(15,1,1) = {"
a
a
a
a
a
a
a
a
a
a
a
a
j
j
j
j
j
b
f
i
l
r
r
r
C
b
j
j
j
a
a
a
a
a
a
a
a
a
a
a
"}
(16,1,1) = {"
a
a
a
a
a
a
a
a
a
a
a
j
j
j
j
j
j
b
g
k
b
r
r
r
b
b
j
j
j
a
a
a
a
a
a
a
a
a
a
a
"}
(17,1,1) = {"
a
a
a
a
a
a
a
a
a
a
j
j
j
j
j
j
j
b
b
b
b
s
r
z
b
j
j
j
a
a
a
a
a
a
a
a
a
a
a
a
"}
(18,1,1) = {"
a
a
a
a
a
a
a
a
a
j
j
j
j
j
j
j
j
j
j
j
b
b
x
b
b
j
j
j
a
a
a
a
a
a
a
a
a
a
a
a
"}
(19,1,1) = {"
a
a
a
a
a
a
a
a
j
j
j
j
j
j
j
j
j
j
j
j
j
b
b
b
j
j
j
a
a
a
a
a
a
a
a
a
a
a
a
a
"}
(20,1,1) = {"
a
a
a
a
a
a
a
a
j
j
j
j
j
j
j
j
j
j
j
j
j
j
j
j
j
j
a
a
a
a
a
a
a
a
a
a
a
a
a
a
"}
(21,1,1) = {"
a
a
a
a
a
a
a
j
j
j
j
j
j
j
j
j
j
j
j
j
j
j
j
j
j
a
a
a
a
a
a
a
a
a
a
a
a
a
a
a
"}
(22,1,1) = {"
a
a
a
a
a
a
a
j
j
j
j
j
j
j
j
j
j
j
j
j
j
j
j
j
a
a
a
a
a
a
a
a
a
a
a
a
a
a
a
a
"}
(23,1,1) = {"
a
a
a
a
a
a
j
j
j
j
j
j
j
j
j
j
j
j
j
j
j
j
j
a
a
a
a
a
a
a
a
a
a
a
a
a
a
a
a
a
"}
(24,1,1) = {"
a
a
a
a
a
j
j
j
j
j
j
j
j
j
j
j
j
j
j
j
j
j
a
a
a
a
a
a
a
a
a
a
a
a
a
a
a
a
a
a
"}
(25,1,1) = {"
a
a
a
a
j
j
j
j
j
j
j
j
j
j
j
j
j
j
j
j
j
a
a
a
a
a
a
a
a
a
j
j
j
j
a
a
a
a
a
a
"}
(26,1,1) = {"
a
a
a
a
j
j
j
j
j
j
j
j
j
j
j
j
j
j
j
j
a
a
a
a
a
a
a
a
j
j
j
j
j
j
j
a
a
a
a
a
"}
(27,1,1) = {"
a
a
a
j
j
j
j
j
j
j
j
j
j
j
j
j
j
j
j
a
a
a
a
a
a
a
a
j
j
j
j
j
j
j
j
j
a
a
a
a
"}
(28,1,1) = {"
a
a
j
j
j
j
j
j
j
j
j
j
j
j
j
j
j
j
a
a
a
a
a
a
a
a
j
j
j
j
j
j
j
j
j
j
j
a
a
a
"}
(29,1,1) = {"
a
j
j
j
j
j
j
j
j
j
j
j
j
j
j
j
j
j
a
a
a
a
a
a
a
a
j
j
j
j
j
j
j
j
j
j
j
a
a
a
"}
(30,1,1) = {"
a
j
j
j
j
j
j
j
j
j
j
j
j
j
j
j
j
a
a
a
a
a
a
a
a
a
j
j
j
j
j
j
j
j
j
j
j
a
a
a
"}
(31,1,1) = {"
a
j
j
j
j
j
j
j
j
j
j
j
j
j
j
j
a
a
a
a
a
a
a
a
a
a
a
j
j
j
j
j
j
j
j
j
j
a
a
a
"}
(32,1,1) = {"
a
a
j
j
j
j
j
j
j
j
j
j
j
j
j
j
a
a
a
a
a
a
a
a
a
a
a
a
j
j
j
j
j
j
j
j
j
a
a
a
"}
(33,1,1) = {"
a
a
a
j
j
j
j
j
j
j
j
j
j
j
j
a
a
a
a
a
a
a
a
a
a
a
a
a
a
a
j
j
j
j
j
j
a
a
a
a
"}
(34,1,1) = {"
a
a
a
a
j
j
j
j
j
j
j
j
j
j
a
a
a
a
a
a
a
a
a
a
a
a
a
a
a
a
a
j
j
j
j
a
a
a
a
a
"}
(35,1,1) = {"
a
a
a
a
j
j
j
j
j
j
j
j
j
a
a
a
a
a
a
a
a
a
a
a
a
a
a
a
a
a
a
a
a
j
a
a
a
a
a
a
"}
(36,1,1) = {"
a
a
a
a
a
j
j
j
j
j
j
j
a
a
a
a
a
a
a
a
a
a
a
a
a
a
a
a
a
a
a
a
a
a
a
a
a
a
a
a
"}
(37,1,1) = {"
a
a
a
a
a
a
j
j
j
j
j
a
a
a
a
a
a
a
a
a
a
a
a
a
a
a
a
a
a
a
a
a
a
a
a
a
a
a
a
a
"}
(38,1,1) = {"
a
a
a
a
a
a
a
a
j
j
a
a
a
a
a
a
a
a
a
a
a
a
a
a
a
a
a
a
a
a
a
a
a
a
a
a
a
a
a
a
"}
(39,1,1) = {"
a
a
a
a
a
a
a
a
a
a
a
a
a
a
a
a
a
a
a
a
a
a
a
a
a
a
a
a
a
a
a
a
a
a
a
a
a
a
a
a
"}
(40,1,1) = {"
a
a
a
a
a
a
a
a
a
a
a
a
a
a
a
a
a
a
a
a
a
a
a
a
a
a
a
a
a
a
a
a
a
a
a
a
a
a
a
a
"}
