//MAP CONVERTED BY dmm2tgm.py THIS HEADER COMMENT PREVENTS RECONVERSION, DO NOT REMOVE
"a" = (
/turf/template_noop,
/area/template_noop)
"b" = (
/turf/closed/mineral,
/area/ruin/powered)
"c" = (
/turf/closed/wall/ship,
/area/ruin/powered)
"d" = (
/obj/structure/girder,
/turf/open/floor/plating/airless,
/area/ruin/powered)
"e" = (
/turf/open/floor/plating/airless,
/area/ruin/powered)
"f" = (
/obj/structure/closet/crate,
/obj/effect/spawner/lootdrop/maintenance/three,
/turf/open/floor/plating/airless,
/area/ruin/powered)
"g" = (
/obj/machinery/light/small{
	dir = 1
	},
/turf/open/floor/plating/airless,
/area/ruin/powered)
"h" = (
/obj/structure/closet/crate,
/obj/item/stack/spacecash/c10,
/turf/open/floor/plating/airless,
/area/ruin/powered)
"i" = (
/obj/structure/closet/crate/secure/engineering,
/obj/item/organ/cyberimp/brain/anti_stun,
/obj/item/organ/cyberimp/arm/toolset,
/obj/item/organ/cyberimp/eyes/hud/medical,
/turf/open/floor/plating/airless,
/area/ruin/powered)
"j" = (
/obj/structure/shuttle/engine/heater{
	dir = 4
	},
/obj/structure/window/reinforced{
	dir = 8
	},
/turf/open/floor/plating/airless,
/area/ruin/powered)
"k" = (
/obj/structure/shuttle/engine/propulsion/burst{
	dir = 4
	},
/turf/open/floor/plating/airless,
/area/ruin/powered)
"l" = (
/obj/structure/closet/crate/wooden,
/obj/effect/spawner/lootdrop/maintenance/three,
/obj/effect/spawner/lootdrop/maintenance/three,
/turf/open/floor/plating/airless,
/area/ruin/powered)
"m" = (
/obj/structure/grille/broken,
/turf/open/floor/plating/airless,
/area/ruin/powered)
"n" = (
/obj/structure/table_frame,
/turf/open/floor/plating/airless,
/area/ruin/powered)
"o" = (
/obj/structure/chair/comfy/shuttle{
	dir = 8
	},
/turf/open/floor/plating/airless,
/area/ruin/powered)
"p" = (
/obj/machinery/light/small{
	dir = 4
	},
/turf/open/floor/plating/airless,
/area/ruin/powered)
"q" = (
/obj/machinery/button/door{
	id = "asteroid_stuck";
	name = "Cargo Blast Door Control";
	pixel_y = -24
	},
/obj/structure/closet/crate,
/obj/effect/spawner/lootdrop/maintenance/three,
/turf/open/floor/plating/airless,
/area/ruin/powered)
"r" = (
/obj/structure/closet/crate,
/obj/item/stack/spacecash/c10,
/obj/effect/spawner/lootdrop/maintenance/three,
/turf/open/floor/plating/airless,
/area/ruin/powered)
"s" = (
/obj/structure/closet/crate,
/obj/item/stack/spacecash/c200,
/obj/item/stack/spacecash/c200,
/turf/open/floor/plating/airless,
/area/ruin/powered)
"t" = (
/obj/machinery/light/small,
/obj/structure/closet/crate,
/obj/effect/spawner/lootdrop/maintenance/three,
/turf/open/floor/plating/airless,
/area/ruin/powered)
"u" = (
/obj/machinery/door/poddoor{
	id = "asteroid_stuck";
	name = "Cargo Blast Door"
	},
/turf/open/floor/plating/airless,
/area/ruin/powered)
"v" = (
/turf/open/floor/plating/asteroid/airless,
/area/ruin/powered)

(1,1,1) = {"
a
a
a
a
a
a
a
a
a
a
a
a
a
a
a
a
a
a
a
a
a
a
a
a
a
a
a
a
a
a
a
a
a
a
a
a
a
a
a
a
"}
(2,1,1) = {"
a
a
a
a
a
a
a
a
a
a
a
a
a
a
b
b
a
a
a
a
a
a
a
a
a
a
a
a
a
a
a
a
a
a
a
a
a
a
a
a
"}
(3,1,1) = {"
a
a
a
a
b
a
a
a
a
a
a
a
a
a
b
b
b
a
a
a
a
a
a
a
a
a
a
a
a
a
a
a
a
a
a
a
a
a
a
a
"}
(4,1,1) = {"
a
a
a
b
b
b
a
a
a
a
a
a
a
b
b
b
b
b
a
a
a
a
a
a
a
a
a
a
a
a
a
a
a
a
a
a
a
a
a
a
"}
(5,1,1) = {"
a
a
b
b
b
b
b
b
a
a
a
a
b
b
b
b
b
b
a
a
a
a
a
a
a
a
a
b
b
b
a
a
a
a
a
a
a
a
a
a
"}
(6,1,1) = {"
a
b
b
b
b
b
b
b
b
a
a
a
b
b
b
b
b
b
a
a
a
a
a
a
a
b
b
b
b
b
b
b
a
a
a
a
a
a
a
a
"}
(7,1,1) = {"
a
b
b
b
b
b
b
b
b
b
a
a
b
b
b
b
b
b
a
a
a
a
a
b
b
b
b
b
b
b
b
b
b
a
a
a
a
a
a
a
"}
(8,1,1) = {"
a
a
b
b
b
b
b
b
b
b
a
a
a
b
b
b
b
a
a
a
a
b
b
b
b
b
b
b
b
b
b
b
b
b
a
a
a
a
a
a
"}
(9,1,1) = {"
a
a
a
b
b
b
b
b
b
a
a
a
a
a
b
b
a
a
a
b
b
b
b
b
b
b
b
b
b
b
b
b
b
b
b
a
a
a
a
a
"}
(10,1,1) = {"
a
a
a
a
b
b
b
b
a
a
a
a
a
a
a
a
a
a
b
b
b
b
b
b
b
b
b
b
b
b
b
b
b
b
b
b
a
a
a
a
"}
(11,1,1) = {"
a
a
a
a
a
b
b
a
a
a
a
a
a
a
a
a
b
b
b
b
b
b
b
b
b
b
b
b
b
b
b
b
b
b
b
b
a
a
a
a
"}
(12,1,1) = {"
a
a
a
a
a
a
a
a
a
a
a
a
a
a
a
b
b
b
b
b
b
b
b
b
b
b
b
b
b
b
b
b
b
b
b
b
a
a
a
a
"}
(13,1,1) = {"
a
a
a
a
a
a
a
a
a
a
a
a
a
a
a
b
b
b
b
b
b
b
b
b
b
b
b
b
b
b
b
b
b
b
b
b
b
a
a
a
"}
(14,1,1) = {"
a
a
a
a
a
a
a
a
a
a
a
a
a
a
b
b
b
b
b
b
b
b
b
b
b
b
b
b
b
b
b
b
b
b
b
b
b
a
a
a
"}
(15,1,1) = {"
a
a
a
a
a
a
a
a
a
a
a
a
a
a
b
b
b
b
b
b
b
b
b
b
b
b
b
b
b
b
b
b
b
b
b
b
b
a
a
a
"}
(16,1,1) = {"
a
a
a
a
a
a
a
a
a
a
a
a
a
b
b
b
b
b
b
b
b
b
b
b
b
b
b
b
b
b
b
b
b
b
b
b
b
a
a
a
"}
(17,1,1) = {"
a
a
a
a
a
a
a
a
a
a
a
a
b
b
b
b
b
b
b
b
b
b
b
b
b
b
b
b
b
b
b
b
b
b
b
b
b
a
a
a
"}
(18,1,1) = {"
a
a
a
a
a
a
a
a
a
a
a
a
b
b
b
b
b
b
b
b
b
b
b
b
b
b
b
b
b
b
b
b
b
b
b
b
b
a
a
a
"}
(19,1,1) = {"
a
a
a
a
a
a
a
a
a
a
a
a
b
b
b
b
b
b
b
b
b
b
b
b
b
b
b
b
b
b
b
b
b
b
b
b
b
a
a
a
"}
(20,1,1) = {"
a
a
a
a
a
a
a
a
a
a
a
a
a
b
b
b
b
b
b
b
b
b
b
b
b
b
b
b
b
b
b
b
b
b
b
b
b
a
a
a
"}
(21,1,1) = {"
a
a
a
a
a
a
a
a
a
a
a
a
a
a
b
b
b
b
b
b
b
b
b
b
b
b
b
b
b
b
b
b
b
b
b
b
b
a
a
a
"}
(22,1,1) = {"
a
a
a
a
a
a
a
a
a
a
a
a
a
a
b
b
b
b
b
b
b
b
b
b
m
c
b
b
b
b
b
b
b
b
b
b
b
a
a
a
"}
(23,1,1) = {"
a
a
a
a
a
a
a
a
a
a
a
a
a
b
b
b
b
b
b
b
b
b
b
b
n
c
b
b
b
b
b
b
b
b
b
b
a
a
a
a
"}
(24,1,1) = {"
a
a
a
a
a
a
a
a
a
a
a
a
a
b
b
b
b
b
b
b
b
c
e
e
o
e
c
b
b
b
b
b
b
b
b
a
a
a
a
a
"}
(25,1,1) = {"
a
a
a
a
a
a
a
a
a
a
a
a
a
b
b
b
b
b
b
b
b
c
e
e
p
e
c
b
b
b
b
b
b
b
b
a
a
a
a
a
"}
(26,1,1) = {"
a
a
a
a
a
a
a
a
a
a
a
a
a
a
b
b
b
b
b
b
b
c
c
e
c
c
c
b
b
b
b
b
b
b
b
a
a
a
a
a
"}
(27,1,1) = {"
a
a
a
a
a
a
a
a
a
a
a
a
a
a
a
b
b
b
b
b
b
c
f
e
e
q
c
b
b
b
b
b
b
b
a
a
a
a
a
a
"}
(28,1,1) = {"
a
a
a
a
a
b
a
a
a
a
a
a
a
a
a
b
b
b
b
b
b
d
e
e
e
e
u
b
b
b
b
b
b
a
a
a
a
a
a
a
"}
(29,1,1) = {"
a
a
a
a
b
b
b
a
b
a
a
a
a
a
a
a
b
b
b
b
b
c
g
e
f
r
u
b
b
b
b
b
a
a
a
a
a
a
a
a
"}
(30,1,1) = {"
a
a
a
b
b
b
b
b
b
b
a
a
a
a
a
a
a
b
b
b
b
c
f
f
f
f
u
v
b
b
b
b
a
a
a
a
a
a
a
a
"}
(31,1,1) = {"
a
a
b
b
b
b
b
b
b
b
b
a
a
a
a
a
a
a
b
b
b
c
f
f
h
s
c
v
v
b
b
a
a
a
a
b
b
a
a
a
"}
(32,1,1) = {"
a
b
b
b
b
b
b
b
b
b
b
b
a
a
a
a
a
a
a
b
b
c
h
f
f
t
c
v
v
b
a
a
a
a
b
b
b
b
a
a
"}
(33,1,1) = {"
a
b
b
b
b
b
b
b
b
b
b
b
a
a
a
a
a
a
a
a
b
c
i
l
f
f
c
a
a
a
a
a
a
b
b
b
b
b
a
a
"}
(34,1,1) = {"
a
b
b
b
b
b
b
b
b
b
b
b
a
a
a
a
a
a
a
a
a
c
j
j
j
j
c
a
a
a
a
a
b
b
b
b
b
b
b
a
"}
(35,1,1) = {"
a
a
b
b
b
b
b
b
b
b
b
a
a
a
a
a
a
a
a
a
a
a
k
k
k
k
a
a
a
a
a
a
b
b
b
b
b
b
b
a
"}
(36,1,1) = {"
a
a
a
b
b
b
b
b
b
a
a
a
a
a
a
a
a
a
a
a
a
a
a
a
a
a
a
a
a
a
a
a
a
b
b
b
b
b
a
a
"}
(37,1,1) = {"
a
a
a
a
b
b
b
b
a
a
a
a
a
a
a
a
a
a
a
a
a
a
a
a
a
a
a
a
a
a
a
a
a
a
b
b
a
a
a
a
"}
(38,1,1) = {"
a
a
a
a
a
b
b
a
a
a
a
a
a
a
a
a
a
a
a
a
a
a
a
a
a
a
a
a
a
a
a
a
a
a
a
a
a
a
a
a
"}
(39,1,1) = {"
a
a
a
a
a
a
a
a
a
a
a
a
a
a
a
a
a
a
a
a
a
a
a
a
a
a
a
a
a
a
a
a
a
a
a
a
a
a
a
a
"}
(40,1,1) = {"
a
a
a
a
a
a
a
a
a
a
a
a
a
a
a
a
a
a
a
a
a
a
a
a
a
a
a
a
a
a
a
a
a
a
a
a
a
a
a
a
"}
