//MAP CONVERTED BY dmm2tgm.py THIS HEADER COMMENT PREVENTS RECONVERSION, DO NOT REMOVE
"h" = (
/turf/open/space/basic,
/area/space)
"o" = (
/turf/closed/mineral,
/area/ruin/powered)
"r" = (
/turf/closed/wall/steel,
/area/ruin/powered)
"B" = (
/obj/structure/filingcabinet,
/obj/item/folder/syndicate/mining,
/turf/open/floor/plating,
/area/ruin/powered)
"M" = (
/obj/machinery/door/airlock/vault/ship{
	name = "Vault";
	req_one_access_txt = "53"
	},
/turf/open/floor/plating,
/area/ruin/powered)
"N" = (
/obj/item/grenade/smokebomb,
/obj/structure/closet/crate,
/obj/item/clothing/glasses/night,
/turf/open/floor/plating,
/area/ruin/powered)
"R" = (
/obj/structure/safe,
/obj/item/reagent_containers/food/drinks/bottle/vodka/badminka,
/obj/item/stack/ore/bluespace_crystal,
/obj/item/stack/ore/bluespace_crystal,
/obj/item/stack/ore/bluespace_crystal,
/obj/item/stack/ore/bluespace_crystal,
/obj/item/stack/ore/diamond,
/obj/item/stack/ore/diamond,
/obj/item/stack/ore/diamond,
/obj/item/stack/ore/diamond,
/obj/item/stack/ore/diamond,
/obj/item/stack/ore/bananium,
/obj/item/stack/ore/bananium,
/obj/item/stack/ore/bananium,
/obj/item/stack/ore/bananium,
/obj/item/stack/ore/bananium,
/obj/item/stack/ore/plasma,
/obj/item/stack/ore/plasma,
/obj/item/stack/ore/plasma,
/obj/item/stack/ore/plasma,
/obj/item/stack/ore/plasma,
/obj/item/stack/ore/uranium,
/obj/item/stack/ore/uranium,
/obj/item/stack/ore/uranium,
/obj/item/stack/ore/uranium,
/obj/item/stack/ore/uranium,
/turf/open/floor/plating,
/area/ruin/powered)
"T" = (
/turf/open/floor/plating,
/area/ruin/powered)

(1,1,1) = {"
h
h
h
h
h
h
h
h
h
h
h
h
h
h
h
h
h
h
h
h
h
h
h
h
h
h
h
h
h
h
h
h
h
h
h
h
h
h
h
h
"}
(2,1,1) = {"
h
h
h
h
h
h
h
h
h
h
h
h
h
h
h
h
h
h
h
h
h
h
h
h
h
h
h
h
h
h
h
h
h
h
h
h
h
h
h
h
"}
(3,1,1) = {"
h
h
h
h
h
h
h
h
h
h
h
h
h
h
h
h
h
h
h
h
h
h
h
h
h
h
h
h
h
h
h
h
h
h
h
h
h
h
h
h
"}
(4,1,1) = {"
h
h
h
h
h
h
h
h
h
h
h
h
h
h
h
h
h
h
h
h
h
h
h
h
h
h
h
h
h
h
h
h
h
h
h
h
h
h
h
h
"}
(5,1,1) = {"
h
h
h
h
h
h
h
h
h
h
h
h
h
h
h
h
h
h
h
h
o
o
o
o
h
h
h
h
h
h
h
h
h
h
h
h
h
h
h
h
"}
(6,1,1) = {"
h
h
h
o
o
o
h
h
h
h
h
h
h
h
h
o
h
o
o
o
o
o
o
o
o
o
h
h
h
h
h
h
h
h
h
h
h
h
h
h
"}
(7,1,1) = {"
h
h
o
o
o
o
o
h
h
h
h
h
h
h
o
o
o
o
o
o
r
r
M
r
r
o
o
h
h
h
h
h
h
h
h
h
h
h
h
h
"}
(8,1,1) = {"
h
h
o
o
o
o
o
o
h
h
h
h
h
o
o
o
o
o
o
o
r
R
T
T
r
o
o
h
h
h
h
h
h
h
h
o
o
o
h
h
"}
(9,1,1) = {"
h
h
o
o
o
o
o
o
h
h
h
h
o
o
o
o
o
o
o
o
r
B
T
N
r
o
o
h
h
h
h
h
h
o
o
o
o
o
h
h
"}
(10,1,1) = {"
h
h
o
o
o
o
o
o
h
h
h
h
o
o
o
o
o
o
o
o
r
r
r
r
r
o
o
o
h
h
h
h
o
o
o
o
o
o
o
h
"}
(11,1,1) = {"
h
h
o
o
o
o
o
o
h
h
h
o
o
o
o
o
o
o
o
o
o
o
o
o
o
o
o
o
o
h
h
h
o
o
o
o
o
o
o
h
"}
(12,1,1) = {"
h
h
o
o
o
o
o
h
h
h
h
o
o
o
o
o
o
o
o
o
o
o
o
o
o
o
o
o
o
h
h
h
h
o
o
o
o
o
o
h
"}
(13,1,1) = {"
h
h
h
o
o
h
h
h
h
h
h
o
o
o
o
o
o
o
o
o
o
o
o
o
o
o
o
o
o
h
h
h
h
h
o
o
o
o
h
h
"}
(14,1,1) = {"
h
h
h
h
h
h
h
h
h
h
o
o
o
o
o
o
o
o
o
o
o
o
o
o
o
o
o
o
h
h
h
h
h
h
h
o
h
h
h
h
"}
(15,1,1) = {"
h
h
h
h
h
h
h
h
h
h
o
o
o
o
o
o
o
o
o
o
o
o
o
o
o
o
o
o
o
h
h
h
h
h
h
h
h
h
h
h
"}
(16,1,1) = {"
h
h
h
h
h
h
h
h
h
o
o
o
o
o
o
o
o
o
o
o
o
o
o
o
o
o
o
o
o
o
h
h
h
h
h
h
h
h
h
h
"}
(17,1,1) = {"
h
h
h
h
h
h
h
h
h
o
o
o
o
o
o
o
o
o
o
o
o
o
o
o
o
o
o
o
o
o
h
h
h
h
h
h
h
h
h
h
"}
(18,1,1) = {"
h
h
h
h
h
h
h
h
h
o
o
o
o
o
o
o
o
o
o
o
o
o
o
o
o
o
o
o
o
o
o
h
h
h
h
h
h
h
h
h
"}
(19,1,1) = {"
h
h
h
h
h
h
h
h
h
o
o
o
o
o
o
o
o
o
o
o
o
o
o
o
o
o
o
o
o
o
o
h
h
h
h
h
h
h
h
h
"}
(20,1,1) = {"
h
h
h
h
h
h
h
h
h
o
o
o
o
o
o
o
o
o
o
o
o
o
o
o
o
o
o
o
o
o
o
o
h
h
h
h
h
h
h
h
"}
(21,1,1) = {"
h
h
h
h
h
h
h
h
h
o
o
o
o
o
o
o
o
o
o
o
o
o
o
o
o
o
o
o
o
o
o
o
h
h
h
h
h
h
h
h
"}
(22,1,1) = {"
h
h
h
h
h
h
h
h
h
o
o
o
o
o
o
o
o
o
o
o
o
o
o
o
o
o
o
o
o
o
o
o
o
h
h
h
h
h
h
h
"}
(23,1,1) = {"
h
h
h
h
h
h
h
h
h
o
o
o
o
o
o
o
o
o
o
o
o
o
o
o
o
o
o
o
o
o
o
o
o
o
h
h
h
h
h
h
"}
(24,1,1) = {"
h
h
h
h
h
h
h
h
h
o
o
o
o
o
o
o
o
o
o
o
o
o
o
o
o
o
o
o
o
o
o
o
o
o
h
h
h
h
h
h
"}
(25,1,1) = {"
h
h
h
h
h
h
h
h
h
o
o
o
o
o
o
o
o
o
o
o
o
o
o
o
o
o
o
o
o
o
o
o
o
o
h
h
h
h
h
h
"}
(26,1,1) = {"
h
h
h
h
h
h
h
h
h
o
o
o
o
o
o
o
o
o
o
o
o
o
o
o
o
o
o
o
o
o
o
o
o
o
h
h
h
h
h
h
"}
(27,1,1) = {"
h
h
h
h
h
h
h
h
h
o
o
o
o
o
o
o
o
o
o
o
o
o
o
o
o
o
o
o
o
o
o
o
o
o
h
h
h
h
h
h
"}
(28,1,1) = {"
h
h
h
h
h
h
h
h
h
o
o
o
o
o
o
o
o
o
o
o
o
o
o
o
o
o
o
o
o
o
o
o
o
h
h
h
h
h
h
h
"}
(29,1,1) = {"
h
h
h
h
h
h
h
h
h
o
o
o
o
o
o
o
o
o
o
o
o
o
o
o
o
o
o
o
o
o
o
o
o
h
h
h
h
h
h
h
"}
(30,1,1) = {"
h
h
h
h
h
h
h
h
h
h
o
o
o
o
o
o
o
o
o
o
o
o
o
o
o
o
o
o
o
o
o
o
h
h
h
h
h
h
h
h
"}
(31,1,1) = {"
h
h
h
h
h
h
h
h
h
h
h
h
o
o
o
o
o
o
o
o
o
o
o
o
o
o
o
h
o
o
o
h
h
h
h
h
h
h
h
h
"}
(32,1,1) = {"
h
h
h
h
h
h
h
h
h
h
h
h
h
o
o
o
o
o
o
o
o
o
o
h
o
o
h
h
h
h
h
h
h
h
h
h
h
h
h
h
"}
(33,1,1) = {"
h
h
o
o
o
o
h
h
h
h
h
h
h
h
h
h
h
h
h
h
h
h
h
h
h
h
h
h
h
h
h
h
h
h
h
h
h
h
h
h
"}
(34,1,1) = {"
h
o
o
o
o
o
o
h
h
h
h
h
h
h
h
h
h
h
h
h
h
h
h
h
h
h
h
h
h
h
h
h
h
h
h
h
h
h
h
h
"}
(35,1,1) = {"
o
o
o
o
o
o
o
o
h
h
h
h
h
h
h
h
h
h
h
h
h
h
h
h
h
h
h
h
h
h
h
h
h
h
h
h
h
h
h
h
"}
(36,1,1) = {"
o
o
o
o
o
o
o
o
o
h
h
h
h
h
h
h
h
h
h
h
h
h
h
h
h
h
h
h
h
h
h
h
h
h
h
h
h
h
h
h
"}
(37,1,1) = {"
o
o
o
o
o
o
o
o
o
h
h
h
h
h
h
h
h
h
h
h
h
h
h
h
h
h
h
h
h
h
h
h
h
h
h
h
h
h
h
h
"}
(38,1,1) = {"
o
o
o
o
o
o
o
o
h
h
h
h
h
h
h
h
h
h
h
h
h
h
h
h
h
h
h
h
h
h
h
h
h
h
h
h
h
h
h
h
"}
(39,1,1) = {"
h
o
o
o
o
o
h
h
h
h
h
h
h
h
h
h
h
h
h
h
h
h
h
h
h
h
h
h
h
h
h
h
h
h
h
h
h
h
h
h
"}
(40,1,1) = {"
h
h
h
h
h
h
h
h
h
h
h
h
h
h
h
h
h
h
h
h
h
h
h
h
h
h
h
h
h
h
h
h
h
h
h
h
h
h
h
h
"}
