//MAP CONVERTED BY dmm2tgm.py THIS HEADER COMMENT PREVENTS RECONVERSION, DO NOT REMOVE
"a" = (
/obj/structure/mineral_door/wood,
/turf/open/floor/carpet/ship/beige_carpet{
	color = "#CC8899";
	name = "nanoweave carpet (puce)"
	},
/area/ruin/powered)
"j" = (
/turf/open/floor/plating/asteroid,
/area/ruin/powered)
"q" = (
/turf/template_noop,
/area/template_noop)
"u" = (
/turf/closed/mineral,
/area/ruin/powered)
"I" = (
/turf/closed/wall/mineral/wood,
/area/ruin/powered)
"L" = (
/turf/open/floor/carpet/ship/beige_carpet{
	color = "#CC8899";
	name = "nanoweave carpet (puce)"
	},
/area/ruin/powered)
"S" = (
/obj/structure/table/wood/fancy/royalblack,
/turf/open/floor/carpet/ship/beige_carpet{
	color = "#CC8899";
	name = "nanoweave carpet (puce)"
	},
/area/ruin/powered)
"U" = (
/obj/item/hilbertshotel,
/obj/structure/table/wood/fancy/royalblack,
/turf/open/floor/carpet/ship/beige_carpet{
	color = "#CC8899";
	name = "nanoweave carpet (puce)"
	},
/area/ruin/powered)
"X" = (
/obj/structure/statue/uranium/nuke,
/turf/open/floor/carpet/ship/beige_carpet{
	color = "#CC8899";
	name = "nanoweave carpet (puce)"
	},
/area/ruin/powered)
"Z" = (
/obj/structure/statue/diamond/captain,
/turf/open/floor/carpet/ship/beige_carpet{
	color = "#CC8899";
	name = "nanoweave carpet (puce)"
	},
/area/ruin/powered)

(1,1,1) = {"
q
q
q
q
q
q
q
q
q
q
q
q
q
q
q
q
q
q
q
q
q
q
q
q
q
q
q
q
q
q
q
q
q
q
q
q
q
q
q
q
"}
(2,1,1) = {"
q
q
q
q
q
q
q
q
q
q
q
q
q
q
q
q
q
q
q
q
q
q
q
q
q
q
q
q
q
q
q
q
q
q
q
q
q
q
q
q
"}
(3,1,1) = {"
q
q
q
q
q
q
q
q
u
u
u
q
q
q
q
q
q
q
q
q
q
q
q
q
q
q
q
q
q
q
q
q
q
q
q
q
q
q
q
q
"}
(4,1,1) = {"
q
q
q
q
q
q
u
u
u
u
u
u
u
q
q
q
q
q
q
q
q
q
q
q
q
q
q
q
q
q
q
q
q
q
q
q
q
q
q
q
"}
(5,1,1) = {"
q
q
q
q
u
u
u
u
u
u
u
u
u
u
q
q
q
q
q
q
q
q
q
q
q
q
q
q
q
q
q
q
q
q
q
q
q
q
q
q
"}
(6,1,1) = {"
q
q
q
q
u
u
u
u
u
u
u
u
u
u
u
q
q
q
q
q
q
q
q
q
q
q
q
q
q
q
q
q
q
q
q
q
q
q
q
q
"}
(7,1,1) = {"
q
q
q
u
u
u
u
u
u
u
u
u
u
u
u
q
q
q
q
q
q
q
q
q
q
q
q
q
q
q
q
q
q
q
q
q
q
q
q
q
"}
(8,1,1) = {"
q
q
q
u
u
u
u
u
u
u
u
u
u
u
u
u
q
q
q
q
q
q
q
q
q
q
q
q
q
q
q
q
q
q
q
q
q
q
q
q
"}
(9,1,1) = {"
q
q
q
u
u
u
u
u
u
u
u
u
u
u
u
q
q
q
q
q
q
q
q
q
q
q
q
q
q
q
q
q
q
q
q
q
q
q
q
q
"}
(10,1,1) = {"
q
q
q
u
u
u
u
u
u
u
u
u
q
q
q
q
q
q
q
q
q
q
q
q
q
q
q
q
q
q
q
q
q
q
q
q
q
q
q
q
"}
(11,1,1) = {"
q
q
q
u
u
u
u
u
u
u
q
q
q
q
q
q
q
q
q
q
q
q
q
q
q
q
q
q
q
q
q
q
q
q
q
q
q
q
q
q
"}
(12,1,1) = {"
q
q
q
u
u
u
u
u
u
q
q
q
q
q
q
q
q
q
q
q
q
q
q
q
q
q
q
q
q
q
q
q
q
q
q
q
q
q
q
q
"}
(13,1,1) = {"
q
q
q
q
u
u
u
q
q
q
q
q
q
q
q
q
q
q
q
q
q
q
q
q
u
u
u
q
q
q
q
q
q
q
q
q
q
q
q
q
"}
(14,1,1) = {"
q
q
q
q
q
q
q
q
q
q
q
q
q
q
q
u
u
u
u
u
u
u
u
u
u
u
u
u
q
q
q
q
q
q
q
q
q
q
q
q
"}
(15,1,1) = {"
q
q
q
q
q
q
q
q
q
q
q
u
u
u
u
u
u
u
u
u
u
u
u
u
u
u
u
u
u
q
q
q
q
q
q
q
q
q
q
q
"}
(16,1,1) = {"
q
q
q
q
q
q
q
q
q
q
u
u
u
u
u
u
u
u
u
u
u
u
u
u
u
u
u
u
u
u
q
q
q
q
q
q
q
q
q
q
"}
(17,1,1) = {"
q
q
q
q
q
q
q
q
u
u
u
u
u
u
u
u
u
u
u
u
u
u
u
u
u
u
u
u
u
u
q
q
q
q
q
q
q
q
q
q
"}
(18,1,1) = {"
q
q
q
q
q
q
q
q
u
u
u
u
u
u
u
u
u
u
u
u
u
u
u
u
u
u
u
u
u
u
u
q
q
q
q
q
q
q
q
q
"}
(19,1,1) = {"
q
q
q
q
q
q
q
u
u
u
u
u
u
u
u
u
u
u
u
u
u
u
u
u
u
u
u
u
u
u
u
q
q
q
q
q
q
q
q
q
"}
(20,1,1) = {"
q
q
q
q
q
q
u
u
u
u
u
u
u
u
u
u
u
u
u
u
u
u
u
u
u
u
u
u
u
u
u
u
q
q
q
q
q
q
q
q
"}
(21,1,1) = {"
q
q
q
q
q
q
u
u
u
u
u
u
u
u
u
u
u
u
u
u
u
u
u
u
u
u
u
u
u
u
u
u
q
q
q
q
q
q
q
q
"}
(22,1,1) = {"
q
q
q
q
q
u
I
I
I
I
I
I
I
I
I
u
u
u
u
u
u
u
u
u
u
u
u
u
u
u
u
u
q
q
q
q
q
q
q
q
"}
(23,1,1) = {"
q
q
q
q
q
u
I
X
L
L
L
L
L
L
I
j
u
u
u
u
u
u
u
u
u
u
u
u
u
u
u
q
q
q
q
q
q
q
q
q
"}
(24,1,1) = {"
q
q
q
q
q
u
I
U
L
L
L
L
L
L
a
j
u
u
u
u
u
u
u
u
u
u
u
u
u
q
q
q
q
q
q
q
q
q
q
q
"}
(25,1,1) = {"
q
q
q
q
q
u
I
S
L
L
L
L
L
L
a
j
u
u
u
u
u
u
u
u
u
u
u
u
q
q
q
q
q
q
q
q
q
q
q
q
"}
(26,1,1) = {"
q
q
q
q
q
u
I
Z
L
L
L
L
L
L
I
j
u
u
u
u
u
u
u
u
u
u
u
q
q
q
q
q
q
q
q
q
q
q
q
q
"}
(27,1,1) = {"
q
q
q
q
q
u
I
I
I
I
I
I
I
I
I
u
u
u
u
u
u
u
u
u
u
u
q
q
q
q
q
q
q
q
q
q
q
q
q
q
"}
(28,1,1) = {"
q
q
q
q
q
q
u
u
u
u
u
u
u
u
u
u
u
u
u
u
u
u
u
u
u
q
q
q
q
q
q
q
q
q
q
q
q
q
q
q
"}
(29,1,1) = {"
q
q
q
q
q
q
u
u
u
u
u
u
u
u
u
u
u
u
u
u
u
u
u
u
q
q
q
q
q
q
q
q
q
q
q
q
q
q
q
q
"}
(30,1,1) = {"
q
q
q
q
q
q
u
u
u
u
u
u
u
u
u
u
u
u
u
u
u
u
u
u
q
q
q
q
q
q
q
q
q
q
q
q
q
q
q
q
"}
(31,1,1) = {"
q
q
q
q
q
q
u
u
u
u
u
u
u
u
u
u
u
u
u
u
u
u
q
q
q
q
q
q
q
q
q
q
q
q
q
q
q
q
q
q
"}
(32,1,1) = {"
q
q
q
q
q
q
q
u
u
u
u
u
u
u
u
u
u
u
u
u
u
u
q
q
q
q
q
q
q
q
q
q
q
q
q
q
q
q
q
q
"}
(33,1,1) = {"
q
q
q
q
q
q
q
u
u
u
u
u
u
u
u
u
u
u
u
u
u
q
q
q
q
q
q
q
q
q
q
q
q
q
q
q
q
q
q
q
"}
(34,1,1) = {"
q
q
q
q
q
q
q
q
u
u
u
u
u
u
u
u
u
u
u
q
q
q
q
q
q
q
q
q
q
q
q
q
q
q
q
q
q
q
q
q
"}
(35,1,1) = {"
q
q
q
q
q
q
q
q
q
q
q
q
q
q
q
q
q
q
q
q
q
q
q
q
q
q
q
q
q
q
q
q
q
q
q
q
q
q
q
q
"}
(36,1,1) = {"
q
q
q
q
q
q
q
q
q
q
q
q
q
q
q
q
q
q
q
q
q
q
q
q
q
q
q
q
q
q
q
q
q
q
q
q
q
q
q
q
"}
(37,1,1) = {"
q
q
q
q
q
q
q
q
q
q
q
q
q
q
q
q
q
q
q
q
q
q
q
q
q
q
q
q
q
q
q
q
q
q
q
q
q
q
q
q
"}
(38,1,1) = {"
q
q
q
q
q
q
q
q
q
q
q
q
q
q
q
q
q
q
q
q
q
q
q
q
q
q
q
q
q
q
q
q
q
q
q
q
q
q
q
q
"}
(39,1,1) = {"
q
q
q
q
q
q
q
q
q
q
q
q
q
q
q
q
q
q
q
q
q
q
q
q
q
q
q
q
q
q
q
q
q
q
q
q
q
q
q
q
"}
(40,1,1) = {"
q
q
q
q
q
q
q
q
q
q
q
q
q
q
q
q
q
q
q
q
q
q
q
q
q
q
q
q
q
q
q
q
q
q
q
q
q
q
q
q
"}
