//MAP CONVERTED BY dmm2tgm.py THIS HEADER COMMENT PREVENTS RECONVERSION, DO NOT REMOVE
"a" = (
/turf/template_noop,
/area/template_noop)
"b" = (
/turf/closed/mineral,
/area/ruin/powered)
"c" = (
/turf/open/floor/plating/asteroid/airless,
/area/ruin/powered)
"d" = (
/obj/structure/dead_ratvar,
/turf/open/floor/plating/asteroid/airless,
/area/ruin/powered)
"e" = (
/obj/item/stack/tile/brass,
/obj/item/stack/tile/brass,
/obj/item/stack/tile/brass,
/turf/open/floor/plating/asteroid/airless,
/area/ruin/powered)
"g" = (
/obj/item/toy/cog,
/turf/open/floor/plating/asteroid/airless,
/area/ruin/powered)
"o" = (
/turf/closed/mineral/random,
/area/ruin/powered)
"B" = (
/obj/effect/mob_spawn/human/corpse/charredskeleton,
/turf/open/floor/plating/asteroid/airless,
/area/ruin/powered)
"D" = (
/obj/item/toy/cog,
/turf/closed/mineral,
/area/ruin/powered)
"I" = (
/obj/effect/landmark/dropship_entry,
/turf/template_noop,
/area/template_noop)

(1,1,1) = {"
a
a
a
a
a
a
a
a
a
a
a
a
a
a
a
a
a
a
a
a
a
a
a
a
a
a
a
a
a
a
a
a
a
a
a
a
a
a
a
a
"}
(2,1,1) = {"
a
a
a
a
a
a
a
a
a
a
a
a
a
a
a
a
a
a
a
a
a
a
a
a
a
a
a
a
a
a
a
a
a
a
a
a
a
a
a
a
"}
(3,1,1) = {"
a
a
a
a
a
a
a
a
a
a
a
a
a
a
a
a
a
a
a
a
a
a
a
a
a
a
a
a
a
a
a
a
a
a
a
a
a
a
a
a
"}
(4,1,1) = {"
a
a
a
a
a
a
a
a
a
a
a
a
a
a
a
a
a
a
a
a
a
a
a
b
b
b
b
a
a
a
a
a
a
a
a
a
a
a
a
a
"}
(5,1,1) = {"
a
a
a
a
a
a
a
a
a
a
a
a
a
a
a
a
a
a
a
a
a
a
b
b
b
b
b
b
b
a
a
a
a
a
I
a
a
a
a
a
"}
(6,1,1) = {"
a
a
a
a
a
a
a
a
a
b
b
b
b
b
a
a
a
b
b
b
b
a
D
b
b
b
b
b
b
b
b
a
a
a
a
a
a
a
a
a
"}
(7,1,1) = {"
a
a
a
a
a
a
a
a
b
b
b
b
o
o
o
o
b
b
b
b
b
b
b
o
b
o
o
b
b
b
b
b
a
a
a
a
a
a
a
a
"}
(8,1,1) = {"
a
a
a
a
a
a
a
b
b
b
b
o
o
o
o
b
b
b
b
b
o
o
b
o
b
o
b
o
o
o
o
o
b
a
a
a
a
a
a
a
"}
(9,1,1) = {"
a
a
a
a
a
a
a
b
b
b
o
o
o
b
o
b
o
b
b
o
b
o
o
b
o
b
o
o
o
o
b
b
o
a
a
a
a
a
a
a
"}
(10,1,1) = {"
a
a
a
a
a
a
a
b
b
b
o
o
b
b
o
b
b
o
b
b
o
o
b
o
o
o
o
o
o
o
b
b
o
b
a
a
a
a
a
a
"}
(11,1,1) = {"
a
a
a
a
a
a
b
b
b
b
o
o
b
b
o
o
o
b
o
b
o
o
b
o
o
o
o
o
o
o
b
o
b
b
b
a
a
a
a
a
"}
(12,1,1) = {"
a
a
a
a
a
a
b
b
b
o
o
o
b
b
o
o
o
o
o
o
o
b
o
o
b
o
o
o
o
o
o
b
b
b
b
b
b
a
a
a
"}
(13,1,1) = {"
a
a
a
a
a
a
b
b
b
o
o
o
b
o
o
o
o
o
b
o
o
b
o
o
b
b
o
o
o
o
b
b
b
b
b
b
b
a
a
a
"}
(14,1,1) = {"
a
a
a
a
a
a
b
b
b
o
o
o
o
o
o
o
o
o
o
o
o
o
o
b
o
o
o
b
o
b
b
b
b
b
b
b
b
a
a
a
"}
(15,1,1) = {"
a
a
a
a
a
a
b
b
b
b
o
o
o
o
o
o
o
o
o
o
o
o
o
b
o
b
o
b
b
b
b
b
c
b
b
b
a
a
a
a
"}
(16,1,1) = {"
a
a
a
a
a
a
a
b
b
b
o
o
o
o
o
b
o
b
o
o
b
o
o
b
o
b
b
b
b
b
b
c
d
e
b
b
b
a
a
a
"}
(17,1,1) = {"
a
a
a
a
a
a
a
b
b
b
o
o
o
o
o
b
o
o
b
b
b
b
b
b
b
b
b
b
b
b
c
c
c
c
b
b
b
a
a
a
"}
(18,1,1) = {"
a
a
a
a
a
a
a
b
b
b
o
b
o
o
o
o
o
b
o
b
b
b
o
b
b
b
b
b
b
c
c
c
c
B
b
b
b
b
a
a
"}
(19,1,1) = {"
a
a
a
a
a
a
a
a
b
o
o
o
b
o
o
o
b
o
b
b
b
b
o
b
b
b
b
b
c
c
c
c
c
c
c
b
b
b
a
a
"}
(20,1,1) = {"
a
a
a
a
a
a
a
a
b
b
o
b
o
o
b
o
b
o
b
b
b
o
b
b
b
b
b
c
c
c
c
c
c
c
c
b
b
b
a
a
"}
(21,1,1) = {"
a
a
a
a
a
a
a
a
b
o
o
o
o
o
b
o
o
b
o
b
o
b
b
b
b
b
c
c
c
c
c
c
c
c
c
b
b
b
a
a
"}
(22,1,1) = {"
a
a
a
a
a
a
a
b
b
o
o
o
b
o
o
o
b
o
b
o
b
b
b
b
b
b
B
c
c
c
c
c
c
c
g
b
b
b
a
a
"}
(23,1,1) = {"
a
a
a
a
a
a
a
b
b
o
o
o
o
o
b
o
b
b
b
b
b
b
b
b
b
b
b
c
c
c
c
c
c
c
c
b
b
a
a
a
"}
(24,1,1) = {"
a
a
a
a
a
a
a
b
b
o
o
o
o
o
o
b
o
b
b
b
b
b
b
b
b
b
b
b
c
c
c
c
c
c
c
b
b
b
a
a
"}
(25,1,1) = {"
a
a
a
a
a
a
a
b
b
b
b
o
o
o
o
o
b
b
b
b
b
b
b
b
b
b
b
b
c
c
c
c
c
c
c
b
b
b
a
a
"}
(26,1,1) = {"
a
a
a
a
a
a
a
b
b
o
o
o
b
o
o
b
b
b
b
b
b
b
b
b
b
b
b
b
b
c
c
c
c
B
b
b
b
b
a
a
"}
(27,1,1) = {"
a
a
a
a
a
a
a
b
b
b
b
b
o
b
o
o
o
b
b
b
b
b
b
b
b
b
b
b
b
c
c
c
c
c
b
b
b
b
a
a
"}
(28,1,1) = {"
a
a
a
a
a
a
a
a
b
o
b
o
o
o
o
b
o
o
b
b
b
b
b
b
b
b
b
b
b
b
c
c
c
c
b
b
b
a
a
a
"}
(29,1,1) = {"
a
a
a
a
a
a
a
b
b
b
o
o
o
o
o
b
b
o
b
b
b
b
b
b
b
b
b
b
b
b
b
c
c
b
b
b
a
a
a
a
"}
(30,1,1) = {"
a
a
a
a
a
a
a
b
b
b
b
b
o
o
o
o
b
o
o
b
b
b
b
b
o
b
b
b
b
b
b
o
o
b
b
a
a
a
a
a
"}
(31,1,1) = {"
a
a
a
a
a
a
a
b
b
o
o
b
o
b
o
o
b
o
o
o
o
b
o
b
b
o
o
o
o
o
o
b
o
b
b
a
a
a
a
a
"}
(32,1,1) = {"
a
a
a
a
a
a
a
b
b
b
o
o
o
b
o
o
o
o
o
o
o
o
o
o
b
o
o
o
o
o
b
o
b
b
a
a
a
a
a
a
"}
(33,1,1) = {"
a
a
a
a
a
a
a
b
b
b
b
o
o
o
o
o
o
o
b
o
o
o
o
o
o
o
o
o
o
o
o
o
o
b
a
a
a
a
a
a
"}
(34,1,1) = {"
a
a
a
a
a
a
a
b
b
b
b
b
b
o
o
o
b
o
b
o
o
o
o
o
o
o
o
b
o
o
o
o
b
a
a
a
a
a
a
a
"}
(35,1,1) = {"
a
a
a
a
a
a
a
a
b
b
b
b
b
b
o
o
o
o
b
o
o
o
o
o
o
o
b
b
o
o
o
b
b
a
a
a
a
a
a
a
"}
(36,1,1) = {"
a
a
a
a
a
a
a
a
a
a
b
b
b
b
b
o
b
o
o
o
b
b
b
b
b
b
b
b
b
b
b
b
a
a
a
a
a
a
a
a
"}
(37,1,1) = {"
a
a
a
a
a
a
a
a
a
a
a
b
b
b
o
b
o
o
o
b
b
b
b
b
b
o
b
a
b
b
b
a
a
a
a
a
a
a
a
a
"}
(38,1,1) = {"
a
a
a
a
a
a
a
a
a
a
a
a
b
b
b
o
o
b
o
o
o
o
o
o
o
b
a
a
a
a
a
a
a
a
a
a
a
a
a
a
"}
(39,1,1) = {"
a
a
a
a
a
a
a
a
a
a
a
a
a
b
b
b
b
b
b
b
b
b
b
b
a
a
a
a
a
a
a
a
a
a
a
a
a
a
a
a
"}
(40,1,1) = {"
a
a
a
a
a
a
a
a
a
a
a
a
a
a
a
a
a
a
a
a
a
a
a
a
a
a
a
a
a
a
a
a
a
a
a
a
a
a
a
a
"}
