"a" = (/turf/template_noop,/area/template_noop)
"b" = (/turf/closed/mineral,/area/ruin/powered)

(1,1,1) = {"
aaaaaaaaaaaaaaaaaaaaaaaaaaaaaaaaaaaaaaaa
aaaaaaaaaaaaaaaaaaaaaaaaaaaaaaaaaaaaaaaa
aabbbbbbbbbbbbbbbbbbbbbbbbbbbbbbbbbbbbaa
aabbbbbbbbbbbbbbbbbbbbbbbbbbbbbbbbbbbbaa
aabbbbbbbbbbbbbbbbbbbbbbbbbbbbbbbbbbbbaa
aabbbbbbbbbbbbbbbbbbbbbbbbbbbbbbbbbbbbaa
aabbbbbbbbbbbbbbbbbbbbbbbbbbbbbbbbbbbbaa
aabbbbbbbbbbbbbbbbbbbbbbbbbbbbbbbbbbbbaa
aabbbbbbbbbbbbbbbbbbbbbbbbbbbbbbbbbbbbaa
aabbbbbbbbbbbbbbbbbbbbbbbbbbbbbbbbbbbbaa
aabbbbbbbbbbbbbbbbbbbbbbbbbbbbbbbbbbbbaa
aabbbbbbbbbbbbbbbbbbbbbbbbbbbbbbbbbbbbaa
aabbbbbbbbbbbbbbbbbbbbbbbbbbbbbbbbbbbbaa
aabbbbbbbbbbbbbbbbbbbbbbbbbbbbbbbbbbbbaa
aabbbbbbbbbbbbbbbbbbbbbbbbbbbbbbbbbbbbaa
aabbbbbbbbbbbbbbbbbbbbbbbbbbbbbbbbbbbbaa
aabbbbbbbbbbbbbbbbbbbbbbbbbbbbbbbbbbbbaa
aabbbbbbbbbbbbbbbbbbbbbbbbbbbbbbbbbbbbaa
aabbbbbbbbbbbbbbbbbbbbbbbbbbbbbbbbbbbbaa
aabbbbbbbbbbbbbbbbbbbbbbbbbbbbbbbbbbbbaa
aabbbbbbbbbbbbbbbbbbbbbbbbbbbbbbbbbbbbaa
aabbbbbbbbbbbbbbbbbbbbbbbbbbbbbbbbbbbbaa
aabbbbbbbbbbbbbbbbbbbbbbbbbbbbbbbbbbbbaa
aabbbbbbbbbbbbbbbbbbbbbbbbbbbbbbbbbbbbaa
aabbbbbbbbbbbbbbbbbbbbbbbbbbbbbbbbbbbbaa
aabbbbbbbbbbbbbbbbbbbbbbbbbbbbbbbbbbbbaa
aabbbbbbbbbbbbbbbbbbbbbbbbbbbbbbbbbbbbaa
aabbbbbbbbbbbbbbbbbbbbbbbbbbbbbbbbbbbbaa
aabbbbbbbbbbbbbbbbbbbbbbbbbbbbbbbbbbbbaa
aabbbbbbbbbbbbbbbbbbbbbbbbbbbbbbbbbbbbaa
aabbbbbbbbbbbbbbbbbbbbbbbbbbbbbbbbbbbbaa
aabbbbbbbbbbbbbbbbbbbbbbbbbbbbbbbbbbbbaa
aabbbbbbbbbbbbbbbbbbbbbbbbbbbbbbbbbbbbaa
aabbbbbbbbbbbbbbbbbbbbbbbbbbbbbbbbbbbbaa
aabbbbbbbbbbbbbbbbbbbbbbbbbbbbbbbbbbbbaa
aabbbbbbbbbbbbbbbbbbbbbbbbbbbbbbbbbbbbaa
aabbbbbbbbbbbbbbbbbbbbbbbbbbbbbbbbbbbbaa
aabbbbbbbbbbbbbbbbbbbbbbbbbbbbbbbbbbbbaa
aaaaaaaaaaaaaaaaaaaaaaaaaaaaaaaaaaaaaaaa
aaaaaaaaaaaaaaaaaaaaaaaaaaaaaaaaaaaaaaaa
"}
