//MAP CONVERTED BY dmm2tgm.py THIS HEADER COMMENT PREVENTS RECONVERSION, DO NOT REMOVE
"d" = (
/obj/item/hemostat/alien,
/turf/open/floor/plating/abductor{
	initial_gas_mix = "TEMP=2.7"
	},
/area/ruin/powered)
"g" = (
/obj/structure/closet/abductor,
/turf/open/floor/plating/abductor{
	initial_gas_mix = "TEMP=2.7"
	},
/area/ruin/powered)
"q" = (
/turf/closed/wall/mineral/abductor,
/area/ruin/powered)
"r" = (
/turf/closed/mineral,
/area/ruin/powered)
"u" = (
/obj/structure/table/abductor,
/obj/item/storage/box/alienhandcuffs,
/turf/open/floor/plating/abductor{
	initial_gas_mix = "TEMP=2.7"
	},
/area/ruin/powered)
"w" = (
/turf/open/floor/plating/asteroid/airless,
/area/ruin/powered)
"B" = (
/obj/item/scalpel/alien,
/obj/item/surgical_drapes,
/turf/open/floor/plating/abductor{
	initial_gas_mix = "TEMP=2.7"
	},
/area/ruin/powered)
"F" = (
/obj/structure/bed/abductor,
/turf/open/floor/plating/abductor{
	initial_gas_mix = "TEMP=2.7"
	},
/area/ruin/powered)
"G" = (
/obj/machinery/abductor/gland_dispenser,
/turf/open/floor/plating/abductor{
	initial_gas_mix = "TEMP=2.7"
	},
/area/ruin/powered)
"I" = (
/obj/machinery/abductor/experiment{
	team_number = 100
	},
/turf/open/floor/plating/abductor{
	initial_gas_mix = "TEMP=2.7"
	},
/area/ruin/powered)
"K" = (
/obj/machinery/abductor/pad{
	team_number = 100
	},
/turf/open/floor/plating/abductor{
	initial_gas_mix = "TEMP=2.7"
	},
/area/ruin/powered)
"L" = (
/obj/effect/mob_spawn/human/abductor,
/turf/open/floor/plating/abductor{
	initial_gas_mix = "TEMP=2.7"
	},
/area/ruin/powered)
"N" = (
/obj/structure/table/optable/abductor,
/obj/item/cautery/alien,
/turf/open/floor/plating/abductor{
	initial_gas_mix = "TEMP=2.7"
	},
/area/ruin/powered)
"O" = (
/turf/open/space/basic,
/area/space)
"V" = (
/turf/open/floor/plating/abductor{
	initial_gas_mix = "TEMP=2.7"
	},
/area/ruin/powered)
"Y" = (
/obj/structure/table/abductor,
/obj/item/surgicaldrill/alien,
/obj/item/circular_saw/alien,
/turf/open/floor/plating/abductor{
	initial_gas_mix = "TEMP=2.7"
	},
/area/ruin/powered)
"Z" = (
/obj/item/retractor/alien,
/obj/item/paper/guides/antag/abductor,
/turf/open/floor/plating/abductor{
	initial_gas_mix = "TEMP=2.7"
	},
/area/ruin/powered)

(1,1,1) = {"
O
O
O
O
O
O
O
O
O
O
O
O
O
O
O
O
O
O
O
O
O
O
O
O
O
O
O
O
O
O
O
O
O
O
O
O
O
O
O
O
"}
(2,1,1) = {"
O
O
O
O
O
O
O
O
O
O
O
O
O
O
O
O
O
O
O
O
O
O
O
O
O
O
O
O
O
O
O
O
O
O
O
O
O
O
O
O
"}
(3,1,1) = {"
O
O
O
O
O
O
O
O
O
O
O
O
O
O
O
O
O
O
O
O
O
O
O
O
O
O
O
O
O
O
O
O
O
O
O
O
O
O
O
O
"}
(4,1,1) = {"
O
O
O
O
O
O
O
O
O
O
O
O
O
O
O
O
O
O
O
O
r
r
O
O
O
O
O
O
O
O
O
O
O
O
O
O
O
O
O
O
"}
(5,1,1) = {"
O
O
O
O
O
O
O
O
O
O
O
O
O
O
O
O
O
O
r
r
r
r
r
O
O
O
O
O
O
O
O
O
O
O
O
O
O
O
O
O
"}
(6,1,1) = {"
O
O
O
O
O
O
O
O
O
O
O
O
O
O
O
O
r
r
r
r
r
r
r
r
r
r
O
O
O
O
O
O
O
O
O
O
O
O
O
O
"}
(7,1,1) = {"
O
O
O
O
O
O
O
O
O
O
O
O
O
O
O
r
r
r
r
r
r
r
r
r
r
r
r
r
O
O
O
O
O
O
O
O
O
O
O
O
"}
(8,1,1) = {"
O
O
O
O
O
O
O
O
O
O
O
O
O
r
r
r
r
r
r
r
r
r
r
r
r
r
r
r
r
w
w
w
O
O
O
O
O
O
O
O
"}
(9,1,1) = {"
O
O
O
O
O
O
O
O
O
O
O
O
r
r
r
r
r
r
r
r
r
r
r
r
r
r
r
r
r
r
w
w
w
O
O
O
O
O
O
O
"}
(10,1,1) = {"
O
O
O
O
O
O
O
O
O
O
O
r
r
r
r
r
r
r
r
r
r
r
r
r
r
r
r
r
r
w
w
w
w
w
O
O
O
O
O
O
"}
(11,1,1) = {"
O
O
O
O
O
O
O
O
O
O
O
r
r
r
r
r
r
r
r
r
r
r
r
r
r
r
q
q
w
w
q
w
w
w
O
O
O
O
O
O
"}
(12,1,1) = {"
O
O
O
O
O
O
O
O
O
O
O
r
r
r
r
r
r
r
r
r
r
r
r
r
r
q
q
V
V
V
q
q
w
w
w
O
O
O
O
O
"}
(13,1,1) = {"
O
O
O
O
O
O
O
O
O
O
O
r
r
r
r
r
r
r
r
r
r
r
r
r
r
q
I
V
V
V
G
q
w
w
w
O
O
O
O
O
"}
(14,1,1) = {"
O
O
O
O
O
O
O
O
O
O
O
r
r
r
r
r
r
r
r
r
r
r
r
r
r
q
d
V
N
B
Y
q
w
r
r
O
O
O
O
O
"}
(15,1,1) = {"
O
O
O
O
O
O
O
O
O
O
O
r
r
r
r
r
r
r
r
r
r
r
r
r
r
q
K
L
V
Z
F
q
r
r
r
r
O
O
O
O
"}
(16,1,1) = {"
O
O
O
O
O
O
O
O
O
O
r
r
r
r
r
r
r
r
r
r
r
r
r
r
r
q
q
g
u
g
q
q
r
r
r
r
r
O
O
O
"}
(17,1,1) = {"
O
O
O
O
O
O
O
O
O
O
r
r
r
r
r
r
r
r
r
r
r
r
r
r
r
r
q
q
q
q
q
r
r
r
r
r
r
O
O
O
"}
(18,1,1) = {"
O
O
O
O
O
O
O
O
O
O
r
r
r
r
r
r
r
r
r
r
r
r
r
r
r
r
r
r
r
r
r
r
r
r
r
r
O
O
O
O
"}
(19,1,1) = {"
O
O
O
O
O
O
O
O
O
O
r
r
r
r
r
r
r
r
r
r
r
r
r
r
r
r
r
r
r
r
r
r
r
r
r
r
O
O
O
O
"}
(20,1,1) = {"
O
O
O
O
O
O
O
O
O
r
r
r
r
r
r
r
r
r
r
r
r
r
r
r
r
r
r
r
r
r
r
r
r
r
r
O
O
O
O
O
"}
(21,1,1) = {"
O
O
O
O
O
O
O
O
O
r
r
r
r
r
r
r
r
r
r
r
r
r
r
r
r
r
r
r
r
r
r
r
r
r
O
O
O
O
O
O
"}
(22,1,1) = {"
O
O
O
O
O
O
O
O
r
r
r
r
r
r
r
r
r
r
r
r
r
r
r
r
r
r
r
r
r
r
r
r
r
O
O
O
O
O
O
O
"}
(23,1,1) = {"
O
O
O
O
O
O
O
O
r
r
r
r
r
r
r
r
r
r
r
r
r
r
r
r
r
r
r
r
r
r
r
r
r
O
O
O
O
O
O
O
"}
(24,1,1) = {"
O
O
O
O
O
O
O
O
r
r
r
r
r
r
r
r
r
r
r
r
r
r
r
r
r
r
r
r
r
r
r
r
O
O
O
O
O
O
O
O
"}
(25,1,1) = {"
O
O
O
O
O
O
O
O
r
r
r
r
r
r
r
r
r
r
r
r
r
r
r
r
r
r
r
r
r
r
r
r
O
O
O
O
O
O
O
O
"}
(26,1,1) = {"
O
O
O
O
O
O
O
O
r
r
r
r
r
r
r
r
r
r
r
r
r
r
r
r
r
r
r
r
r
r
r
O
O
O
O
O
O
O
O
O
"}
(27,1,1) = {"
O
O
O
O
O
O
O
O
O
r
r
r
r
r
r
r
r
r
r
r
r
r
r
r
r
r
r
r
r
r
r
O
O
O
O
O
O
O
O
O
"}
(28,1,1) = {"
O
O
O
O
O
O
O
O
r
r
r
r
r
r
r
r
r
r
r
r
r
r
r
r
r
r
r
r
r
r
O
O
O
O
O
O
O
O
O
O
"}
(29,1,1) = {"
O
O
O
O
O
O
O
O
r
r
r
r
r
r
r
r
r
r
r
r
r
r
r
r
r
r
r
r
r
O
O
O
O
O
O
O
O
O
O
O
"}
(30,1,1) = {"
O
O
O
O
O
O
O
O
O
r
r
r
r
r
r
r
r
r
r
r
r
r
r
r
r
r
r
r
O
O
O
O
O
O
O
O
O
O
O
O
"}
(31,1,1) = {"
O
O
O
O
O
O
O
O
O
r
r
r
r
r
r
r
r
r
r
r
r
r
r
r
r
O
O
O
O
O
O
O
O
O
O
O
O
O
O
O
"}
(32,1,1) = {"
O
O
O
O
O
O
O
O
O
O
r
r
r
r
r
r
r
r
r
r
r
r
r
O
O
O
O
O
O
O
O
O
O
O
O
O
O
O
O
O
"}
(33,1,1) = {"
O
O
O
O
O
O
O
O
O
O
O
r
r
r
r
r
r
r
r
O
O
O
O
O
O
O
O
O
O
O
O
O
O
O
O
O
O
O
O
O
"}
(34,1,1) = {"
O
O
O
O
O
O
O
O
O
O
O
O
O
r
r
r
r
O
O
O
O
O
O
O
O
O
O
O
O
O
O
O
O
O
O
O
O
O
O
O
"}
(35,1,1) = {"
O
O
O
O
O
O
O
O
O
O
O
O
O
O
O
O
O
O
O
O
O
O
O
O
O
O
O
O
O
O
O
O
O
O
O
O
O
O
O
O
"}
(36,1,1) = {"
O
O
O
O
O
O
O
O
O
O
O
O
O
O
O
O
O
O
O
O
O
O
O
O
O
O
O
O
O
O
O
O
O
O
O
O
O
O
O
O
"}
(37,1,1) = {"
O
O
O
O
O
O
O
O
O
O
O
O
O
O
O
O
O
O
O
O
O
O
O
O
O
O
O
O
O
O
O
O
O
O
O
O
O
O
O
O
"}
(38,1,1) = {"
O
O
O
O
O
O
O
O
O
O
O
O
O
O
O
O
O
O
O
O
O
O
O
O
O
O
O
O
O
O
O
O
O
O
O
O
O
O
O
O
"}
(39,1,1) = {"
O
O
O
O
O
O
O
O
O
O
O
O
O
O
O
O
O
O
O
O
O
O
O
O
O
O
O
O
O
O
O
O
O
O
O
O
O
O
O
O
"}
(40,1,1) = {"
O
O
O
O
O
O
O
O
O
O
O
O
O
O
O
O
O
O
O
O
O
O
O
O
O
O
O
O
O
O
O
O
O
O
O
O
O
O
O
O
"}
