//MAP CONVERTED BY dmm2tgm.py THIS HEADER COMMENT PREVENTS RECONVERSION, DO NOT REMOVE
"b" = (
/turf/closed/mineral,
/area/ruin/powered)
"c" = (
/turf/open/floor/wood,
/area/ruin/powered)
"d" = (
/obj/structure/window/paperframe{
	CanAtmosPass = 0
	},
/turf/open/floor/wood,
/area/ruin/powered)
"e" = (
/obj/structure/chair/wood/wings{
	dir = 8
	},
/turf/open/floor/wood,
/area/ruin/powered)
"f" = (
/obj/structure/lattice,
/turf/open/space/basic,
/area/space)
"g" = (
/obj/machinery/door/airlock/wood{
	req_one_access_txt = "0"
	},
/obj/effect/mapping_helpers/airlock/cyclelink_helper{
	dir = 8
	},
/turf/open/floor/wood,
/area/ruin/powered)
"i" = (
/obj/machinery/door/airlock/wood{
	req_one_access_txt = "0"
	},
/obj/effect/mapping_helpers/airlock/cyclelink_helper{
	dir = 4
	},
/turf/open/floor/wood,
/area/ruin/powered)
"j" = (
/obj/structure/table/wood/fancy,
/obj/item/reagent_containers/food/snacks/hotdog,
/turf/open/floor/wood,
/area/ruin/powered)
"k" = (
/obj/structure/bed/dogbed,
/mob/living/simple_animal/hostile/carp,
/turf/open/floor/wood,
/area/ruin/powered)
"m" = (
/obj/structure/rack,
/turf/open/floor/wood,
/area/ruin/powered)
"o" = (
/obj/structure/rack,
/obj/item/toy/plush/carpplushie,
/turf/open/floor/wood,
/area/ruin/powered)
"p" = (
/obj/machinery/light{
	dir = 8
	},
/turf/open/floor/wood,
/area/ruin/powered)
"s" = (
/obj/structure/table/wood/fancy,
/obj/item/reagent_containers/food/snacks/sashimi,
/turf/open/floor/wood,
/area/ruin/powered)
"t" = (
/obj/structure/rack,
/obj/item/nullrod/scythe/vibro{
	damtype = "stamina";
	force = 30
	},
/turf/open/floor/wood,
/area/ruin/powered)
"u" = (
/obj/structure/table/wood/fancy,
/obj/item/reagent_containers/food/snacks/raisincookie,
/turf/open/floor/wood,
/area/ruin/powered)
"v" = (
/obj/structure/bookcase/random,
/turf/open/floor/wood,
/area/ruin/powered)
"x" = (
/obj/structure/closet/crate,
/obj/item/stack/sheet/paperframes/fifty,
/obj/item/stack/sheet/paperframes/fifty,
/obj/item/storage/fancy/candle_box,
/turf/open/floor/wood,
/area/ruin/powered)
"y" = (
/obj/structure/rack,
/obj/item/nullrod/scythe/vibro{
	damtype = "stamina";
	force = 30
	},
/obj/machinery/light,
/turf/open/floor/wood,
/area/ruin/powered)
"z" = (
/obj/item/twohanded/required/kirbyplants{
	icon_state = "plant-10"
	},
/turf/open/floor/wood,
/area/ruin/powered)
"D" = (
/obj/structure/chair/wood/wings{
	dir = 4
	},
/turf/open/floor/wood,
/area/ruin/powered)
"F" = (
/obj/structure/mineral_door/paperframe{
	name = "Dojo"
	},
/turf/open/floor/wood,
/area/ruin/powered)
"I" = (
/obj/structure/lattice/catwalk,
/turf/open/space/basic,
/area/space)
"J" = (
/mob/living/simple_animal/hostile/carp/megacarp,
/obj/structure/bed/dogbed,
/turf/open/floor/wood,
/area/ruin/powered)
"K" = (
/obj/structure/rack,
/obj/item/clothing/under/costume/geisha,
/obj/machinery/light{
	dir = 1
	},
/turf/open/floor/wood,
/area/ruin/powered)
"M" = (
/obj/structure/table/wood/fancy,
/obj/item/reagent_containers/food/snacks/meatclown,
/turf/open/floor/wood,
/area/ruin/powered)
"N" = (
/obj/structure/table/wood/fancy,
/turf/open/floor/wood,
/area/ruin/powered)
"O" = (
/turf/closed/indestructible{
	icon = 'icons/turf/walls/wood_wall.dmi';
	icon_state = "wood";
	smooth = 1
	},
/area/ruin/powered)
"S" = (
/obj/machinery/light{
	dir = 4
	},
/turf/open/floor/wood,
/area/ruin/powered)
"U" = (
/obj/machinery/light{
	dir = 1
	},
/turf/open/floor/wood,
/area/ruin/powered)
"V" = (
/mob/living/simple_animal/hostile/carp,
/obj/structure/bed/dogbed,
/turf/open/floor/wood,
/area/ruin/powered)
"Y" = (
/turf/open/space/basic,
/area/space)
"Z" = (
/obj/structure/rack,
/obj/item/clothing/suit/hooded/carp_costume,
/turf/open/floor/wood,
/area/ruin/powered)

(1,1,1) = {"
Y
Y
Y
Y
Y
Y
Y
Y
Y
Y
Y
Y
Y
Y
Y
Y
Y
Y
Y
Y
Y
Y
Y
Y
Y
Y
Y
Y
Y
Y
Y
Y
Y
Y
Y
Y
Y
Y
Y
Y
"}
(2,1,1) = {"
Y
Y
Y
Y
Y
Y
Y
Y
Y
Y
Y
Y
Y
Y
Y
Y
Y
Y
f
I
I
I
f
Y
Y
Y
Y
Y
Y
Y
Y
Y
Y
Y
Y
Y
Y
Y
Y
Y
"}
(3,1,1) = {"
Y
Y
Y
Y
Y
Y
Y
Y
Y
Y
Y
Y
Y
Y
Y
Y
b
b
O
O
i
O
O
b
b
b
b
Y
Y
Y
Y
Y
Y
Y
Y
Y
Y
Y
Y
Y
"}
(4,1,1) = {"
Y
Y
Y
Y
Y
Y
Y
Y
Y
Y
Y
Y
Y
Y
Y
b
b
b
O
c
c
c
O
b
b
b
b
b
Y
Y
Y
Y
Y
Y
Y
Y
Y
Y
Y
Y
"}
(5,1,1) = {"
Y
Y
Y
Y
Y
Y
Y
Y
Y
Y
Y
Y
Y
Y
b
b
b
b
O
O
g
O
O
b
b
b
b
b
b
Y
Y
Y
Y
Y
Y
Y
Y
Y
Y
Y
"}
(6,1,1) = {"
Y
Y
Y
Y
Y
Y
Y
b
b
b
Y
Y
b
b
b
b
b
b
O
z
c
z
O
b
b
b
b
b
b
b
Y
Y
Y
Y
Y
Y
Y
Y
Y
Y
"}
(7,1,1) = {"
Y
Y
Y
Y
Y
Y
b
b
b
b
b
b
b
b
b
b
b
b
O
U
c
c
O
b
b
b
b
b
b
b
b
Y
Y
Y
Y
Y
Y
Y
Y
Y
"}
(8,1,1) = {"
Y
Y
Y
Y
Y
b
b
b
b
b
b
b
b
b
b
b
b
b
O
c
c
c
O
b
b
b
b
b
b
b
b
b
Y
Y
Y
Y
Y
Y
Y
Y
"}
(9,1,1) = {"
Y
Y
Y
Y
b
b
b
b
b
b
b
b
b
O
O
O
O
O
O
c
c
c
O
O
O
O
O
O
O
b
b
b
Y
Y
Y
Y
Y
Y
Y
Y
"}
(10,1,1) = {"
Y
Y
Y
Y
b
b
b
b
b
b
b
b
b
O
z
D
D
c
d
c
c
c
d
c
c
p
c
x
O
b
b
b
Y
Y
Y
Y
Y
Y
Y
Y
"}
(11,1,1) = {"
Y
Y
Y
Y
b
b
b
b
b
b
b
b
b
O
c
s
N
c
d
c
c
c
d
c
c
c
k
v
O
b
b
Y
Y
Y
Y
Y
Y
Y
Y
Y
"}
(12,1,1) = {"
Y
Y
Y
Y
b
b
b
b
b
b
b
b
b
O
U
c
c
c
F
c
c
c
F
c
c
c
c
v
O
b
b
b
Y
Y
Y
Y
Y
Y
Y
Y
"}
(13,1,1) = {"
Y
Y
Y
Y
b
b
b
b
b
b
b
b
b
O
c
s
N
c
d
z
S
z
d
z
c
c
c
m
O
b
b
b
Y
Y
Y
Y
Y
Y
Y
Y
"}
(14,1,1) = {"
Y
Y
Y
Y
b
b
b
b
b
b
b
b
b
O
z
e
e
c
O
O
O
O
O
d
d
F
d
d
O
b
b
b
Y
Y
Y
Y
Y
Y
Y
Y
"}
(15,1,1) = {"
Y
Y
Y
Y
b
b
b
b
b
b
b
b
b
O
O
O
O
O
O
b
b
b
O
c
c
c
c
c
O
b
b
b
b
Y
Y
Y
Y
Y
Y
Y
"}
(16,1,1) = {"
Y
Y
Y
Y
b
b
b
b
b
b
b
b
b
b
b
b
b
b
b
b
b
O
O
c
c
c
c
c
O
O
b
b
b
Y
Y
Y
Y
Y
Y
Y
"}
(17,1,1) = {"
Y
Y
Y
Y
Y
b
b
b
b
b
b
b
b
b
b
b
b
b
b
b
b
O
z
c
c
c
c
c
z
O
b
b
b
Y
Y
Y
Y
Y
Y
Y
"}
(18,1,1) = {"
Y
Y
Y
Y
Y
Y
b
b
b
b
b
b
b
b
b
b
b
b
b
b
b
O
c
c
c
c
c
c
c
O
b
b
b
Y
Y
Y
Y
Y
Y
Y
"}
(19,1,1) = {"
Y
Y
Y
Y
Y
Y
b
b
b
b
b
b
b
b
b
b
b
b
b
b
b
O
K
c
u
M
j
c
y
O
b
b
b
Y
Y
Y
Y
Y
Y
Y
"}
(20,1,1) = {"
Y
Y
Y
Y
Y
Y
b
b
b
b
b
b
b
b
b
b
b
b
b
b
b
O
o
c
V
J
V
c
Z
O
b
b
b
Y
Y
Y
Y
Y
Y
Y
"}
(21,1,1) = {"
Y
Y
Y
Y
Y
Y
b
b
b
b
b
b
b
b
b
b
b
b
b
b
b
O
t
c
c
c
c
c
o
O
b
b
b
Y
Y
Y
Y
Y
Y
Y
"}
(22,1,1) = {"
Y
Y
Y
Y
Y
Y
b
b
b
b
b
b
b
b
b
b
b
b
b
b
b
O
O
O
O
O
O
O
O
O
b
b
b
Y
Y
Y
Y
Y
Y
Y
"}
(23,1,1) = {"
Y
Y
Y
Y
Y
Y
b
b
b
b
b
b
b
b
b
b
b
b
b
b
b
b
b
b
b
b
b
b
b
b
b
b
b
Y
Y
Y
Y
Y
Y
Y
"}
(24,1,1) = {"
Y
Y
Y
Y
Y
Y
Y
b
b
b
b
b
b
b
b
b
b
b
b
b
b
b
b
b
b
b
b
b
b
b
b
b
b
Y
Y
Y
Y
Y
Y
Y
"}
(25,1,1) = {"
Y
Y
Y
Y
Y
Y
Y
b
b
b
b
b
b
b
b
b
b
b
b
b
b
b
b
b
b
b
b
b
b
b
b
b
b
Y
Y
Y
Y
Y
Y
Y
"}
(26,1,1) = {"
Y
Y
Y
Y
Y
Y
Y
Y
b
b
b
b
b
b
b
b
b
b
b
b
b
b
b
b
b
b
b
b
b
b
b
b
Y
Y
Y
Y
Y
Y
Y
Y
"}
(27,1,1) = {"
Y
Y
Y
Y
Y
Y
Y
Y
b
b
b
b
b
b
b
b
b
b
b
b
b
b
b
b
b
b
b
b
b
b
b
Y
Y
Y
Y
Y
Y
Y
Y
Y
"}
(28,1,1) = {"
Y
Y
Y
Y
Y
Y
Y
Y
Y
b
b
b
b
b
b
b
b
b
b
b
b
b
b
b
b
b
b
b
b
b
b
b
Y
Y
Y
Y
Y
Y
Y
Y
"}
(29,1,1) = {"
Y
Y
Y
Y
Y
Y
Y
Y
Y
Y
b
b
b
b
b
b
b
b
b
b
b
b
b
b
b
b
b
b
b
b
b
b
Y
Y
Y
Y
Y
Y
Y
Y
"}
(30,1,1) = {"
Y
Y
Y
Y
Y
Y
Y
Y
Y
Y
Y
Y
Y
b
b
b
b
b
b
b
b
b
b
b
b
b
b
b
b
b
b
b
Y
Y
Y
Y
Y
Y
Y
Y
"}
(31,1,1) = {"
Y
Y
Y
Y
Y
Y
Y
Y
Y
Y
Y
Y
Y
Y
b
b
b
b
b
b
b
b
b
b
b
b
b
b
b
b
b
b
Y
Y
Y
Y
Y
Y
Y
Y
"}
(32,1,1) = {"
Y
Y
Y
Y
Y
Y
Y
Y
Y
Y
Y
Y
Y
Y
Y
b
b
b
b
b
b
b
b
b
b
b
b
b
b
b
b
b
Y
Y
Y
Y
Y
Y
Y
Y
"}
(33,1,1) = {"
Y
Y
Y
Y
Y
Y
Y
Y
Y
Y
Y
Y
Y
Y
Y
b
b
b
b
b
b
b
b
b
b
b
b
b
b
b
b
b
Y
Y
Y
Y
Y
Y
Y
Y
"}
(34,1,1) = {"
Y
Y
Y
Y
Y
Y
Y
Y
Y
Y
Y
Y
Y
Y
Y
b
b
b
b
b
b
b
b
b
b
b
b
b
b
b
b
b
Y
Y
Y
Y
Y
Y
Y
Y
"}
(35,1,1) = {"
Y
Y
Y
Y
Y
Y
Y
Y
Y
Y
Y
Y
Y
Y
Y
Y
b
b
b
b
b
b
b
b
b
b
b
b
b
b
b
Y
Y
Y
Y
Y
Y
Y
Y
Y
"}
(36,1,1) = {"
Y
Y
Y
Y
Y
Y
Y
Y
Y
Y
Y
Y
Y
Y
Y
Y
Y
Y
b
b
b
b
b
b
b
b
b
b
b
Y
Y
Y
Y
Y
Y
Y
Y
Y
Y
Y
"}
(37,1,1) = {"
Y
Y
Y
Y
Y
Y
Y
Y
Y
Y
Y
Y
Y
Y
Y
Y
Y
Y
Y
Y
b
b
b
b
b
b
Y
Y
Y
Y
Y
Y
Y
Y
Y
Y
Y
Y
Y
Y
"}
(38,1,1) = {"
Y
Y
Y
Y
Y
Y
Y
Y
Y
Y
Y
Y
Y
Y
Y
Y
Y
Y
Y
Y
Y
Y
Y
Y
Y
Y
Y
Y
Y
Y
Y
Y
Y
Y
Y
Y
Y
Y
Y
Y
"}
(39,1,1) = {"
Y
Y
Y
Y
Y
Y
Y
Y
Y
Y
Y
Y
Y
Y
Y
Y
Y
Y
Y
Y
Y
Y
Y
Y
Y
Y
Y
Y
Y
Y
Y
Y
Y
Y
Y
Y
Y
Y
Y
Y
"}
(40,1,1) = {"
Y
Y
Y
Y
Y
Y
Y
Y
Y
Y
Y
Y
Y
Y
Y
Y
Y
Y
Y
Y
Y
Y
Y
Y
Y
Y
Y
Y
Y
Y
Y
Y
Y
Y
Y
Y
Y
Y
Y
Y
"}
