"a" = (/obj/structure/lattice,/turf/template_noop,/area/template_noop)
"b" = (/turf/closed/mineral,/area/ruin/powered)
"c" = (/turf/open/floor/wood,/area/ruin/powered)
"d" = (/obj/structure/window/paperframe{CanAtmosPass = 0},/turf/open/floor/wood,/area/ruin/powered)
"e" = (/obj/structure/chair/wood/wings{dir = 8},/turf/open/floor/wood,/area/ruin/powered)
"f" = (/obj/structure/lattice/catwalk,/turf/template_noop,/area/template_noop)
"g" = (/obj/machinery/door/airlock/wood{req_one_access_txt = "0"},/obj/effect/mapping_helpers/airlock/cyclelink_helper{dir = 8},/turf/open/floor/wood,/area/ruin/powered)
"h" = (/obj/structure/bed/dogbed,/mob/living/simple_animal/hostile/carp/megacarp,/turf/open/floor/wood,/area/ruin/powered)
"i" = (/obj/machinery/door/airlock/wood{req_one_access_txt = "0"},/obj/effect/mapping_helpers/airlock/cyclelink_helper{dir = 4},/turf/open/floor/wood,/area/ruin/powered)
"j" = (/obj/structure/table/wood/fancy,/obj/item/reagent_containers/food/snacks/hotdog,/turf/open/floor/wood,/area/ruin/powered)
"k" = (/obj/structure/bed/dogbed,/mob/living/simple_animal/hostile/carp,/turf/open/floor/wood,/area/ruin/powered)
"m" = (/obj/structure/rack,/turf/open/floor/wood,/area/ruin/powered)
"o" = (/obj/structure/rack,/obj/item/toy/plush/carpplushie,/turf/open/floor/wood,/area/ruin/powered)
"p" = (/obj/machinery/light{dir = 8},/turf/open/floor/wood,/area/ruin/powered)
"s" = (/obj/structure/table/wood/fancy,/obj/item/reagent_containers/food/snacks/sashimi,/turf/open/floor/wood,/area/ruin/powered)
"t" = (/obj/structure/rack,/obj/item/nullrod/scythe/vibro{damtype = "stamina"; force = 30},/turf/open/floor/wood,/area/ruin/powered)
"u" = (/obj/structure/table/wood/fancy,/obj/item/reagent_containers/food/snacks/raisincookie,/turf/open/floor/wood,/area/ruin/powered)
"v" = (/obj/structure/bookcase/random,/turf/open/floor/wood,/area/ruin/powered)
"x" = (/obj/structure/closet/crate,/obj/item/stack/sheet/paperframes/fifty,/obj/item/stack/sheet/paperframes/fifty,/obj/item/storage/fancy/candle_box,/turf/open/floor/wood,/area/ruin/powered)
"y" = (/obj/structure/rack,/obj/item/nullrod/scythe/vibro{damtype = "stamina"; force = 30},/obj/machinery/light,/turf/open/floor/wood,/area/ruin/powered)
"z" = (/obj/item/twohanded/required/kirbyplants{icon_state = "plant-10"},/turf/open/floor/wood,/area/ruin/powered)
"D" = (/obj/structure/chair/wood/wings{dir = 4},/turf/open/floor/wood,/area/ruin/powered)
"F" = (/obj/structure/mineral_door/paperframe{name = "Dojo"},/turf/open/floor/wood,/area/ruin/powered)
"K" = (/obj/structure/rack,/obj/item/clothing/under/costume/geisha,/obj/machinery/light{dir = 1},/turf/open/floor/wood,/area/ruin/powered)
"M" = (/obj/structure/table/wood/fancy,/obj/item/reagent_containers/food/snacks/meatclown,/turf/open/floor/wood,/area/ruin/powered)
"N" = (/obj/structure/table/wood/fancy,/turf/open/floor/wood,/area/ruin/powered)
"O" = (/turf/closed/indestructible{icon = 'icons/turf/walls/wood_wall.dmi'; icon_state = "wood"; smooth = 1},/area/ruin/powered)
"S" = (/obj/machinery/light{dir = 4},/turf/open/floor/wood,/area/ruin/powered)
"U" = (/obj/machinery/light{dir = 1},/turf/open/floor/wood,/area/ruin/powered)
"Y" = (/turf/template_noop,/area/template_noop)
"Z" = (/obj/structure/rack,/obj/item/clothing/suit/hooded/carp_costume,/turf/open/floor/wood,/area/ruin/powered)

(1,1,1) = {"
YYYYYYYYYYYYYYYYYYYYYYYYYYYYYYYYYYYYYYYY
YYYYYYYYYYYYYYYYYYYYYYYYYYYYYYYYYYYYYYYY
YYYYYYYYYYYYYYYYYYYYYYYYYYYYYYYYYYYYYYYY
YYYYYYYYYYYYYYYYYYYYYYYYYYYYYYYYYYYYYYYY
YYYYYYYYbbbbbbbbYYYYYYYYYYYYYYYYYYYYYYYY
YYYYYYYbbbbbbbbbbYYYYYYYYYYYYYYYYYYYYYYY
YYYYYYbbbbbbbbbbbbbbbbbYYYYYYYYYYYYYYYYY
YYYYYbbbbbbbbbbbbbbbbbbbbYYYYYYYYYYYYYYY
YYYYYbbbbbbbbbbbbbbbbbbbbbbYYYYYYYYYYYYY
YYYYYbbbbbbbbbbbbbbbbbbbbbbbYYYYYYYYYYYY
YYYYYYbbbbbbbbbbbbbbbbbbbbbbbYYYYYYYYYYY
YYYYYYbbbbbbbbbbbbbbbbbbbbbbbYYYYYYYYYYY
YYYYYbbbbbbbbbbbbbbbbbbbbbbbbYYYYYYYYYYY
YYYYYbbbOOOOOOObbbbbbbbbbbbbbbYYYYYYYYYY
YYYYbbbbOzcUczObbbbbbbbbbbbbbbbYYYYYYYYY
YYYbbbbbODscseObbbbbbbbbbbbbbbbbbbYYYYYY
YYbbbbbbODNcNeObbbbbbbbbbbbbbbbbbbbYYYYY
YYbbbbbbOcccccObbbbbbbbbbbbbbbbbbbbYYYYY
YaOOOOOOOddFdOObbbbbbbbbbbbbbbbbbbbbYYYY
YfOcOzUccccczObbbbbbbbbbbbbbbbbbbbbbYYYY
YficgcccccccSObbbbbbbbbbbbbbbbbbbbbbbYYY
YfOcOzcccccczObOOOOOOObbbbbbbbbbbbbbbYYY
YaOOOOOOOddFdOOOzcKotObbbbbbbbbbbbbbbYYY
YYbbbbbbOccczdcccccccObbbbbbbbbbbbbbbYYY
YYbbbbbbOccccdccccukcObbbbbbbbbbbbbbbYYY
YYbbbbbbOpcccFccccMhcObbbbbbbbbbbbbbbYYY
YYbbbbbbOckccdccccjkcObbbbbbbbbbbbbbYYYY
YYYbbbbbOxvvmdcccccccObbbbbbbbbbbbbbYYYY
YYYYbbbbOOOOOOOOzcyZoObbbbbbbbbbbbbbYYYY
YYYYYbbbbbbbbbbOOOOOOObbbbbbbbbbbbbYYYYY
YYYYYYbbbbbbbbbbbbbbbbbbbbbbbbbbbbbYYYYY
YYYYYYYbbbYbbbbbbbbbbbbbbbYbbbbbbbYYYYYY
YYYYYYYYYYYYYYbbbbbbbbbbbYYYYYYYYYYYYYYY
YYYYYYYYYYYYYYYYYYYYYYYYYYYYYYYYYYYYYYYY
YYYYYYYYYYYYYYYYYYYYYYYYYYYYYYYYYYYYYYYY
YYYYYYYYYYYYYYYYYYYYYYYYYYYYYYYYYYYYYYYY
YYYYYYYYYYYYYYYYYYYYYYYYYYYYYYYYYYYYYYYY
YYYYYYYYYYYYYYYYYYYYYYYYYYYYYYYYYYYYYYYY
YYYYYYYYYYYYYYYYYYYYYYYYYYYYYYYYYYYYYYYY
YYYYYYYYYYYYYYYYYYYYYYYYYYYYYYYYYYYYYYYY
"}
