//MAP CONVERTED BY dmm2tgm.py THIS HEADER COMMENT PREVENTS RECONVERSION, DO NOT REMOVE
"i" = (
/turf/open/floor/plating/asteroid,
/area/ruin/powered)
"p" = (
/turf/open/space/basic,
/area/space)
"O" = (
/obj/item/stack/sheet/mineral/sandstone{
	desc = "It's a brick.";
	name = "brick"
	},
/turf/open/floor/plating/asteroid,
/area/ruin/powered)
"Y" = (
/turf/closed/mineral,
/area/ruin/powered)

(1,1,1) = {"
p
p
p
p
p
p
p
p
p
p
p
p
p
p
p
p
p
p
p
p
p
p
p
p
p
p
p
p
p
p
p
p
p
p
p
p
p
p
p
p
"}
(2,1,1) = {"
p
p
p
p
p
p
p
p
p
p
p
p
p
p
p
p
p
p
p
p
p
p
p
p
p
p
p
p
p
p
p
p
p
p
p
p
p
p
p
p
"}
(3,1,1) = {"
p
p
p
p
p
p
p
p
p
p
p
p
p
p
p
p
p
p
p
p
p
p
p
p
p
p
p
p
p
p
p
p
p
p
p
p
p
p
p
p
"}
(4,1,1) = {"
p
p
p
p
p
p
p
p
p
p
p
p
p
p
p
p
p
p
p
p
p
p
p
p
p
p
p
p
p
p
p
p
p
p
p
p
p
p
p
p
"}
(5,1,1) = {"
p
p
p
p
p
p
p
p
p
p
p
p
p
p
p
p
p
p
p
p
p
p
p
p
p
p
p
p
p
p
p
p
p
p
p
p
p
p
p
p
"}
(6,1,1) = {"
p
p
p
p
p
p
p
p
p
Y
Y
Y
Y
Y
Y
Y
Y
Y
Y
p
p
p
p
p
p
p
p
p
p
p
p
p
p
p
p
p
p
p
p
p
"}
(7,1,1) = {"
p
p
p
p
p
p
p
p
Y
Y
Y
Y
Y
Y
Y
Y
Y
Y
Y
Y
Y
Y
Y
p
p
p
p
p
p
p
p
p
p
p
p
p
p
p
p
p
"}
(8,1,1) = {"
p
p
p
p
p
p
p
Y
Y
Y
Y
Y
Y
Y
Y
Y
Y
Y
Y
Y
Y
Y
Y
Y
Y
Y
p
p
p
p
p
p
p
p
p
p
p
p
p
p
"}
(9,1,1) = {"
p
p
p
p
p
p
p
Y
Y
Y
Y
Y
Y
Y
Y
Y
Y
Y
Y
Y
Y
Y
Y
Y
Y
Y
Y
p
p
p
p
p
p
p
p
p
p
p
p
p
"}
(10,1,1) = {"
p
p
p
p
p
p
Y
Y
Y
Y
Y
Y
Y
Y
Y
Y
Y
Y
Y
Y
Y
Y
Y
Y
Y
Y
Y
Y
Y
p
p
p
p
p
p
p
p
p
p
p
"}
(11,1,1) = {"
p
p
p
p
p
p
Y
Y
Y
Y
Y
Y
Y
Y
Y
Y
Y
Y
Y
Y
Y
Y
Y
Y
Y
Y
Y
Y
Y
Y
Y
p
p
p
p
p
p
p
p
p
"}
(12,1,1) = {"
p
p
p
p
p
Y
Y
Y
Y
Y
Y
Y
Y
Y
Y
Y
Y
Y
Y
Y
Y
Y
Y
Y
Y
Y
Y
Y
Y
Y
Y
Y
p
p
p
p
p
p
p
p
"}
(13,1,1) = {"
p
p
p
p
p
Y
Y
Y
Y
Y
Y
Y
Y
Y
Y
Y
Y
Y
Y
Y
Y
Y
Y
Y
Y
Y
Y
Y
Y
Y
Y
Y
Y
p
p
p
p
p
p
p
"}
(14,1,1) = {"
p
p
p
p
Y
Y
Y
Y
Y
Y
Y
Y
Y
Y
Y
Y
Y
Y
Y
Y
Y
Y
Y
Y
Y
Y
Y
Y
Y
Y
Y
Y
Y
Y
p
p
p
p
p
p
"}
(15,1,1) = {"
p
p
p
p
Y
Y
Y
Y
Y
Y
Y
Y
Y
Y
Y
Y
Y
Y
Y
Y
Y
Y
Y
Y
Y
Y
Y
Y
Y
Y
Y
Y
Y
Y
Y
p
p
p
p
p
"}
(16,1,1) = {"
p
p
p
p
Y
Y
Y
Y
Y
Y
Y
Y
Y
Y
Y
Y
Y
Y
Y
Y
Y
Y
Y
Y
Y
Y
Y
Y
Y
Y
Y
Y
Y
Y
Y
p
p
p
p
p
"}
(17,1,1) = {"
p
p
p
p
Y
Y
Y
Y
Y
Y
Y
Y
Y
Y
Y
Y
Y
Y
Y
Y
Y
Y
Y
Y
Y
Y
Y
Y
Y
Y
Y
Y
Y
Y
Y
Y
p
p
p
p
"}
(18,1,1) = {"
p
p
p
Y
Y
Y
i
i
i
Y
Y
Y
Y
Y
Y
Y
Y
Y
Y
Y
Y
Y
Y
Y
Y
Y
Y
Y
Y
Y
Y
Y
Y
Y
Y
Y
p
p
p
p
"}
(19,1,1) = {"
p
p
p
Y
Y
Y
i
O
i
Y
Y
Y
Y
Y
Y
Y
Y
Y
Y
Y
Y
Y
Y
Y
Y
Y
Y
Y
Y
Y
Y
Y
Y
Y
Y
Y
Y
p
p
p
"}
(20,1,1) = {"
p
p
Y
Y
Y
Y
i
i
i
Y
Y
Y
Y
Y
Y
Y
Y
Y
Y
Y
Y
Y
Y
Y
Y
Y
Y
Y
Y
Y
Y
Y
Y
Y
Y
Y
Y
p
p
p
"}
(21,1,1) = {"
p
p
Y
Y
Y
Y
Y
Y
Y
Y
Y
Y
Y
Y
Y
Y
Y
Y
Y
Y
Y
Y
Y
Y
Y
Y
Y
Y
Y
Y
Y
Y
Y
Y
Y
Y
Y
Y
p
p
"}
(22,1,1) = {"
p
p
Y
Y
Y
Y
Y
Y
Y
Y
Y
Y
Y
Y
Y
Y
Y
Y
Y
Y
Y
Y
Y
Y
Y
Y
Y
Y
Y
Y
Y
Y
Y
Y
Y
Y
Y
Y
Y
p
"}
(23,1,1) = {"
p
p
Y
Y
Y
Y
Y
Y
Y
Y
Y
Y
Y
Y
Y
Y
Y
Y
Y
Y
Y
Y
Y
Y
Y
Y
Y
Y
Y
Y
Y
Y
Y
Y
Y
Y
Y
Y
Y
p
"}
(24,1,1) = {"
p
p
Y
Y
Y
Y
Y
Y
Y
Y
Y
Y
Y
Y
Y
Y
Y
Y
Y
Y
Y
Y
Y
Y
Y
Y
Y
Y
Y
Y
Y
Y
Y
Y
Y
Y
Y
Y
Y
p
"}
(25,1,1) = {"
p
p
p
Y
Y
Y
Y
Y
Y
Y
Y
Y
Y
Y
Y
Y
Y
Y
Y
Y
Y
Y
Y
Y
Y
Y
Y
Y
Y
Y
Y
Y
Y
Y
Y
Y
Y
Y
Y
p
"}
(26,1,1) = {"
p
p
p
Y
Y
Y
Y
Y
Y
Y
Y
Y
Y
Y
Y
Y
Y
Y
Y
Y
Y
Y
Y
Y
Y
Y
Y
Y
Y
Y
Y
Y
Y
Y
Y
Y
Y
Y
Y
p
"}
(27,1,1) = {"
p
p
p
Y
Y
Y
Y
Y
Y
Y
Y
Y
Y
Y
Y
Y
Y
Y
Y
Y
Y
Y
Y
Y
Y
Y
Y
Y
Y
Y
Y
Y
Y
Y
Y
Y
Y
Y
Y
p
"}
(28,1,1) = {"
p
p
p
p
Y
Y
Y
Y
Y
Y
Y
Y
Y
Y
Y
Y
Y
Y
Y
Y
Y
Y
Y
Y
Y
Y
Y
Y
Y
Y
Y
Y
Y
Y
Y
Y
Y
Y
p
p
"}
(29,1,1) = {"
p
p
p
p
p
Y
Y
Y
Y
Y
Y
Y
Y
Y
Y
Y
Y
Y
Y
Y
Y
p
p
Y
Y
Y
Y
Y
p
p
Y
Y
Y
Y
Y
Y
Y
p
p
p
"}
(30,1,1) = {"
p
p
p
p
p
p
Y
Y
Y
Y
Y
Y
Y
Y
Y
Y
Y
Y
Y
Y
p
p
p
p
p
p
p
p
p
p
p
p
Y
Y
Y
Y
p
p
p
p
"}
(31,1,1) = {"
p
p
p
p
p
p
p
p
Y
Y
Y
Y
Y
Y
Y
Y
Y
Y
Y
p
p
p
p
p
p
p
p
p
p
p
p
p
p
Y
Y
p
p
p
p
p
"}
(32,1,1) = {"
p
p
p
p
p
p
p
p
p
p
p
p
p
p
Y
Y
Y
p
p
p
p
p
p
p
p
p
p
p
p
p
p
p
p
p
p
p
p
p
p
p
"}
(33,1,1) = {"
p
p
p
p
p
p
p
p
p
p
p
p
p
p
p
p
p
p
p
p
p
p
p
p
p
p
p
p
p
p
p
p
p
p
p
p
p
p
p
p
"}
(34,1,1) = {"
p
p
p
p
p
p
p
p
p
p
p
p
p
p
p
p
p
p
p
p
p
p
p
p
p
p
p
p
p
p
p
p
p
p
p
p
p
p
p
p
"}
(35,1,1) = {"
p
p
p
p
p
p
p
p
p
p
p
p
p
p
p
p
p
p
p
p
p
p
p
p
p
p
p
p
p
p
p
p
p
p
p
p
p
p
p
p
"}
(36,1,1) = {"
p
p
p
p
p
p
p
p
p
p
p
p
p
p
p
p
p
p
p
p
p
p
p
p
p
p
p
p
p
p
p
p
p
p
p
p
p
p
p
p
"}
(37,1,1) = {"
p
p
p
p
p
p
p
p
p
p
p
p
p
p
p
p
p
p
p
p
p
p
p
p
p
p
p
p
p
p
p
p
p
p
p
p
p
p
p
p
"}
(38,1,1) = {"
p
p
p
p
p
p
p
p
p
p
p
p
p
p
p
p
p
p
p
p
p
p
p
p
p
p
p
p
p
p
p
p
p
p
p
p
p
p
p
p
"}
(39,1,1) = {"
p
p
p
p
p
p
p
p
p
p
p
p
p
p
p
p
p
p
p
p
p
p
p
p
p
p
p
p
p
p
p
p
p
p
p
p
p
p
p
p
"}
(40,1,1) = {"
p
p
p
p
p
p
p
p
p
p
p
p
p
p
p
p
p
p
p
p
p
p
p
p
p
p
p
p
p
p
p
p
p
p
p
p
p
p
p
p
"}
