"aa" = (/turf/template_noop,/area/template_noop)
"ab" = (/turf/closed/mineral,/area/ruin/powered)
"ac" = (/turf/closed/wall/steel,/area/ruin/powered)
"ad" = (/obj/effect/decal/cleanable/blood/old,/obj/effect/decal/cleanable/dirt,/turf/open/floor/monotile/dark,/area/ruin/powered)
"ae" = (/obj/structure/closet/crate/freezer/surplus_limbs,/obj/effect/decal/cleanable/dirt,/turf/open/floor/monotile/dark,/area/ruin/powered)
"af" = (/obj/structure/closet/crate/freezer{name = "cat tails"},/obj/item/organ/tail/cat,/obj/item/organ/tail/cat,/obj/item/organ/tail/cat,/obj/item/organ/tail/cat,/obj/item/organ/tail/cat,/obj/item/organ/tail/cat,/obj/machinery/light/small{dir = 1},/obj/effect/decal/cleanable/dirt,/turf/open/floor/monotile/dark,/area/ruin/powered)
"ag" = (/obj/structure/closet/crate/freezer{name = "cat ears"},/obj/item/organ/ears/cat,/obj/item/organ/ears/cat,/obj/item/organ/ears/cat,/obj/item/organ/ears/cat,/obj/item/organ/ears/cat,/obj/item/organ/ears/cat,/obj/effect/decal/cleanable/dirt,/turf/open/floor/monotile/dark,/area/ruin/powered)
"ah" = (/obj/machinery/atmospherics/components/unary/vent_pump/siphon/atmos{dir = 1; id_tag = "o2_out_cat"; name = "freezer vent"},/obj/structure/closet/crate/freezer{name = "cat hide"},/obj/item/stack/sheet/animalhide/human,/obj/item/stack/sheet/animalhide/human,/obj/item/stack/sheet/animalhide/human,/obj/item/stack/sheet/animalhide/human,/obj/item/stack/sheet/animalhide/human,/obj/item/stack/sheet/animalhide/human,/obj/item/stack/sheet/animalhide/human,/obj/item/stack/sheet/animalhide/human,/obj/item/stack/sheet/animalhide/human,/obj/item/stack/sheet/animalhide/human,/obj/item/stack/sheet/animalhide/human,/obj/effect/decal/cleanable/dirt,/turf/open/floor/monotile/dark,/area/ruin/powered)
"ai" = (/obj/effect/decal/cleanable/dirt,/turf/open/floor/monotile/dark,/area/ruin/powered)
"aj" = (/obj/structure/closet/crate/freezer{name = "cat meat"},/obj/item/reagent_containers/food/snacks/meat/slab/synthmeat{desc = "A slab of cat meat. Tastes like furball."; name = "cat meat"},/obj/item/reagent_containers/food/snacks/meat/slab/synthmeat{desc = "A slab of cat meat. Tastes like furball."; name = "cat meat"},/obj/item/reagent_containers/food/snacks/meat/slab/synthmeat{desc = "A slab of cat meat. Tastes like furball."; name = "cat meat"},/obj/item/reagent_containers/food/snacks/meat/slab/synthmeat{desc = "A slab of cat meat. Tastes like furball."; name = "cat meat"},/obj/item/reagent_containers/food/snacks/meat/slab/synthmeat{desc = "A slab of cat meat. Tastes like furball."; name = "cat meat"},/obj/item/reagent_containers/food/snacks/meat/slab/synthmeat{desc = "A slab of cat meat. Tastes like furball."; name = "cat meat"},/obj/item/reagent_containers/food/snacks/meat/slab/synthmeat{desc = "A slab of cat meat. Tastes like furball."; name = "cat meat"},/obj/item/reagent_containers/food/snacks/meat/slab/synthmeat{desc = "A slab of cat meat. Tastes like furball."; name = "cat meat"},/obj/effect/decal/cleanable/dirt,/turf/open/floor/monotile/dark,/area/ruin/powered)
"ak" = (/obj/machinery/door/airlock/ship/station{name = "Surgery storage"},/turf/open/floor/monotile/dark,/area/ruin/powered)
"al" = (/turf/open/floor/monotile/light,/area/ruin/powered)
"am" = (/obj/effect/spawner/structure/window/reinforced,/obj/machinery/door/poddoor/preopen{id = "anti_dog_door"; name = "feline protection door"},/turf/open/floor/plating,/area/ruin/powered)
"an" = (/obj/effect/decal/cleanable/dirt,/obj/effect/decal/cleanable/dirt,/turf/open/floor/monotile/dark,/area/ruin/powered)
"ao" = (/obj/item/reagent_containers/glass/bowl,/obj/item/reagent_containers/food/snacks/meat/slab/synthmeat{desc = "A slab of cat meat. Tastes like furball."; name = "cat meat"},/obj/machinery/light/small{dir = 1},/obj/effect/decal/cleanable/dirt,/obj/effect/decal/cleanable/dirt,/turf/open/floor/monotile/dark,/area/ruin/powered)
"ap" = (/obj/structure/bed/dogbed{name = "kitty bed"},/obj/effect/mob_spawn/human/corpse/damaged{head = /obj/item/clothing/head/kitty},/obj/effect/decal/cleanable/dirt,/obj/effect/decal/cleanable/dirt,/turf/open/floor/monotile/dark,/area/ruin/powered)
"aq" = (/obj/machinery/door/window/westleft{name = "kitty door"; req_access_txt = "200"},/obj/effect/decal/cleanable/dirt,/obj/effect/decal/cleanable/dirt,/obj/machinery/door/poddoor/preopen{id = "anti_dog_door"; name = "feline protection door"},/turf/open/floor/monotile/dark,/area/ruin/powered)
"ar" = (/obj/structure/closet,/obj/item/clothing/under/costume/maid,/obj/item/clothing/head/kitty,/obj/item/toy/cattoy,/turf/open/floor/plating/asteroid/airless,/area/ruin/powered)
"as" = (/obj/structure/janitorialcart,/obj/effect/decal/cleanable/cobweb/cobweb2,/turf/open/floor/plating/asteroid/airless,/area/ruin/powered)
"at" = (/obj/structure/table/wood,/obj/item/reagent_containers/spray/cleaner,/turf/open/floor/monotile,/area/ruin/powered)
"au" = (/obj/structure/dresser,/obj/machinery/light{dir = 1},/turf/open/floor/monotile,/area/ruin/powered)
"av" = (/obj/structure/closet/cabinet,/obj/item/gps{gpstag = "kitty"},/turf/open/floor/monotile,/area/ruin/powered)
"aw" = (/obj/structure/rack,/obj/item/melee/baton/cattleprod,/obj/item/melee/baton/cattleprod,/obj/item/restraints/handcuffs,/obj/item/restraints/handcuffs,/turf/open/floor/monotile,/area/ruin/powered)
"ax" = (/obj/machinery/light{dir = 8},/obj/machinery/button/door{id = "anti_dog_door"; name = "Emergency Kitty Protection"; pixel_x = -24},/turf/open/floor/monotile/light,/area/ruin/powered)
"ay" = (/mob/living/simple_animal/hostile/cat_butcherer,/turf/open/floor/monotile/light,/area/ruin/powered)
"az" = (/obj/structure/table/optable,/obj/effect/mob_spawn/human/corpse/damaged{head = /obj/item/clothing/head/kitty},/obj/item/organ/ears/cat,/obj/effect/decal/cleanable/blood/old,/turf/open/floor/monotile/light,/area/ruin/powered)
"aA" = (/obj/structure/table/reinforced,/obj/item/clothing/gloves/color/latex,/obj/item/surgical_drapes,/obj/machinery/light{dir = 4},/turf/open/floor/monotile/light,/area/ruin/powered)
"aB" = (/obj/structure/reagent_dispensers/watertank,/turf/open/floor/plating/asteroid/airless,/area/ruin/powered)
"aC" = (/obj/item/mop,/obj/item/reagent_containers/glass/bucket,/turf/open/floor/plating/asteroid/airless,/area/ruin/powered)
"aD" = (/obj/structure/chair/wood/wings{icon_state = "wooden_chair_wings"; dir = 1},/turf/open/floor/monotile,/area/ruin/powered)
"aE" = (/turf/open/floor/monotile,/area/ruin/powered)
"aF" = (/obj/effect/decal/cleanable/blood/old,/obj/item/organ/tail/cat,/turf/open/floor/monotile/light,/area/ruin/powered)
"aG" = (/obj/item/reagent_containers/glass/bowl,/obj/effect/decal/cleanable/dirt,/turf/open/floor/monotile/dark,/area/ruin/powered)
"aH" = (/obj/structure/bed/dogbed{name = "kitty bed"},/obj/effect/decal/cleanable/dirt,/turf/open/floor/monotile/dark,/area/ruin/powered)
"aI" = (/obj/structure/bed/dogbed{name = "kitty bed"},/mob/living/simple_animal/pet/cat/space,/turf/open/floor/monotile,/area/ruin/powered)
"aJ" = (/obj/structure/table/reinforced,/obj/item/retractor,/obj/item/razor,/turf/open/floor/monotile/light,/area/ruin/powered)
"aK" = (/obj/structure/table/reinforced,/obj/item/scalpel{pixel_y = 12},/turf/open/floor/monotile/light,/area/ruin/powered)
"aL" = (/obj/structure/table/reinforced,/obj/item/hemostat,/obj/item/cautery{pixel_x = 4},/turf/open/floor/monotile/light,/area/ruin/powered)
"aM" = (/obj/machinery/door/window/westleft{name = "kitty door"; req_access_txt = "200"},/obj/effect/decal/cleanable/dirt,/obj/machinery/door/poddoor/preopen{id = "anti_dog_door"; name = "feline protection door"},/turf/open/floor/monotile/dark,/area/ruin/powered)
"aN" = (/obj/machinery/light/small,/obj/effect/decal/cleanable/dirt,/turf/open/floor/monotile/dark,/area/ruin/powered)
"aO" = (/obj/structure/table/wood,/obj/item/flashlight/lamp,/turf/open/floor/monotile,/area/ruin/powered)
"aP" = (/obj/structure/bed,/turf/open/floor/monotile,/area/ruin/powered)
"aQ" = (/obj/machinery/door/airlock/ship/public{name = "Private quarters"},/turf/open/floor/monotile,/area/ruin/powered)
"aR" = (/obj/machinery/door/airlock/ship/medical{name = "Surgery"},/turf/open/floor/monotile/light,/area/ruin/powered)
"aS" = (/obj/machinery/door/window/northleft{name = "kitty door"; req_access_txt = "200"},/obj/effect/decal/cleanable/dirt,/obj/machinery/door/poddoor/preopen{id = "anti_dog_door"; name = "feline protection door"},/turf/open/floor/monotile/dark,/area/ruin/powered)
"aT" = (/obj/effect/spawner/structure/window/reinforced,/turf/open/floor/plating,/area/ruin/powered)
"aU" = (/turf/open/floor/plating/asteroid/airless,/area/ruin/powered)
"aV" = (/obj/effect/mapping_helpers/airlock/cyclelink_helper,/obj/machinery/door/airlock/ship/external/glass,/turf/open/floor/plating,/area/ruin/powered)
"aW" = (/obj/machinery/light/small{dir = 8},/obj/effect/decal/cleanable/dirt,/turf/open/floor/monotile/dark,/area/ruin/powered)
"aX" = (/obj/structure/sign/warning/vacuum{pixel_x = 32},/turf/open/floor/plating,/area/ruin/powered)
"aY" = (/obj/effect/mapping_helpers/airlock/cyclelink_helper{dir = 1},/obj/structure/fans/tiny/invisible,/obj/machinery/door/airlock/ship/external/glass,/turf/open/floor/plating,/area/ruin/powered)
"aZ" = (/obj/structure/lattice,/turf/template_noop,/area/template_noop)
"ba" = (/obj/structure/lattice/catwalk,/turf/template_noop,/area/template_noop)

(1,1,1) = {"
aaaaaaaaaaaaaaaaaaaaaaaaaaaaaaaaaaaaaaaaaaaaaaaaaaaaaaaaaaaaaaaaaaaaaaaaaaaaaaaa
aaaaaaaaaaabababaaaaaaaaaaaaaaaaaaaaaaaaaaaaaaaaaaaaaaaaabababababaaaaaaaaaaaaaa
aaaaaaababababababaaaaaaaaaaaaaaaaaaaaaaaaaaaaaaaaaaaaabababababababaaaaaaaaaaaa
aaaaababababababababaaaaaaaaaaaaaaaaaaaaaaaaaaaaaaaaabababababababababaaaaaaaaaa
aaababababababababababaaaaaaaaaaaaaaaaaaaaaaaaaaaaabababababababababababaaaaaaaa
aaababababababababababaaaaaaaaaaaaaaaaaaaaaaaaaaaaabababababababababababaaaaaaaa
aaababababababababababaaaaaaaaaaaaaaaaababaaaaaaaaababababababababababaaaaaaaaaa
aaababababababababababaaaaaaaaaaaaabababababaaaaaaaaababababababababaaaaaaaaaaaa
aaaaababababababababaaaaaaaaaaaaabababababababaaaaaaaaababababababaaaaaaaaaaaaaa
aaaaaaababababababaaaaaaaaaaaaaaababababababababaaaaaaaaababababaaaaaaaaaaaaaaaa
aaaaaaaaaaaaaaaaaaaaaaaaaaaaaaaaabababababababababaaaaaaaaaaaaaaaaaaaaaaaaaaaaaa
aaaaaaaaaaaaaaaaaaaaaaaaaaaaaaaaaaabababababababaaaaaaaaaaaaaaaaaaaaaaaaaaaaaaaa
aaaaaaaaaaaaaaaaaaaaaaaaaaaaaaaaaaaaabababababaaaaaaaaaaaaaaaaaaaaaaaaaaaaaaaaaa
aaaaaaaaaaaaaaaaaaaaaaabababababaaaaaaaaaaaaaaaaaaaaaaaaaaaaaaaaaaaaaaaaaaaaaaaa
aaaaaaaaaaaaaaaaaaababababababababaaaaababababaaaaaaaaaaaaaaaaaaaaaaaaaaaaaaaaaa
aaaaaaaaaaaaaaabababababababababababababababababaaaaaaaaaaaaaaaaaaaaaaaaaaaaaaaa
aaaaaaaaaaaaaaabababababababababababababababababababaaaaaaaaaaaaaaaaaaaaaaaaaaaa
aaaaaaaaaaaaabababababababababababababababababababababaaaaaaaaaaaaaaaaaaaaaaaaaa
aaaaaaaaaaaaabababababababababababababababababababababaaaaaaaaaaaaaaaaaaaaaaaaaa
aaaaaaaaaaabababababababababababababababababababababababaaaaaaaaaaaaaaaaaaaaaaaa
aaaaaaaaaaabababababababababababababababababababababababaaaaaaaaaaaaaaaaaaaaaaaa
aaaaaaaaabababababababababababababababababababababababababaaaaaaaaaaaaaaaaaaaaaa
aaaaaaaaabababababababababababababababababababababababababaaaaaaaaaaaaaaaaaaaaaa
aaaaaaaaabababababababababababababababababababababababababaaaaaaaaaaaaaaaaaaaaaa
aaaaaaabababababababababababababacacacacacacacabababababababaaaaaaaaaaaaaaaaaaaa
aaaaaaabababababababababababababacadaeafagahacabababababababaaaaaaaaaaaaaaaaaaaa
aaaaababababababababababababababacaiaiaiaiajacabababababababaaaaaaaaaaaaaaaaaaaa
aaaaababababababababababababababacakacacacacacacacacacacababaaaaaaaaaaaaaaaaaaaa
aaaaaaabababababababababababababacalalalalalalamanaoapacababaaaaaaaaaaaaaaaaaaaa
aaaaaaaaababababacacacacacacacacacalalalalalalaqanananacababaaaaaaaaaaaaaaaaaaaa
aaaaaaaaababababacarasacatauavawacaxalayazalaAacacacacacababaaaaaaaaaaaaaaaaaaaa
aaaaaaaaaaabababacaBaCacaDaEaEaEacalalaFalalalamaiaGaHacababaaaaaaaaaaaaaaaaaaaa
aaaaaaaaaaaaababacacabacaEaEaIaEacalaJaKaLalalaMaiaNaiacababaaaaaaaaaaaaaaaaaaaa
aaaaaaaaaaaaaaababababacaOaPacaQacaRacacacaSamacacacacacabaaaaaaaaaaaaaaaaaaaaaa
aaaaaaaaaaaaaaaaabababacaTaTacaEaEaEacabacaiaiacabababababaaaaaaaaaaaaaaaaaaaaaa
aaaaaaaaaaaaaaaaaaababaUaUaUacacacaVacabacaWaGacababababaaaaaaaaaaaaaaaaaaaaaaaa
aaaaaaaaaaaaaaaaaaaaaUaUaUaUababacaXacabacaiaHacabababaaaaaaaaaaaaaaaaaaaaaaaaaa
aaaaaaaaaaaaaaaaaaaaaaaaaaaaaUabacaYacabacacacacababaaaaaaaaaaaaaaaaaaaaaaaaaaaa
aaaaaaaaaaaaaaaaaaaaaaaaaaaaaaaaaZbaaZaaaaaaaaaaaaaaaaaaaaaaaaaaaaaaaaaaaaaaaaaa
aaaaaaaaaaaaaaaaaaaaaaaaaaaaaaaaaaaaaaaaaaaaaaaaaaaaaaaaaaaaaaaaaaaaaaaaaaaaaaaa
"}
