//MAP CONVERTED BY dmm2tgm.py THIS HEADER COMMENT PREVENTS RECONVERSION, DO NOT REMOVE
"g" = (
/turf/closed/mineral,
/area/ruin/powered)
"m" = (
/turf/template_noop,
/area/template_noop)
"o" = (
/obj/effect/decal/cleanable/blood/tracks{
	dir = 10
	},
/turf/open/floor/plating/asteroid/snow/airless,
/area/ruin/powered)
"p" = (
/obj/effect/decal/cleanable/blood/tracks{
	dir = 1
	},
/turf/open/floor/plating/asteroid/snow/airless,
/area/ruin/powered)
"q" = (
/obj/effect/decal/cleanable/blood,
/obj/effect/decal/cleanable/blood/gibs/up,
/turf/open/floor/plating/asteroid/snow/airless,
/area/ruin/powered)
"t" = (
/obj/structure/bonfire/prelit,
/turf/open/floor/plating/snowed/colder,
/area/ruin/powered)
"v" = (
/obj/machinery/door/airlock/freezer,
/obj/structure/fans/tiny/invisible,
/turf/open/floor/plating/snowed,
/area/ruin/powered)
"y" = (
/obj/item/clothing/glasses/cold,
/turf/open/floor/plating/snowed/colder,
/area/ruin/powered)
"B" = (
/obj/vehicle/ridden/atv{
	dir = 4
	},
/turf/open/floor/plating/snowed/colder,
/area/ruin/powered)
"C" = (
/turf/open/floor/plating/asteroid/snow/airless,
/area/ruin/powered)
"H" = (
/turf/closed/wall/mineral/snow,
/area/ruin/powered)
"K" = (
/turf/open/floor/plating/snowed/colder,
/area/ruin/powered)
"L" = (
/mob/living/simple_animal/hostile/skeleton/eskimo,
/turf/open/floor/plating/snowed/colder,
/area/ruin/powered)
"T" = (
/obj/effect/decal/cleanable/blood/gibs/limb,
/obj/effect/decal/cleanable/blood/gibs/limb{
	dir = 4
	},
/turf/open/floor/plating/snowed/colder,
/area/ruin/powered)
"Y" = (
/obj/effect/decal/cleanable/blood/tracks{
	dir = 8
	},
/obj/item/key{
	desc = "A small grey key meant to be placed inside a vehicle. There is nothing special about this key at all besides that.";
	name = "ATV key"
	},
/turf/open/floor/plating/asteroid/snow/airless,
/area/ruin/powered)

(1,1,1) = {"
m
m
m
m
m
m
m
m
m
m
m
m
m
m
m
m
m
m
m
m
m
m
m
m
m
m
m
m
m
m
m
m
m
m
m
m
m
m
m
m
"}
(2,1,1) = {"
m
m
m
m
m
m
m
m
m
m
m
m
m
m
m
m
m
m
m
m
m
m
m
m
m
m
m
m
m
m
m
m
m
m
m
m
m
m
m
m
"}
(3,1,1) = {"
m
m
m
m
m
m
m
m
m
m
m
m
m
m
m
m
m
m
m
g
g
g
g
g
g
g
m
m
m
m
m
m
m
m
m
m
m
m
m
m
"}
(4,1,1) = {"
m
m
m
m
m
m
m
m
m
m
m
m
m
m
m
m
m
m
g
g
g
g
g
g
g
g
g
m
m
m
m
m
m
m
m
m
m
m
m
m
"}
(5,1,1) = {"
m
m
m
m
m
m
m
m
m
m
m
m
m
m
m
m
g
g
g
g
g
g
g
g
g
g
g
g
m
m
m
m
m
m
m
m
m
m
m
m
"}
(6,1,1) = {"
m
m
m
m
m
m
m
m
m
m
m
m
m
m
m
m
g
g
g
g
g
g
g
g
g
g
g
g
m
m
m
m
m
m
m
m
m
m
m
m
"}
(7,1,1) = {"
m
m
m
m
m
m
m
m
m
m
m
m
m
g
g
g
g
g
g
g
g
g
g
g
g
g
g
g
g
m
m
m
m
m
m
m
m
m
m
m
"}
(8,1,1) = {"
m
m
m
m
m
m
m
m
m
m
m
m
m
g
g
g
g
g
g
g
g
g
g
g
g
g
g
g
g
m
m
m
m
m
m
m
m
m
m
m
"}
(9,1,1) = {"
m
m
m
m
m
m
m
m
m
m
m
g
g
g
g
g
g
g
g
g
g
g
g
g
g
g
g
g
g
g
m
m
m
m
m
m
m
m
m
m
"}
(10,1,1) = {"
m
m
m
m
m
m
m
m
m
m
g
g
g
g
g
g
g
g
g
g
g
g
g
g
g
g
g
g
g
g
m
m
m
m
m
m
m
m
m
m
"}
(11,1,1) = {"
m
m
m
m
m
m
m
m
m
g
g
C
C
C
g
g
g
g
g
g
g
g
g
g
g
g
g
g
g
g
m
m
m
m
m
m
m
m
m
m
"}
(12,1,1) = {"
m
m
m
m
m
m
m
m
g
g
C
C
H
C
C
g
g
g
g
g
g
g
g
g
g
g
g
g
g
g
g
m
m
m
m
m
m
m
m
m
"}
(13,1,1) = {"
m
m
m
m
m
m
m
g
g
C
C
H
H
H
C
C
g
g
g
g
g
g
g
g
g
g
g
g
g
g
g
g
m
m
m
m
m
m
m
m
"}
(14,1,1) = {"
m
m
m
m
m
m
g
g
C
C
H
H
K
H
H
C
C
C
g
g
g
g
g
g
g
g
g
g
g
g
g
g
m
m
m
m
m
m
m
m
"}
(15,1,1) = {"
m
m
m
m
m
m
g
g
C
H
H
K
K
K
H
H
C
C
C
g
g
g
g
g
g
g
g
g
g
g
g
g
m
m
m
m
m
m
m
m
"}
(16,1,1) = {"
m
m
m
m
m
g
g
g
C
H
K
L
T
K
K
H
C
C
C
g
g
g
g
g
g
g
g
g
g
g
g
g
m
m
m
m
m
m
m
m
"}
(17,1,1) = {"
m
m
m
m
m
g
g
g
C
H
K
K
t
K
K
v
p
o
C
g
g
g
g
g
g
g
g
g
g
g
g
g
m
m
m
m
m
m
m
m
"}
(18,1,1) = {"
m
m
m
m
m
g
g
g
C
H
B
y
K
K
K
H
C
Y
C
g
g
g
g
g
g
g
g
g
g
g
g
g
m
m
m
m
m
m
m
m
"}
(19,1,1) = {"
m
m
m
m
m
g
g
g
C
H
H
K
K
K
H
H
C
q
C
g
g
g
g
g
g
g
g
g
g
g
g
g
m
m
m
m
m
m
m
m
"}
(20,1,1) = {"
m
m
m
m
m
g
g
g
C
C
H
H
L
H
H
C
C
C
g
g
g
g
g
g
g
g
g
g
g
g
g
g
m
m
m
m
m
m
m
m
"}
(21,1,1) = {"
m
m
m
m
m
g
g
g
g
C
C
H
H
H
C
C
g
g
g
g
g
g
g
g
g
g
g
g
g
g
g
m
m
m
m
m
m
m
m
m
"}
(22,1,1) = {"
m
m
m
m
m
m
g
g
g
g
C
C
H
C
C
g
g
g
g
g
g
g
g
g
g
g
g
g
g
g
m
m
m
m
m
m
m
m
m
m
"}
(23,1,1) = {"
m
m
m
m
m
m
g
g
g
g
g
C
C
C
g
g
g
g
g
g
g
g
g
g
g
g
g
g
g
g
m
m
m
m
m
m
m
m
m
m
"}
(24,1,1) = {"
m
m
m
m
m
m
m
g
g
g
g
g
g
g
g
g
g
g
g
g
g
g
g
g
g
g
g
g
g
m
m
m
m
m
m
m
m
m
m
m
"}
(25,1,1) = {"
m
m
m
m
m
m
m
g
g
g
g
g
g
g
g
g
g
g
g
g
g
g
g
g
g
g
g
g
g
m
m
m
m
m
m
m
m
m
m
m
"}
(26,1,1) = {"
m
m
m
m
m
m
m
m
g
g
g
g
g
g
g
g
g
g
g
g
g
g
g
g
g
g
g
g
m
m
m
m
m
m
m
m
m
m
m
m
"}
(27,1,1) = {"
m
m
m
m
m
m
m
m
g
g
g
g
g
g
g
g
g
g
g
g
g
g
g
g
g
g
g
g
m
m
m
m
m
m
m
m
m
m
m
m
"}
(28,1,1) = {"
m
m
m
m
m
m
m
m
m
g
g
g
g
g
g
g
g
g
g
g
g
g
g
g
g
g
g
m
m
m
m
m
m
m
m
m
m
m
m
m
"}
(29,1,1) = {"
m
m
m
m
m
m
m
m
m
m
g
g
g
g
g
g
g
g
g
g
g
g
g
g
g
g
g
m
m
m
m
m
m
m
m
m
m
m
m
m
"}
(30,1,1) = {"
m
m
m
m
m
m
m
m
m
m
m
g
g
g
g
g
g
g
g
g
g
g
g
g
g
g
g
m
m
m
m
m
m
m
m
m
m
m
m
m
"}
(31,1,1) = {"
m
m
m
m
m
m
m
m
m
m
m
g
g
g
g
g
g
g
g
g
g
g
g
g
g
g
m
m
m
m
m
m
m
m
m
m
m
m
m
m
"}
(32,1,1) = {"
m
m
m
m
m
m
m
m
m
m
m
m
g
g
g
g
g
g
g
g
g
g
g
g
m
m
m
m
m
m
m
m
m
m
m
m
m
m
m
m
"}
(33,1,1) = {"
m
m
m
m
m
m
m
m
m
m
m
m
m
m
g
g
g
g
g
g
g
g
m
m
m
m
m
m
m
m
m
m
m
m
m
m
m
m
m
m
"}
(34,1,1) = {"
m
m
m
m
m
m
m
m
m
m
m
m
m
m
m
m
m
m
m
m
m
m
m
m
m
m
m
m
m
m
m
m
m
m
m
m
m
m
m
m
"}
(35,1,1) = {"
m
m
m
m
m
m
m
m
m
m
m
m
m
m
m
m
m
m
m
m
m
m
m
m
m
m
m
m
m
m
m
m
m
m
m
m
m
m
m
m
"}
(36,1,1) = {"
m
m
m
m
m
m
m
m
m
m
m
m
m
m
m
m
m
m
m
m
m
m
m
m
m
m
m
m
m
m
m
m
m
m
m
m
m
m
m
m
"}
(37,1,1) = {"
m
m
m
m
m
m
m
m
m
m
m
m
m
m
m
m
m
m
m
m
m
m
m
m
m
m
m
m
m
m
m
m
m
m
m
m
m
m
m
m
"}
(38,1,1) = {"
m
m
m
m
m
m
m
m
m
m
m
m
m
m
m
m
m
m
m
m
m
m
m
m
m
m
m
m
m
m
m
m
m
m
m
m
m
m
m
m
"}
(39,1,1) = {"
m
m
m
m
m
m
m
m
m
m
m
m
m
m
m
m
m
m
m
m
m
m
m
m
m
m
m
m
m
m
m
m
m
m
m
m
m
m
m
m
"}
(40,1,1) = {"
m
m
m
m
m
m
m
m
m
m
m
m
m
m
m
m
m
m
m
m
m
m
m
m
m
m
m
m
m
m
m
m
m
m
m
m
m
m
m
m
"}
