//MAP CONVERTED BY dmm2tgm.py THIS HEADER COMMENT PREVENTS RECONVERSION, DO NOT REMOVE
"g" = (
/turf/closed/wall/r_wall,
/area/ruin/powered)
"h" = (
/turf/closed/mineral,
/area/ruin/powered)
"C" = (
/obj/effect/mine/sound/bwoink{
	opacity = 255
	},
/turf/closed/mineral,
/area/ruin/powered)
"E" = (
/turf/open/space/basic,
/area/space)

(1,1,1) = {"
E
E
E
E
E
E
E
E
E
E
E
E
E
E
E
E
E
E
E
E
E
E
E
E
E
E
E
E
E
E
E
E
E
E
E
E
E
E
E
E
"}
(2,1,1) = {"
E
E
E
E
E
E
E
E
E
E
E
E
E
E
E
E
E
E
E
E
E
E
E
E
E
E
E
E
E
E
E
E
E
E
E
E
E
E
E
E
"}
(3,1,1) = {"
E
E
E
E
E
E
E
E
E
E
E
E
E
E
E
E
E
E
E
E
E
E
E
E
E
E
E
E
E
E
E
E
E
E
E
E
E
E
E
E
"}
(4,1,1) = {"
E
E
E
E
E
E
E
E
E
E
E
E
E
E
E
E
E
h
h
h
h
E
E
E
E
E
E
E
E
E
E
E
E
E
E
E
E
E
E
E
"}
(5,1,1) = {"
E
E
E
E
E
E
E
E
E
E
E
E
E
E
h
h
h
h
h
h
h
h
h
E
E
E
E
E
E
E
E
E
E
E
E
E
E
E
E
E
"}
(6,1,1) = {"
E
E
E
E
E
E
E
E
E
E
E
E
E
h
h
h
h
h
C
h
h
h
h
h
h
E
E
E
E
E
E
E
E
E
E
E
E
E
E
E
"}
(7,1,1) = {"
E
E
E
E
E
E
E
E
E
E
E
E
h
h
h
h
h
h
h
h
h
h
h
h
h
h
h
E
E
E
E
E
E
E
E
E
E
E
E
E
"}
(8,1,1) = {"
E
E
E
E
E
E
E
E
E
E
E
h
h
h
h
h
h
h
h
h
h
h
h
h
h
h
h
h
h
E
E
E
E
E
E
E
E
E
E
E
"}
(9,1,1) = {"
E
E
E
E
E
E
E
E
E
h
h
h
h
h
h
h
h
h
h
h
h
h
h
h
h
h
h
h
h
h
h
E
E
E
E
E
E
E
E
E
"}
(10,1,1) = {"
E
E
E
E
E
E
E
E
h
h
h
h
h
h
h
h
h
h
h
h
h
h
h
h
h
h
C
g
h
h
h
E
E
E
E
E
E
E
E
E
"}
(11,1,1) = {"
E
E
E
E
E
E
E
h
h
h
h
h
h
h
g
h
h
g
g
h
h
h
h
h
h
g
g
h
g
h
h
h
E
E
E
E
E
E
E
E
"}
(12,1,1) = {"
E
E
E
E
E
E
h
h
h
h
C
h
h
g
h
h
g
h
h
g
h
h
h
h
h
g
h
h
h
g
h
h
E
E
E
E
E
E
E
E
"}
(13,1,1) = {"
E
E
E
E
E
h
h
h
h
h
h
h
g
h
h
g
g
h
h
g
g
h
h
h
h
g
h
h
h
g
g
h
h
E
E
E
E
E
E
E
"}
(14,1,1) = {"
E
E
E
E
E
h
h
h
h
h
h
h
g
h
h
g
h
h
h
h
g
h
h
h
h
g
g
g
g
g
g
C
h
E
E
E
E
E
E
E
"}
(15,1,1) = {"
E
E
E
E
h
h
h
h
h
h
h
h
g
h
h
g
g
h
h
g
g
h
h
h
h
g
h
h
h
g
h
g
h
h
h
E
E
E
E
E
"}
(16,1,1) = {"
E
E
E
E
h
h
h
h
h
h
h
C
g
h
h
h
g
h
h
g
h
h
h
h
h
g
h
h
h
g
h
g
h
h
h
E
E
E
E
E
"}
(17,1,1) = {"
E
E
E
E
h
h
h
h
h
h
h
h
h
g
h
h
h
g
g
h
h
h
h
h
h
g
g
g
g
g
h
g
g
h
h
E
E
E
E
E
"}
(18,1,1) = {"
E
E
E
E
h
h
h
h
h
h
h
h
h
h
g
h
h
h
h
h
h
h
h
h
h
g
h
h
h
g
h
g
g
h
h
h
E
E
E
E
"}
(19,1,1) = {"
E
E
E
E
h
h
h
h
h
h
h
h
h
h
h
h
h
h
h
h
h
h
h
h
h
g
h
h
h
g
h
g
h
g
h
h
E
E
E
E
"}
(20,1,1) = {"
E
E
E
E
h
h
h
h
h
h
h
h
h
h
h
h
h
h
h
h
h
h
h
h
C
g
g
g
g
g
h
g
g
g
h
h
E
E
E
E
"}
(21,1,1) = {"
E
E
E
E
h
h
h
h
h
h
h
h
h
h
h
h
h
h
h
C
g
g
C
g
h
g
h
h
h
g
h
g
h
h
g
h
E
E
E
E
"}
(22,1,1) = {"
E
E
E
E
h
h
h
h
h
h
h
h
h
h
h
h
h
h
h
h
h
h
g
h
h
g
h
h
h
g
h
g
h
h
g
h
h
E
E
E
"}
(23,1,1) = {"
E
E
E
E
h
h
h
h
h
h
h
h
h
h
h
h
h
h
h
h
h
h
h
h
h
g
g
g
g
g
h
g
g
g
g
h
h
E
E
E
"}
(24,1,1) = {"
E
E
E
E
h
h
h
h
h
h
h
h
h
h
g
h
h
g
g
h
h
h
h
h
h
g
h
h
h
g
h
g
h
h
g
h
h
E
E
E
"}
(25,1,1) = {"
E
E
E
E
h
h
h
h
h
h
h
h
h
g
h
C
g
h
h
g
h
h
h
h
h
g
h
h
h
g
h
g
h
h
g
h
h
E
E
E
"}
(26,1,1) = {"
E
E
E
E
E
h
h
h
h
h
h
h
g
h
h
h
g
h
h
g
h
h
h
h
h
g
g
g
g
g
h
g
g
g
g
h
h
E
E
E
"}
(27,1,1) = {"
E
E
E
E
E
h
h
h
h
h
h
h
g
h
h
g
h
h
h
h
g
h
h
h
h
g
h
h
h
g
h
g
h
h
g
C
h
E
E
E
"}
(28,1,1) = {"
E
E
E
E
E
h
h
h
h
h
h
C
g
h
h
g
h
h
h
h
g
h
h
h
h
g
h
h
h
g
h
g
h
h
g
h
h
E
E
E
"}
(29,1,1) = {"
E
E
E
E
E
h
h
h
h
h
h
h
g
h
h
h
g
h
h
g
C
h
h
h
h
g
g
g
g
g
h
g
g
g
g
h
h
E
E
E
"}
(30,1,1) = {"
E
E
E
E
E
E
h
h
h
h
h
h
h
g
h
h
g
h
h
g
h
h
h
h
h
g
h
h
h
g
h
g
h
g
h
h
h
h
E
E
"}
(31,1,1) = {"
E
E
E
E
E
E
h
h
h
h
h
h
h
h
g
h
h
g
g
h
h
h
h
h
h
g
h
h
h
g
g
g
g
g
h
h
h
h
E
E
"}
(32,1,1) = {"
E
E
E
E
E
E
E
h
h
h
h
h
h
h
h
h
h
h
h
h
h
h
h
h
h
g
g
g
g
g
g
C
h
h
h
h
h
h
E
E
"}
(33,1,1) = {"
E
E
E
E
E
E
E
h
h
h
h
h
h
h
h
h
h
h
C
h
h
h
h
h
h
h
h
h
h
h
h
h
h
h
h
h
h
h
E
E
"}
(34,1,1) = {"
E
E
E
E
E
E
E
E
h
h
h
h
h
h
h
h
h
h
h
h
h
h
h
h
h
h
h
h
h
h
h
h
h
h
h
C
h
E
E
E
"}
(35,1,1) = {"
E
E
E
E
E
E
E
E
E
h
h
h
h
h
h
h
h
h
h
h
h
h
h
h
h
h
h
h
h
h
h
h
h
h
h
h
E
E
E
E
"}
(36,1,1) = {"
E
E
E
E
E
E
E
E
E
E
h
h
h
h
h
h
h
h
h
h
h
h
h
h
h
h
h
h
h
h
h
h
h
h
h
E
E
E
E
E
"}
(37,1,1) = {"
E
E
E
E
E
E
E
E
E
E
E
E
h
h
h
h
h
h
h
h
h
h
h
h
C
h
h
h
h
h
h
h
h
E
E
E
E
E
E
E
"}
(38,1,1) = {"
E
E
E
E
E
E
E
E
E
E
E
E
E
E
E
E
E
E
h
h
h
h
h
h
h
h
h
h
E
E
E
E
E
E
E
E
E
E
E
E
"}
(39,1,1) = {"
E
E
E
E
E
E
E
E
E
E
E
E
E
E
E
E
E
E
E
E
E
E
E
E
E
E
E
E
E
E
E
E
E
E
E
E
E
E
E
E
"}
(40,1,1) = {"
E
E
E
E
E
E
E
E
E
E
E
E
E
E
E
E
E
E
E
E
E
E
E
E
E
E
E
E
E
E
E
E
E
E
E
E
E
E
E
E
"}
