"a" = (/turf/template_noop,/area/template_noop)
"b" = (/turf/closed/mineral,/area/ruin/powered)
"c" = (/turf/closed/wall/ship,/area/ruin/powered)
"d" = (/obj/structure/girder,/turf/open/floor/plating/airless,/area/ruin/powered)
"e" = (/turf/open/floor/plating/airless,/area/ruin/powered)
"f" = (/obj/structure/closet/crate,/obj/effect/spawner/lootdrop/maintenance/three,/turf/open/floor/plating/airless,/area/ruin/powered)
"g" = (/obj/machinery/light/small{dir = 1},/turf/open/floor/plating/airless,/area/ruin/powered)
"h" = (/obj/structure/closet/crate,/obj/item/stack/spacecash/c10,/turf/open/floor/plating/airless,/area/ruin/powered)
"i" = (/obj/structure/closet/crate/secure/engineering,/obj/item/organ/cyberimp/brain/anti_stun,/obj/item/organ/cyberimp/arm/toolset,/obj/item/organ/cyberimp/eyes/hud/medical,/turf/open/floor/plating/airless,/area/ruin/powered)
"j" = (/obj/structure/shuttle/engine/heater{dir = 4},/obj/structure/window/reinforced{dir = 8},/turf/open/floor/plating/airless,/area/ruin/powered)
"k" = (/obj/structure/shuttle/engine/propulsion/burst{dir = 4},/turf/open/floor/plating/airless,/area/ruin/powered)
"l" = (/obj/structure/closet/crate/wooden,/obj/effect/spawner/lootdrop/maintenance/three,/obj/effect/spawner/lootdrop/maintenance/three,/turf/open/floor/plating/airless,/area/ruin/powered)
"m" = (/obj/structure/grille/broken,/turf/open/floor/plating/airless,/area/ruin/powered)
"n" = (/obj/structure/table_frame,/turf/open/floor/plating/airless,/area/ruin/powered)
"o" = (/obj/structure/chair/comfy/shuttle{dir = 8},/turf/open/floor/plating/airless,/area/ruin/powered)
"p" = (/obj/machinery/light/small{dir = 4},/turf/open/floor/plating/airless,/area/ruin/powered)
"q" = (/obj/machinery/button/door{id = "asteroid_stuck";name = "Cargo Blast Door Control";pixel_y = -24},/obj/structure/closet/crate,/obj/effect/spawner/lootdrop/maintenance/three,/turf/open/floor/plating/airless,/area/ruin/powered)
"r" = (/obj/structure/closet/crate,/obj/item/stack/spacecash/c10,/obj/effect/spawner/lootdrop/maintenance/three,/turf/open/floor/plating/airless,/area/ruin/powered)
"s" = (/obj/structure/closet/crate,/obj/item/stack/spacecash/c200,/obj/item/stack/spacecash/c200,/turf/open/floor/plating/airless,/area/ruin/powered)
"t" = (/obj/machinery/light/small,/obj/structure/closet/crate,/obj/effect/spawner/lootdrop/maintenance/three,/turf/open/floor/plating/airless,/area/ruin/powered)
"u" = (/obj/machinery/door/poddoor{id = "asteroid_stuck";name = "Cargo Blast Door"},/turf/open/floor/plating/airless,/area/ruin/powered)
"v" = (/turf/open/floor/plating/asteroid/airless,/area/ruin/powered)

(1,1,1) = {"
aaaaaaaaaaaaaaaaaaaaaaaaaaaaaaaaaaaaaaaa
aaaaabbaaaaaaaaaaaaaaaaaaaaaaaabbbaaaaaa
aaaabbbbaaaaaaaaaaaaaaaaaaaaaabbbbbaaaaa
aaabbbbbbaaaaaaaaaaaaaaaaaaaabbbbbbbaaaa
aabbbbbbbbaaaaaaaaaaaaaaaaaabbbbbbbbbaaa
aaabbbbbbbbaaaaaaaaaaaaaaaabbbbbbbbbbbaa
aaaabbbbbbbaaaaaaaaaaaaaaaaabbbbbbbbbbaa
aaaabbbbbbaaaaaaaaaaaaaaaaaaabbbbbbbbaaa
aaaaabbbbaaaaaaaaaaaaaaaaaaabbbbbbbbaaaa
aaaaaabbaaaaaaaaaaaaaaaaaaaaabbbbbbaaaaa
aaaaaaaaaaaaaaaaaaaaaaaaaaaaaabbbbbaaaaa
aaaaaaaaaaaaaaaaaaaaaaaaaaaaaaabbbaaaaaa
aaaabbbaaaaaaaaabbbaaaaaaaaaaaaaaaaaaaaa
aaabbbbbaaaaaaabbbbbaabbbaaaaaaaaaaaaaaa
abbbbbbbbaaaabbbbbbbbbbbbbaaaaaaaaaaaaaa
abbbbbbbbaabbbbbbbbbbbbbbbbbaaaaaaaaaaaa
aabbbbbbaabbbbbbbbbbbbbbbbbbbaaaaaaaaaaa
aaabbbbaaabbbbbbbbbbbbbbbbbbbbaaaaaaaaaa
aaaaaaaaabbbbbbbbbbbbbbbbbbbbbbaaaaaaaaa
aaaaaaaabbbbbbbbbbbbbbbbbbbbbbbbaaaaaaaa
aaaaaaaabbbbbbbbbbbbbbbbbbbbbbbbbaaaaaaa
aaaaaaabbbbbbbbbbbbbbbbccccdccccccaaaaaa
aaaaaaabbbbbbbbbbbbbbbbeecfegffhijkaaaaa
aaaaaabbbbbbbbbbbbbbbbbeeeeeefffljkaaaaa
aaaaaabbbbbbbbbbbbbbbmnopceeffhffjkaaaaa
aaaaabbbbbbbbbbbbbbbbcceecqerfstfjkaaaaa
aaaaabbbbbbbbbbbbbbbbbbccccuuuccccaaaaaa
aaaabbbbbbbbbbbbbbbbbbbbbbbbbvvvaaaaaaaa
aaaabbbbbbbbbbbbbbbbbbbbbbbbbbvvaaaaaaaa
aaaabbbbbbbbbbbbbbbbbbbbbbbbbbbbaaaaaaaa
aaaaabbbbbbbbbbbbbbbbbbbbbbbbbbaaaaaaaaa
aaaaabbbbbbbbbbbbbbbbbbbbbbbbbaaaaaaaaaa
aaaaaabbbbbbbbbbbbbbbbbbbbbbaaaaabbaaaaa
aaaaaaabbbbbbbbbbbbbbbbbbbbaaaaabbbbaaaa
aaaaaaaabbbbbbbbbbbbbbbbbbaaaaabbbbbbaaa
aaaaaaaaabbbbbbbbbbbbbbaaaaaaabbbbbbbaaa
aaaaaaaaaaaabbbbbbbbbbaaaaaaaabbbbbbaaaa
aaaaaaaaaaaaaaaaaaaaaaaaaaaaaaabbbbbaaaa
aaaaaaaaaaaaaaaaaaaaaaaaaaaaaaaaabbaaaaa
aaaaaaaaaaaaaaaaaaaaaaaaaaaaaaaaaaaaaaaa
"}
