"a" = (/turf/open/space/basic,/area/space)
"i" = (/turf/closed/mineral,/area/ruin/powered)
"s" = (/turf/open/floor/plating/asteroid{initial_gas_mix = "plasma=10000;TEMP=293.15"},/area/ruin/powered)

(1,1,1) = {"
aaaaaaaaaaaaaaaaaaaaaaaaaaaaaaaaaaaaaaaa
aaaaaaaaaaaaaaaaaaaaaaaaaaaaaaaaaaaaaaaa
aaaaaaaaaaaaaaaaaaaaaaaaaaaaaaaaaaaaaaaa
aaaaaaaaaaaaaaaaaaaaaaaaaaaaaaaaaaaaaaaa
aaaaaaaaaaaaaaaaaaaaaaaaaaaaaaaaaaaaaaaa
aaaaaaaaaaaaiiiiiiaaaiiiiiiaaaaaaaaaaaaa
aaaaaaaaaaiiiiiiiiiiiisiiiiiaaaaaaaaaaaa
aaaaaaaaaiiiissiiiiiiissssiiiiiiiaaaaaaa
aaaaaaaaiiiiisssiiiiiiiiissiiiisiiaaaaaa
aaaaaaaaisiiiiiiiiiiiiiiiiiiiiissiiaaaaa
aaaaaaaaisisiiiiiiiiiiiiiiiiiiissiiiaaaa
aaaaaaaiisisiiiiiiiiiiiiiiiiiiiisiiiaaaa
aaaaaaiiisssiiiiiiiiiiiiiiiiiiiiiiiiaaaa
aaaaaaiiisisiiiiiiiiiiiiiiiiiiiiiiiiaaaa
aaaaaaiissiiiiiiiiiiiiiiiiiiiiiiiiiiaaaa
aaaaaaiiisiiiiiiiiiiiiiiiiiiiiiiiiiiaaaa
aaaaaiisssssiiiiiiiiiiiiiiiiiiiiiiiiaaaa
aaaaaiiiisisiiiiiiiiiiiiiiiiiiisiiiiaaaa
aaaaiiiiiiiiiiiiiiiiiiiiiiiiiiisiiiiaaaa
aaaiiiiiiiiiiiiiiiiiiiiiiiiiiiisiiiaaaaa
aaaiiiiiiiiiiiiiiiiiiiiiiiiiiisssiiiaaaa
aaaiiiiiiiiiiiiiiiiiiiiiiiiiisssiiiiaaaa
aaaaiiiiiiiiiiiiiiiiiiiiiiiiiissiiiiaaaa
aaaiiissiiiiiiiiiiiiiiiiiiiiiiisiiiiaaaa
aaaiissiiiiiiiiiiiiiiiiiiiiiiiiiiiiaaaaa
aaaiiisiiiiiiiiiiiiiiiiiiiiiiiiiiiaaaaaa
aaaiiiiiiiiiiiiiiiiiiiiiiiiiiiiiiaaaaaaa
aaaaiiiiiiiiiiiiiiiiiiiiiiiiiiiiaaaaaaaa
aaaaaiiiiiiiiiiissiiiiiiiiiiiiiaaaaaaaaa
aaaaaaaaiiiiiiiisssiiiiiiiiiiaaaaaaaaaaa
aaaaaaaaaiiiiiiiiiiiiiiiiiiiaaaaaaaaaaaa
aaaaaaaaaaiiiiiiiiiiiiiiiaaaaaaaaaaaaaaa
aaaaaaaaaaaaaiiiiiiiiiaaaaaaaaaaaaaaaaaa
aaaaaaaaaaaaaaaiiiiiiaaaaaaaaaaaaaaaaaaa
aaaaaaaaaaaaaaaaaaaaaaaaaaaaaaaaaaaaaaaa
aaaaaaaaaaaaaaaaaaaaaaaaaaaaaaaaaaaaaaaa
aaaaaaaaaaaaaaaaaaaaaaaaaaaaaaaaaaaaaaaa
aaaaaaaaaaaaaaaaaaaaaaaaaaaaaaaaaaaaaaaa
aaaaaaaaaaaaaaaaaaaaaaaaaaaaaaaaaaaaaaaa
aaaaaaaaaaaaaaaaaaaaaaaaaaaaaaaaaaaaaaaa
"}
