"a" = (/obj/structure/mineral_door/wood,/turf/open/floor/carpet/ship/beige_carpet{color = "#CC8899";name = "nanoweave carpet (puce)"},/area/ruin/powered)
"j" = (/turf/open/floor/plating/asteroid,/area/ruin/powered)
"q" = (/turf/template_noop,/area/template_noop)
"u" = (/turf/closed/mineral,/area/ruin/powered)
"I" = (/turf/closed/wall/mineral/wood,/area/ruin/powered)
"L" = (/turf/open/floor/carpet/ship/beige_carpet{color = "#CC8899";name = "nanoweave carpet (puce)"},/area/ruin/powered)
"S" = (/obj/structure/table/wood/fancy/royalblack,/turf/open/floor/carpet/ship/beige_carpet{color = "#CC8899";name = "nanoweave carpet (puce)"},/area/ruin/powered)
"U" = (/obj/item/hilbertshotel,/obj/structure/table/wood/fancy/royalblack,/turf/open/floor/carpet/ship/beige_carpet{color = "#CC8899";name = "nanoweave carpet (puce)"},/area/ruin/powered)
"X" = (/obj/structure/statue/uranium/nuke,/turf/open/floor/carpet/ship/beige_carpet{color = "#CC8899";name = "nanoweave carpet (puce)"},/area/ruin/powered)
"Z" = (/obj/structure/statue/diamond/captain,/turf/open/floor/carpet/ship/beige_carpet{color = "#CC8899";name = "nanoweave carpet (puce)"},/area/ruin/powered)

(1,1,1) = {"
qqqqqqqqqqqqqqqqqqqqqqqqqqqqqqqqqqqqqqqq
qqqqqqqqqqqqqqqqqqqqqqqqqqqqqqqqqqqqqqqq
qqqqqqqqqqqqqqqqqqqqqqqqqqqqqqqqqqqqqqqq
qqqqqquuuuuuqqqqqqqqqqqqqqqqqqqqqqqqqqqq
qqqquuuuuuuuuqqqqqqqqqqqqqqqqqqqqqqqqqqq
qqqquuuuuuuuuqqqqqqqquuuuuuqqqqqqqqqqqqq
qqquuuuuuuuuuqqqqqquuIIIIIIuuuuqqqqqqqqq
qqquuuuuuuuuqqqqqquuuIXUSZIuuuuuuqqqqqqq
qquuuuuuuuuuqqqquuuuuILLLLIuuuuuuuqqqqqq
qquuuuuuuuuqqqqquuuuuILLLLIuuuuuuuqqqqqq
qquuuuuuuuqqqqquuuuuuILLLLIuuuuuuuqqqqqq
qqquuuuuuuqqqquuuuuuuILLLLIuuuuuuuqqqqqq
qqquuuuuuqqqqquuuuuuuILLLLIuuuuuuuqqqqqq
qqqquuuuuqqqqquuuuuuuILLLLIuuuuuuuqqqqqq
qqqqquuuuqqqqquuuuuuuIIaaIIuuuuuuuqqqqqq
qqqqqqquqqqqquuuuuuuuujjjjuuuuuuuuqqqqqq
qqqqqqqqqqqqquuuuuuuuuuuuuuuuuuuuuqqqqqq
qqqqqqqqqqqqquuuuuuuuuuuuuuuuuuuuuqqqqqq
qqqqqqqqqqqqquuuuuuuuuuuuuuuuuuuuuqqqqqq
qqqqqqqqqqqqquuuuuuuuuuuuuuuuuuuuqqqqqqq
qqqqqqqqqqqqquuuuuuuuuuuuuuuuuuuuqqqqqqq
qqqqqqqqqqqqquuuuuuuuuuuuuuuuuuuqqqqqqqq
qqqqqqqqqqqqquuuuuuuuuuuuuuuuuqqqqqqqqqq
qqqqqqqqqqqqquuuuuuuuuuuuuuuuuqqqqqqqqqq
qqqqqqqqqqqquuuuuuuuuuuuuuuuqqqqqqqqqqqq
qqqqqqqqqqqquuuuuuuuuuuuuuuqqqqqqqqqqqqq
qqqqqqqqqqqquuuuuuuuuuuuuuqqqqqqqqqqqqqq
qqqqqqqqqqqqquuuuuuuuuuuuqqqqqqqqqqqqqqq
qqqqqqqqqqqqqquuuuuuuuuuqqqqqqqqqqqqqqqq
qqqqqqqqqqqqqqquuuuuuuuqqqqqqqqqqqqqqqqq
qqqqqqqqqqqqqqqqquuuuuuqqqqqqqqqqqqqqqqq
qqqqqqqqqqqqqqqqqqquuuqqqqqqqqqqqqqqqqqq
qqqqqqqqqqqqqqqqqqqqqqqqqqqqqqqqqqqqqqqq
qqqqqqqqqqqqqqqqqqqqqqqqqqqqqqqqqqqqqqqq
qqqqqqqqqqqqqqqqqqqqqqqqqqqqqqqqqqqqqqqq
qqqqqqqqqqqqqqqqqqqqqqqqqqqqqqqqqqqqqqqq
qqqqqqqqqqqqqqqqqqqqqqqqqqqqqqqqqqqqqqqq
qqqqqqqqqqqqqqqqqqqqqqqqqqqqqqqqqqqqqqqq
qqqqqqqqqqqqqqqqqqqqqqqqqqqqqqqqqqqqqqqq
qqqqqqqqqqqqqqqqqqqqqqqqqqqqqqqqqqqqqqqq
"}
