//MAP CONVERTED BY dmm2tgm.py THIS HEADER COMMENT PREVENTS RECONVERSION, DO NOT REMOVE
"a" = (
/obj/item/cardboard_cutout{
	desc = "At closer inspection, this is infact just a cardboard cutout with LEDs glued on.";
	icon = 'icons/mob/swarmer.dmi';
	icon_state = "trap";
	name = "swarmer trap"
	},
/obj/item/grown/bananapeel/bluespace{
	alpha = 25
	},
/turf/open/floor/plating/asteroid,
/area/ruin/powered)
"b" = (
/turf/template_noop,
/area/template_noop)
"c" = (
/obj/item/cardboard_cutout{
	desc = "At closer inspection, this is infact just a cardboard cutout with LEDs glued on.";
	icon = 'icons/mob/swarmer.dmi';
	icon_state = "trap";
	name = "swarmer trap"
	},
/obj/item/grown/bananapeel/bluespace{
	alpha = 25
	},
/turf/open/floor/mineral/plastitanium/red{
	initial_gas_mix = "o2=22;n2=82;TEMP=293.15"
	},
/area/ruin/powered)
"g" = (
/obj/item/cardboard_cutout{
	desc = "At closer inspection, this is infact just a cardboard cutout with LEDs glued on.";
	icon = 'icons/mob/swarmer.dmi';
	icon_state = "swarmer";
	name = "swarmer"
	},
/turf/open/floor/mineral/plastitanium/red{
	initial_gas_mix = "o2=22;n2=82;TEMP=293.15"
	},
/area/ruin/powered)
"p" = (
/obj/item/cardboard_cutout{
	desc = "At closer inspection, this is infact just a cardboard cutout with LEDs glued on.";
	icon = 'icons/mob/swarmer.dmi';
	icon_state = "barricade";
	name = "swarmer barricade"
	},
/turf/open/floor/mineral/plastitanium/red{
	initial_gas_mix = "o2=22;n2=82;TEMP=293.15"
	},
/area/ruin/powered)
"E" = (
/obj/item/cardboard_cutout{
	desc = "At closer inspection, this is infact just a cardboard cutout with LEDs glued on.";
	icon = 'icons/mob/swarmer.dmi';
	icon_state = "swarmer_ranged";
	name = "swarmer"
	},
/turf/open/floor/mineral/plastitanium/red{
	initial_gas_mix = "o2=22;n2=82;TEMP=293.15"
	},
/area/ruin/powered)
"G" = (
/turf/open/floor/mineral/plastitanium/red{
	initial_gas_mix = "o2=22;n2=82;TEMP=293.15"
	},
/area/ruin/powered)
"H" = (
/obj/item/cardboard_cutout{
	desc = "At closer inspection, this is infact just a cardboard cutout with LEDs glued on.";
	icon = 'icons/mob/swarmer.dmi';
	icon_state = "swarmer_console";
	name = "swarmer beacon"
	},
/turf/open/floor/mineral/plastitanium/red{
	initial_gas_mix = "o2=22;n2=82;TEMP=293.15"
	},
/area/ruin/powered)
"L" = (
/turf/closed/mineral,
/area/ruin/powered)
"O" = (
/obj/item/cardboard_cutout{
	desc = "At closer inspection, this is infact just a cardboard cutout with LEDs glued on.";
	icon = 'icons/mob/swarmer.dmi';
	icon_state = "barricade";
	name = "swarmer barricade"
	},
/turf/open/floor/plating/asteroid,
/area/ruin/powered)
"Q" = (
/obj/item/cardboard_cutout{
	desc = "At closer inspection, this is infact just a cardboard cutout with LEDs glued on.";
	icon = 'icons/mob/swarmer.dmi';
	icon_state = "swarmer_melee";
	name = "swarmer"
	},
/turf/open/floor/mineral/plastitanium/red{
	initial_gas_mix = "o2=22;n2=82;TEMP=293.15"
	},
/area/ruin/powered)
"T" = (
/obj/structure/shuttle/engine/propulsion{
	dir = 4
	},
/turf/open/floor/plating/asteroid,
/area/ruin/powered)
"W" = (
/turf/closed/wall/mineral/plastitanium,
/area/ruin/powered)
"Z" = (
/turf/open/floor/plating/asteroid,
/area/ruin/powered)

(1,1,1) = {"
b
b
b
b
b
b
b
b
b
b
b
b
b
b
b
b
b
b
b
b
b
b
b
b
b
b
b
b
b
b
b
b
b
b
b
b
b
b
b
b
"}
(2,1,1) = {"
b
b
b
b
b
b
b
b
b
b
b
b
b
b
b
b
b
b
b
b
b
b
b
b
b
b
b
b
b
b
b
b
b
b
b
b
b
b
b
b
"}
(3,1,1) = {"
b
b
b
b
b
b
b
b
b
b
b
b
b
b
b
b
b
b
b
b
b
b
b
b
b
b
b
b
b
b
b
b
b
b
b
b
b
b
b
b
"}
(4,1,1) = {"
b
b
b
b
b
b
b
b
b
b
b
b
b
b
b
b
b
b
b
b
b
b
b
b
b
b
b
b
b
b
b
b
b
b
b
b
b
b
b
b
"}
(5,1,1) = {"
b
b
b
b
b
b
b
b
b
b
b
b
b
b
b
b
b
b
b
b
b
b
b
b
b
b
b
b
b
b
b
b
b
b
b
b
b
b
b
b
"}
(6,1,1) = {"
b
b
b
b
b
b
b
b
b
b
b
b
b
b
b
b
b
b
b
b
b
b
b
b
b
b
b
b
b
b
b
b
b
b
b
b
b
b
b
b
"}
(7,1,1) = {"
b
b
b
b
b
b
b
b
b
b
b
b
b
b
b
b
b
L
L
L
L
L
L
L
L
L
L
b
b
b
b
b
b
b
b
b
b
b
b
b
"}
(8,1,1) = {"
b
b
b
b
b
b
b
b
b
b
b
b
b
b
b
b
L
L
L
L
L
L
L
L
L
L
L
L
L
L
b
b
b
b
b
b
b
b
b
b
"}
(9,1,1) = {"
b
b
b
b
b
b
b
b
b
b
b
b
b
b
L
L
L
L
L
L
L
L
L
L
L
L
L
L
L
L
L
b
b
b
b
b
b
b
b
b
"}
(10,1,1) = {"
b
b
b
b
b
b
b
b
b
b
b
b
L
L
L
L
L
L
L
L
L
L
L
L
L
L
L
L
L
L
L
L
b
b
b
b
b
b
b
b
"}
(11,1,1) = {"
b
b
b
b
b
b
b
b
b
b
L
L
L
L
L
L
L
L
L
L
L
L
L
L
L
L
L
L
L
L
L
L
L
b
b
b
b
b
b
b
"}
(12,1,1) = {"
b
b
b
b
b
b
b
b
L
L
L
L
L
L
L
L
L
L
L
L
L
L
L
L
L
L
L
L
L
L
L
L
L
b
b
b
b
b
b
b
"}
(13,1,1) = {"
b
b
b
b
b
b
b
L
L
L
L
L
L
L
L
L
L
L
L
L
L
L
L
L
L
L
L
L
L
L
L
L
L
L
b
b
b
b
b
b
"}
(14,1,1) = {"
b
b
b
b
b
b
L
L
L
L
L
L
L
L
L
L
L
L
L
L
L
L
L
L
L
L
L
L
L
L
L
L
L
L
L
b
b
b
b
b
"}
(15,1,1) = {"
b
b
b
b
b
b
L
L
L
L
L
L
L
L
L
L
L
L
L
L
L
L
L
L
L
L
L
L
L
W
Z
O
W
L
L
b
b
b
b
b
"}
(16,1,1) = {"
b
b
b
b
b
b
L
L
L
L
L
L
L
L
L
L
L
L
L
L
L
L
L
L
L
L
L
L
L
O
G
E
W
L
L
b
b
b
b
b
"}
(17,1,1) = {"
b
b
b
b
b
b
L
L
L
L
L
L
L
L
L
L
L
L
L
L
L
L
L
L
L
L
L
L
L
G
G
G
p
L
L
L
b
b
b
b
"}
(18,1,1) = {"
b
b
b
b
b
b
L
L
L
L
L
L
L
L
L
L
L
L
L
L
L
L
L
L
L
L
L
L
L
W
g
G
W
L
L
L
b
b
b
b
"}
(19,1,1) = {"
b
b
b
b
b
b
L
L
L
L
L
L
L
L
L
L
L
L
L
L
L
L
L
L
L
L
L
L
L
W
c
G
W
L
L
L
b
b
b
b
"}
(20,1,1) = {"
b
b
b
b
b
L
L
L
L
L
L
L
L
L
L
L
L
L
L
L
L
L
L
L
L
L
L
L
L
Z
G
G
c
L
L
L
L
b
b
b
"}
(21,1,1) = {"
b
b
b
b
b
L
L
L
L
L
L
L
L
L
L
L
L
L
L
L
L
L
L
L
L
L
L
L
W
W
Q
p
W
W
L
L
L
b
b
b
"}
(22,1,1) = {"
b
b
b
b
b
L
L
L
L
L
L
L
L
L
L
L
L
L
L
L
L
L
L
L
L
L
L
L
W
G
G
G
G
W
L
L
L
b
b
b
"}
(23,1,1) = {"
b
b
b
b
b
L
L
L
L
L
L
L
L
L
L
L
L
L
L
L
L
L
L
L
L
L
L
L
g
G
c
E
G
O
L
L
L
b
b
b
"}
(24,1,1) = {"
b
b
b
b
b
L
L
L
L
L
L
L
L
L
L
L
L
L
L
L
L
L
L
L
L
L
L
L
p
G
H
G
c
Z
L
L
L
b
b
b
"}
(25,1,1) = {"
b
b
b
b
b
L
L
L
L
L
L
L
L
L
L
L
L
L
L
L
L
L
L
L
L
L
L
L
a
Z
G
G
g
p
L
L
L
b
b
b
"}
(26,1,1) = {"
b
b
b
b
L
L
L
L
L
L
L
L
L
L
L
L
L
L
L
L
L
L
L
L
L
L
L
L
W
Z
G
G
G
W
L
L
L
b
b
b
"}
(27,1,1) = {"
b
b
b
b
L
L
L
L
L
L
L
L
L
L
L
L
L
L
L
L
L
L
L
L
L
L
L
L
W
W
W
W
W
W
L
L
L
b
b
b
"}
(28,1,1) = {"
b
b
b
b
L
L
L
L
L
L
L
L
L
L
L
L
L
L
L
L
L
L
L
L
L
L
L
L
L
T
T
T
T
L
L
L
L
b
b
b
"}
(29,1,1) = {"
b
b
b
b
L
L
L
L
L
L
L
L
L
L
L
L
L
L
L
L
L
L
L
L
L
L
L
L
L
L
L
L
L
L
L
L
L
b
b
b
"}
(30,1,1) = {"
b
b
b
b
L
L
L
L
L
L
L
L
L
L
L
L
L
L
L
L
L
L
L
L
L
L
L
L
L
L
L
L
L
L
L
L
b
b
b
b
"}
(31,1,1) = {"
b
b
b
b
L
L
L
L
L
L
L
L
L
L
L
L
L
L
L
L
L
L
L
L
L
L
L
L
L
L
L
L
L
L
L
L
b
b
b
b
"}
(32,1,1) = {"
b
b
b
b
L
L
L
L
L
L
L
L
L
L
L
L
L
L
L
L
L
L
L
L
L
L
L
L
L
L
L
L
L
L
L
b
b
b
b
b
"}
(33,1,1) = {"
b
b
b
b
L
L
L
L
L
L
L
L
L
L
L
L
L
L
L
L
L
L
L
L
L
L
L
L
L
L
L
L
L
L
L
b
b
b
b
b
"}
(34,1,1) = {"
b
b
b
b
b
b
L
L
L
L
L
L
L
L
L
L
L
L
L
L
L
L
L
L
L
L
L
L
L
L
L
L
L
L
b
b
b
b
b
b
"}
(35,1,1) = {"
b
b
b
b
b
b
b
b
L
L
L
L
L
L
L
L
L
L
L
L
L
L
L
L
L
L
L
L
L
L
L
L
L
b
b
b
b
b
b
b
"}
(36,1,1) = {"
b
b
b
b
b
b
b
b
b
b
b
b
b
b
b
L
L
L
L
L
L
L
L
L
L
L
L
L
L
L
L
L
b
b
b
b
b
b
b
b
"}
(37,1,1) = {"
b
b
b
b
b
b
b
b
b
b
b
b
b
b
b
b
b
b
b
b
b
b
L
L
L
L
L
L
L
L
b
b
b
b
b
b
b
b
b
b
"}
(38,1,1) = {"
b
b
b
b
b
b
b
b
b
b
b
b
b
b
b
b
b
b
b
b
b
b
b
b
b
b
b
b
b
b
b
b
b
b
b
b
b
b
b
b
"}
(39,1,1) = {"
b
b
b
b
b
b
b
b
b
b
b
b
b
b
b
b
b
b
b
b
b
b
b
b
b
b
b
b
b
b
b
b
b
b
b
b
b
b
b
b
"}
(40,1,1) = {"
b
b
b
b
b
b
b
b
b
b
b
b
b
b
b
b
b
b
b
b
b
b
b
b
b
b
b
b
b
b
b
b
b
b
b
b
b
b
b
b
"}
