"a" = (/obj/machinery/light,/obj/structure/closet/crate,/obj/item/storage/box/lights,/obj/item/restraints/handcuffs,/obj/item/restraints/handcuffs,/obj/item/bodybag,/turf/open/floor/plating/airless{icon_state = "platingdmg1"},/area/ruin/powered)
"c" = (/obj/structure/table,/turf/open/floor/plating/airless{icon_state = "platingdmg1"},/area/ruin/powered)
"d" = (/obj/machinery/door/airlock/ship/engineering{req_one_access_txt = "200"},/turf/open/floor/plating/airless,/area/ruin/powered)
"e" = (/obj/machinery/door/airlock/ship/command{name = "Bridge";req_one_access_txt = "200"},/turf/open/floor/plating/airless,/area/ruin/powered)
"f" = (/obj/machinery/door/airlock/ship/external/glass,/obj/effect/mapping_helpers/airlock/cyclelink_helper{dir = 1},/turf/open/floor/plating/airless,/area/ruin/powered)
"g" = (/obj/item/shard{icon_state = "small"},/obj/structure/grille/broken,/turf/open/floor/plating/airless,/area/ruin/powered)
"h" = (/obj/structure/shuttle/engine/heater{dir = 4},/obj/structure/window/reinforced{dir = 8},/turf/open/floor/engine/airless,/area/ruin/powered)
"j" = (/obj/machinery/light{dir = 1},/turf/open/floor/plating/airless,/area/ruin/powered)
"k" = (/turf/open/floor/plating/asteroid/airless,/area/ruin/powered)
"l" = (/obj/structure/shuttle/engine/propulsion{dir = 4},/turf/template_noop,/area/ruin/powered)
"m" = (/obj/item/shard,/turf/open/floor/plating/airless,/area/ruin/powered)
"n" = (/obj/item/reagent_containers/food/drinks/beer,/turf/open/floor/plating/airless,/area/ruin/powered)
"o" = (/obj/structure/frame/computer{anchored = 1;dir = 4},/turf/open/floor/plating/airless{icon_state = "platingdmg1"},/area/ruin/powered)
"p" = (/obj/structure/closet/crate/freezer,/obj/item/reagent_containers/food/snacks/meat/slab,/obj/item/reagent_containers/food/snacks/meat/slab,/obj/item/organ/appendix,/turf/open/floor/plating/airless,/area/ruin/powered)
"q" = (/obj/structure/closet/secure_closet/freezer/meat/open{opened = 1},/turf/open/floor/plating/airless,/area/ruin/powered)
"r" = (/turf/closed/wall/mineral/titanium/interior,/area/ruin/powered)
"s" = (/obj/structure/closet/crate,/obj/item/stack/sheet/mineral/uranium{amount = 50},/obj/item/stack/sheet/mineral/uranium{amount = 50},/turf/open/floor/plating/airless,/area/ruin/powered)
"t" = (/obj/item/clothing/glasses/regular/hipster,/turf/open/floor/plating/airless,/area/ruin/powered)
"u" = (/obj/machinery/light/small{dir = 8},/turf/open/floor/plating/airless{icon_state = "platingdmg1"},/area/ruin/powered)
"v" = (/turf/open/floor/plating/airless{icon_state = "platingdmg1"},/area/ruin/powered)
"w" = (/obj/item/shard{icon_state = "small"},/obj/structure/grille,/turf/open/floor/plating/airless,/area/ruin/powered)
"x" = (/obj/structure/closet/crate/freezer,/obj/item/organ/brain,/obj/item/reagent_containers/food/snacks/meat/slab/human/mutant/slime,/turf/open/floor/plating/airless,/area/ruin/powered)
"y" = (/obj/machinery/recharger,/obj/structure/table,/turf/open/floor/plating/airless,/area/ruin/powered)
"z" = (/obj/structure/table,/turf/open/floor/plating/airless,/area/ruin/powered)
"A" = (/turf/closed/wall/mineral/titanium/overspace,/area/ruin/powered)
"C" = (/obj/machinery/teleport/station,/obj/machinery/light{dir = 1},/turf/open/floor/plating/airless,/area/ruin/powered)
"D" = (/turf/closed/mineral,/area/ruin/powered)
"E" = (/obj/structure/reagent_dispensers/fueltank,/turf/open/floor/plating/airless,/area/ruin/powered)
"F" = (/turf/closed/wall/mineral/titanium/nodiagonal,/area/ruin/powered)
"H" = (/obj/structure/table_frame,/turf/open/floor/plating/airless,/area/ruin/powered)
"J" = (/obj/machinery/teleport/hub,/turf/open/floor/plating/airless,/area/ruin/powered)
"K" = (/turf/open/floor/plating/airless,/area/ruin/powered)
"L" = (/obj/machinery/light{dir = 8},/turf/open/floor/plating/airless{icon_state = "platingdmg1"},/area/ruin/powered)
"M" = (/obj/structure/reagent_dispensers,/turf/open/floor/plating/airless,/area/ruin/powered)
"O" = (/obj/structure/closet/crate,/obj/item/clothing/under/misc/overalls,/turf/open/floor/plating/airless,/area/ruin/powered)
"P" = (/obj/structure/table,/obj/machinery/microwave,/turf/open/floor/plating/airless,/area/ruin/powered)
"Q" = (/obj/effect/spawner/structure/window/reinforced,/turf/open/floor/plating,/area/ruin/powered)
"R" = (/obj/structure/rack,/obj/item/storage/belt/utility/full,/turf/open/floor/plating/airless,/area/ruin/powered)
"T" = (/obj/machinery/computer/teleporter,/turf/open/floor/plating/airless,/area/ruin/powered)
"U" = (/obj/machinery/door/airlock/ship/external/glass,/obj/effect/mapping_helpers/airlock/cyclelink_helper,/turf/open/floor/plating/airless,/area/ruin/powered)
"W" = (/turf/template_noop,/area/template_noop)
"Y" = (/obj/structure/ore_box,/turf/open/floor/plating/airless,/area/ruin/powered)
"Z" = (/obj/machinery/light{dir = 8},/turf/open/floor/plating/airless,/area/ruin/powered)

(1,1,1) = {"
WWWWWWWWWDDDDDDDDWWWWWWWWWWWWWWWWWWWWWWW
WWWWWWWDDDDDDDDDDDDWWWWWWWWWWWWWWWWWWWWW
WWWWWDDDDDDDDDDDDDDDWWWWWWWWWWWWWWWWWWWW
WWWWDDDDDDDDDDDDDDDDWWWWWWWWWWWWWWWWWWWW
WWWDDDDDDDDDDDDDDDDDWWWWWWWWWWWWWWWWWWWW
WWWDDDDDDDDDDDDDDDDWWWWWWWWWWWWWWWWWWWWW
WWWDDDDDDDDDDDDDDWWWWWWWWWWWWWWWWWWWWWWW
WWWDDDDDDDDDDDDDDDWWWWWWWWWWWWWWWWWWWWWW
WWWWDDDDDDDDDDDDDWWWWWWWWWWWWWWWWWWWWWWW
WWWWDDDDDDDDDDDDWWWWWWWWWWWWWWWWWWWWWWWW
WWWWWDDDDDDDDDDWWWWWWWWWWDWWWWWWWWWWWWWW
WWWWWWDDDDDDDWWWWWWWWWWWDDDDWWWWWWWWWWWW
WWWWWWWDDDDDWWWWWWWWWWDDDDDDDWWWWWWWWWWW
WWWWWWWWDDWWWWWWWWWWWDDDDDDDDDWWWWWWWWWW
WWWWWWWWWWWWWWWWWWWWDDDDDDDDDDWWWWWWWWWW
WWWWWWWWWWWWWWWWWDDDDDDDDDDDDDDWWWWWWWWW
WWWWWWWWWWWWWDDDDDDDDDDDDDDDDDDWWWWWWWWW
WWWWWWWWWWWDDDDDDDDDDDDDDDDDDDDDWWWWWWWW
WWWWWWWWWWWDDDDDDDDDDDDDDDDDDDDDWWWWWWWW
WWWWWWWWWWWDDDDDDDDDDDDDDDDDDDDDDWWWWWWW
WWWWWWWWWDDDDDDDDDDDDDDDFrrFDDDDDDWWWWWW
WWWWWWWWWDDDDDDDDDDDDFrrrpxFrrFDDDDWWWWW
WWWWWWWWDDDDDDDDDDrrrFqKKKKFKKrrrFDWWWWW
WWWWWWWWDDDDDDDDDDryKFFLmcKdKvTCJrrrAWWW
WWWWWWWDDDDDDDDDDDwovjrPzznFKKvKvKRhlWWW
WWWWWWWDDDDDDDDDDDgHvveKKKKFKKKtKKEhlWWW
WWWWWWDDDDDDDDDDDDQoKKrKvKKdvvKKKKMhlWWW
WWWWWWDDDDDDDDDDDDrvKFFZKKKFmKsaOrrrAWWW
WWWWWWDDDDDDDDDDDDrrrFvKFUUFYYrrrrAWWWWW
WWWWWWDDDDDDDDDDDDDDDFrrFuKFrrFDDDWWWWWW
WWWWWWWDDDDDDDDDDDDDDDDDFffFDDDDDDWWWWWW
WWWWWWDDDDDDDDDDDDDDDDDDkkkDDDDDDWWWWWWW
WWWWWWDDDDDDDDDDDDDDDDDDDkkDDDDDDDWWWWWW
WWWWWWDDDDDDDDDDDDDDDDDDDDDDDDDDDDWWWWWW
WWWWWWDDDDDDDDDDDDDDDDDDDDDDDDDDDDWWWWWW
WWWWWWDDDDDDDDDDDDDDDDDDDWWWDDDDDWWWWWWW
WWWWWWWDDDDDDDDDDDDDDDDDWWWWWDDDWWWWWWWW
WWWWWWWWDDDDDDDDDDDDDDDWWWWWWWWWWWWWWWWW
WWWWWWWWWDDDDDDDDDDWWWWWWWWWWWWWWWWWWWWW
WWWWWWWWWWWDDDDDDWWWWWWWWWWWWWWWWWWWWWWW
"}
