//MAP CONVERTED BY dmm2tgm.py THIS HEADER COMMENT PREVENTS RECONVERSION, DO NOT REMOVE
"aa" = (
/turf/template_noop,
/area/template_noop)
"ab" = (
/turf/closed/mineral/random,
/area/ruin/powered)
"ac" = (
/turf/open/floor/plating/asteroid/airless,
/area/ruin/powered)
"ad" = (
/turf/open/floor/plating/airless{
	icon_state = "platingdmg1"
	},
/area/ruin/powered)
"ae" = (
/turf/open/floor/plating/airless{
	icon_state = "damaged5"
	},
/area/ruin/powered)
"af" = (
/turf/open/floor/plating/airless{
	icon_state = "platingdmg3"
	},
/area/ruin/powered)
"ag" = (
/turf/open/floor/plating/airless{
	icon_state = "damaged4"
	},
/area/ruin/powered)
"ah" = (
/turf/open/floor/plating/airless{
	icon_state = "damaged2"
	},
/area/ruin/powered)
"ai" = (
/turf/closed/wall/r_wall,
/area/ruin/powered)
"aj" = (
/obj/machinery/door/airlock/maintenance,
/turf/open/floor/plating,
/area/ruin/powered)
"ak" = (
/obj/structure/grille,
/obj/structure/window/reinforced/fulltile,
/turf/open/floor/plating,
/area/ruin/powered)
"al" = (
/obj/machinery/door/airlock/medical/glass,
/obj/effect/mapping_helpers/airlock/abandoned,
/obj/machinery/atmospherics/pipe/simple/scrubbers/hidden,
/turf/open/floor/plasteel/white,
/area/ruin/powered)
"am" = (
/obj/machinery/door/airlock/medical/glass,
/obj/structure/disposalpipe/segment,
/obj/effect/mapping_helpers/airlock/abandoned,
/obj/machinery/atmospherics/pipe/simple/supply/hidden,
/turf/open/floor/plasteel/white,
/area/ruin/powered)
"an" = (
/obj/structure/table/reinforced,
/turf/closed/mineral/random,
/area/ruin/powered)
"ao" = (
/turf/open/floor/plating,
/area/ruin/powered)
"ap" = (
/obj/machinery/vending/cola/random,
/turf/open/floor/plasteel/white,
/area/ruin/powered)
"aq" = (
/obj/machinery/atmospherics/pipe/manifold/scrubbers/hidden{
	dir = 8
	},
/turf/open/floor/plasteel/white,
/area/ruin/powered)
"ar" = (
/obj/structure/disposalpipe/segment,
/obj/machinery/atmospherics/pipe/simple/scrubbers/hidden{
	dir = 4
	},
/obj/machinery/atmospherics/pipe/simple/supply/hidden,
/turf/open/floor/plasteel/white,
/area/ruin/powered)
"as" = (
/obj/machinery/atmospherics/pipe/simple/scrubbers/hidden{
	dir = 4
	},
/turf/open/floor/plasteel/white,
/area/ruin/powered)
"at" = (
/obj/machinery/smartfridge/chemistry/preloaded,
/obj/machinery/atmospherics/pipe/simple/scrubbers/hidden{
	dir = 4
	},
/turf/open/floor/plating,
/area/ruin/powered)
"au" = (
/obj/machinery/chem_heater,
/obj/machinery/atmospherics/pipe/simple/scrubbers/hidden{
	dir = 4
	},
/turf/open/floor/plasteel/white,
/area/ruin/powered)
"av" = (
/obj/structure/table/glass,
/obj/item/storage/bag/chemistry,
/obj/item/storage/box/beakers,
/obj/machinery/atmospherics/pipe/simple/scrubbers/hidden{
	dir = 10
	},
/turf/open/floor/plasteel/white,
/area/ruin/powered)
"aw" = (
/obj/structure/table/glass,
/turf/open/floor/plasteel/white,
/area/ruin/powered)
"ax" = (
/obj/machinery/chem_master,
/turf/open/floor/plasteel/white,
/area/ruin/powered)
"ay" = (
/obj/structure/chair/office{
	dir = 1
	},
/turf/open/floor/plasteel/white,
/area/ruin/powered)
"az" = (
/turf/open/floor/plasteel/white,
/area/ruin/powered)
"aA" = (
/obj/structure/table/glass,
/turf/closed/mineral/random,
/area/ruin/powered)
"aB" = (
/obj/machinery/disposal/bin,
/obj/structure/disposalpipe/trunk{
	dir = 4
	},
/turf/open/floor/plasteel/white,
/area/ruin/powered)
"aC" = (
/obj/structure/disposalpipe/segment{
	dir = 10
	},
/turf/open/floor/plasteel/white,
/area/ruin/powered)
"aD" = (
/obj/machinery/door/window{
	name = "Tactical Toilet";
	icon_state = "right";
	dir = 8;
	opacity = 1
	},
/obj/structure/window/reinforced,
/turf/open/floor/plasteel/white,
/area/ruin/powered)
"aE" = (
/obj/structure/window/reinforced,
/turf/open/floor/plasteel/white,
/area/ruin/powered)
"aF" = (
/obj/structure/window/reinforced,
/obj/structure/window/reinforced{
	dir = 4
	},
/turf/open/floor/plasteel/white,
/area/ruin/powered)
"aG" = (
/obj/machinery/dna_scannernew,
/turf/open/floor/plasteel/white,
/area/ruin/powered)
"aH" = (
/obj/structure/chair{
	dir = 4
	},
/turf/open/floor/plasteel/white,
/area/ruin/powered)
"aI" = (
/obj/structure/disposalpipe/segment,
/obj/machinery/atmospherics/components/unary/vent_scrubber/on{
	dir = 8
	},
/obj/machinery/atmospherics/pipe/simple/supply/hidden,
/turf/open/floor/plasteel/white,
/area/ruin/powered)
"aJ" = (
/obj/structure/table/reinforced,
/obj/machinery/door/window{
	dir = 8
	},
/obj/machinery/door/window{
	dir = 4
	},
/turf/open/floor/plasteel/white,
/area/ruin/powered)
"aK" = (
/obj/structure/chair/office{
	dir = 8
	},
/turf/open/floor/plasteel/white,
/area/ruin/powered)
"aL" = (
/obj/machinery/atmospherics/components/unary/vent_scrubber/on{
	dir = 1
	},
/turf/open/floor/plasteel/white,
/area/ruin/powered)
"aM" = (
/obj/machinery/atmospherics/components/unary/vent_pump/on,
/turf/open/floor/plasteel/white,
/area/ruin/powered)
"aN" = (
/obj/structure/table/glass,
/obj/item/storage/bag/chemistry,
/turf/open/floor/plasteel/white,
/area/ruin/powered)
"aO" = (
/obj/structure/disposalpipe/segment,
/turf/open/floor/plasteel/white,
/area/ruin/powered)
"aP" = (
/obj/structure/table/glass,
/obj/item/storage/firstaid/toxin,
/turf/open/floor/plasteel/white,
/area/ruin/powered)
"aQ" = (
/obj/structure/table/glass,
/obj/machinery/atmospherics/components/unary/vent_pump/on,
/turf/open/floor/plasteel/white,
/area/ruin/powered)
"aR" = (
/obj/structure/sink{
	dir = 4;
	pixel_x = 11
	},
/turf/open/floor/plasteel/white,
/area/ruin/powered)
"aS" = (
/obj/machinery/atmospherics/pipe/simple/scrubbers/hidden,
/obj/machinery/atmospherics/components/unary/vent_pump/on{
	dir = 4
	},
/turf/open/floor/plasteel/white,
/area/ruin/powered)
"aT" = (
/obj/structure/disposalpipe/segment,
/obj/machinery/atmospherics/pipe/manifold/supply/hidden{
	dir = 4
	},
/turf/open/floor/plasteel/white,
/area/ruin/powered)
"aU" = (
/obj/machinery/chem_dispenser/drinks/beer,
/turf/open/floor/plasteel/white,
/area/ruin/powered)
"aV" = (
/obj/structure/disposalpipe/segment{
	dir = 8
	},
/turf/open/floor/plasteel/white,
/area/ruin/powered)
"aW" = (
/obj/structure/disposalpipe/segment{
	dir = 10
	},
/obj/machinery/atmospherics/pipe/manifold/supply/hidden{
	dir = 8
	},
/turf/open/floor/plasteel/white,
/area/ruin/powered)
"aX" = (
/obj/machinery/chem_heater,
/obj/machinery/atmospherics/pipe/simple/supply/hidden{
	dir = 8
	},
/turf/open/floor/plasteel/white,
/area/ruin/powered)
"aY" = (
/obj/structure/table/glass,
/obj/machinery/atmospherics/pipe/simple/supply/hidden{
	dir = 8
	},
/turf/open/floor/plasteel/white,
/area/ruin/powered)
"aZ" = (
/obj/structure/grille,
/obj/structure/window/reinforced/fulltile,
/obj/machinery/atmospherics/pipe/simple/supply/hidden{
	dir = 8
	},
/turf/open/floor/plating,
/area/ruin/powered)
"ba" = (
/obj/machinery/dna_scannernew,
/obj/machinery/atmospherics/pipe/simple/supply/hidden{
	dir = 8
	},
/turf/open/floor/plasteel/white,
/area/ruin/powered)
"bb" = (
/obj/structure/disposalpipe/segment,
/obj/machinery/atmospherics/pipe/simple/supply/hidden{
	dir = 8
	},
/turf/open/floor/plasteel/white,
/area/ruin/powered)
"bc" = (
/obj/machinery/atmospherics/pipe/simple/supply/hidden{
	dir = 8
	},
/turf/open/floor/plasteel/white,
/area/ruin/powered)
"bd" = (
/obj/machinery/atmospherics/pipe/manifold/supply/hidden,
/turf/open/floor/plasteel/white,
/area/ruin/powered)
"be" = (
/obj/machinery/door/airlock/maintenance,
/obj/machinery/atmospherics/pipe/simple/supply/hidden{
	dir = 8
	},
/turf/open/floor/plating,
/area/ruin/powered)
"bf" = (
/obj/machinery/atmospherics/pipe/simple/supply/hidden{
	dir = 8
	},
/turf/open/floor/plating,
/area/ruin/powered)
"bg" = (
/obj/machinery/atmospherics/pipe/simple/scrubbers/hidden,
/turf/open/floor/plasteel/white,
/area/ruin/powered)
"bh" = (
/obj/structure/disposalpipe/segment,
/obj/machinery/atmospherics/pipe/simple/supply/hidden,
/turf/open/floor/plasteel/white,
/area/ruin/powered)
"bi" = (
/obj/machinery/door/airlock/medical/glass,
/obj/structure/disposalpipe/segment,
/obj/machinery/atmospherics/pipe/simple/supply/hidden,
/turf/open/floor/plasteel/white,
/area/ruin/powered)
"bj" = (
/obj/machinery/door/airlock/command/glass,
/obj/machinery/atmospherics/pipe/simple/scrubbers/hidden,
/turf/open/floor/plasteel/white,
/area/ruin/powered)
"bk" = (
/obj/structure/closet/wardrobe/genetics_white,
/turf/open/floor/plasteel/white,
/area/ruin/powered)
"bl" = (
/obj/structure/disposalpipe/segment,
/obj/machinery/atmospherics/pipe/simple/scrubbers/hidden,
/turf/open/floor/plasteel/white,
/area/ruin/powered)
"bm" = (
/obj/machinery/computer/cloning{
	dir = 1
	},
/turf/open/floor/plasteel/white,
/area/ruin/powered)
"bn" = (
/obj/machinery/clonepod,
/obj/machinery/shower{
	dir = 8
	},
/turf/open/floor/plasteel/white,
/area/ruin/powered)
"bo" = (
/obj/machinery/door/airlock/medical/glass,
/obj/machinery/atmospherics/pipe/simple/scrubbers/hidden,
/turf/open/floor/plasteel/white,
/area/ruin/powered)
"bp" = (
/obj/machinery/atmospherics/components/unary/portables_connector,
/obj/machinery/portable_atmospherics/canister/oxygen,
/turf/open/floor/plasteel/white,
/area/ruin/powered)
"bq" = (
/obj/machinery/atmospherics/components/unary/thermomachine/freezer,
/turf/open/floor/plasteel/white,
/area/ruin/powered)
"br" = (
/obj/machinery/atmospherics/components/unary/cryo_cell,
/turf/open/floor/plasteel/white,
/area/ruin/powered)
"bs" = (
/obj/machinery/iv_drip,
/turf/open/floor/plasteel/white,
/area/ruin/powered)
"bt" = (
/obj/structure/bed/roller,
/obj/machinery/iv_drip,
/turf/open/floor/plasteel/white,
/area/ruin/powered)
"bu" = (
/obj/machinery/door/airlock/medical/glass,
/obj/structure/disposalpipe/segment,
/obj/machinery/atmospherics/pipe/simple/scrubbers/hidden,
/turf/open/floor/plasteel/white,
/area/ruin/powered)
"bv" = (
/obj/structure/reagent_dispensers/water_cooler,
/turf/open/floor/plasteel/white,
/area/ruin/powered)
"bw" = (
/obj/structure/disposalpipe/junction{
	dir = 1
	},
/obj/machinery/atmospherics/pipe/simple/supply/hidden,
/turf/open/floor/plasteel/white,
/area/ruin/powered)
"bx" = (
/obj/machinery/disposal/bin,
/obj/structure/disposalpipe/trunk{
	dir = 8
	},
/turf/open/floor/plasteel/white,
/area/ruin/powered)
"by" = (
/obj/structure/table/glass,
/obj/item/storage/toolbox/emergency/old,
/turf/open/floor/plasteel/white,
/area/ruin/powered)
"bz" = (
/obj/machinery/atmospherics/pipe/simple/general/visible{
	dir = 5
	},
/turf/open/floor/plasteel/white,
/area/ruin/powered)
"bA" = (
/obj/machinery/atmospherics/pipe/manifold/general/visible,
/turf/open/floor/plasteel/white,
/area/ruin/powered)
"bB" = (
/obj/machinery/atmospherics/pipe/simple/general/visible{
	dir = 9
	},
/turf/open/floor/plasteel/white,
/area/ruin/powered)
"bC" = (
/obj/machinery/door/airlock/medical/glass,
/turf/open/floor/plasteel/white,
/area/ruin/powered)
"bD" = (
/obj/machinery/atmospherics/pipe/simple/scrubbers/hidden{
	dir = 6
	},
/turf/open/floor/plasteel/white,
/area/ruin/powered)
"bE" = (
/obj/machinery/atmospherics/pipe/manifold/scrubbers/hidden,
/turf/open/floor/plasteel/white,
/area/ruin/powered)
"bF" = (
/obj/structure/disposalpipe/segment,
/obj/machinery/atmospherics/pipe/manifold/scrubbers/hidden,
/turf/open/floor/plasteel/white,
/area/ruin/powered)
"bG" = (
/obj/machinery/atmospherics/pipe/simple/scrubbers/hidden{
	dir = 10
	},
/turf/open/floor/plasteel/white,
/area/ruin/powered)
"bH" = (
/obj/structure/closet/l3closet/virology,
/obj/machinery/atmospherics/components/unary/vent_scrubber/on,
/turf/open/floor/plasteel/white,
/area/ruin/powered)
"bI" = (
/obj/structure/closet/l3closet/virology,
/obj/machinery/atmospherics/components/unary/vent_pump/on,
/turf/open/floor/plasteel/white,
/area/ruin/powered)
"bJ" = (
/obj/machinery/sleeper{
	dir = 4
	},
/obj/machinery/shower{
	dir = 4
	},
/turf/open/floor/plasteel/white,
/area/ruin/powered)
"bK" = (
/obj/structure/disposalpipe/segment{
	dir = 5
	},
/obj/machinery/atmospherics/pipe/manifold/supply/hidden,
/turf/open/floor/plasteel/white,
/area/ruin/powered)
"bL" = (
/obj/structure/disposalpipe/segment{
	dir = 8
	},
/obj/machinery/atmospherics/pipe/simple/supply/hidden{
	dir = 4
	},
/turf/open/floor/plasteel/white,
/area/ruin/powered)
"bM" = (
/obj/structure/disposalpipe/segment{
	dir = 8
	},
/obj/machinery/atmospherics/pipe/manifold/supply/hidden{
	dir = 1
	},
/turf/open/floor/plasteel/white,
/area/ruin/powered)
"bN" = (
/obj/structure/disposalpipe/segment{
	dir = 8
	},
/obj/machinery/atmospherics/components/unary/vent_scrubber/on,
/obj/machinery/atmospherics/pipe/simple/supply/hidden{
	dir = 4
	},
/turf/open/floor/plasteel/white,
/area/ruin/powered)
"bO" = (
/obj/machinery/door/airlock/medical/glass,
/obj/structure/disposalpipe/segment{
	dir = 8
	},
/obj/machinery/atmospherics/pipe/simple/supply/hidden{
	dir = 4
	},
/turf/open/floor/plasteel/white,
/area/ruin/powered)
"bP" = (
/obj/structure/disposalpipe/junction{
	dir = 8
	},
/obj/machinery/atmospherics/pipe/manifold/supply/hidden,
/turf/open/floor/plasteel/white,
/area/ruin/powered)
"bQ" = (
/obj/structure/disposalpipe/junction/flip{
	dir = 8
	},
/obj/machinery/atmospherics/pipe/manifold/supply/hidden{
	dir = 1
	},
/turf/open/floor/plasteel/white,
/area/ruin/powered)
"bR" = (
/obj/structure/disposalpipe/segment{
	dir = 8
	},
/obj/machinery/atmospherics/pipe/simple/scrubbers/hidden{
	dir = 1
	},
/obj/machinery/atmospherics/pipe/simple/supply/hidden{
	dir = 4
	},
/turf/open/floor/plasteel/white,
/area/ruin/powered)
"bS" = (
/obj/structure/disposalpipe/segment{
	dir = 8
	},
/obj/machinery/atmospherics/pipe/simple/supply/hidden{
	dir = 8
	},
/turf/open/floor/plasteel/white,
/area/ruin/powered)
"bT" = (
/obj/structure/disposalpipe/segment{
	dir = 9
	},
/obj/machinery/atmospherics/pipe/manifold/supply/hidden{
	dir = 1
	},
/turf/open/floor/plasteel/white,
/area/ruin/powered)
"bU" = (
/obj/machinery/atmospherics/pipe/simple/scrubbers/hidden{
	dir = 1
	},
/obj/machinery/atmospherics/pipe/simple/supply/hidden{
	dir = 8
	},
/turf/open/floor/plasteel/white,
/area/ruin/powered)
"bV" = (
/obj/machinery/door/airlock/virology,
/obj/effect/mapping_helpers/airlock/locked,
/obj/machinery/atmospherics/pipe/simple/supply/hidden{
	dir = 4
	},
/turf/open/floor/plasteel/white,
/area/ruin/powered)
"bW" = (
/obj/machinery/atmospherics/pipe/simple/scrubbers/hidden,
/obj/machinery/atmospherics/pipe/simple/supply/hidden{
	dir = 4
	},
/turf/open/floor/plasteel/white,
/area/ruin/powered)
"bX" = (
/obj/machinery/atmospherics/pipe/simple/supply/hidden{
	dir = 4
	},
/turf/open/floor/plasteel/white,
/area/ruin/powered)
"bY" = (
/obj/machinery/atmospherics/pipe/simple/supply/hidden{
	dir = 10
	},
/turf/open/floor/plasteel/white,
/area/ruin/powered)
"bZ" = (
/obj/machinery/sleeper{
	dir = 4
	},
/obj/machinery/shower{
	dir = 4
	},
/obj/machinery/atmospherics/components/unary/vent_scrubber/on{
	dir = 4
	},
/turf/open/floor/plasteel/white,
/area/ruin/powered)
"ca" = (
/obj/machinery/atmospherics/pipe/manifold/scrubbers/hidden{
	dir = 1
	},
/turf/open/floor/plasteel/white,
/area/ruin/powered)
"cb" = (
/obj/machinery/atmospherics/pipe/simple/scrubbers/hidden{
	dir = 4
	},
/obj/machinery/atmospherics/pipe/simple/supply/hidden,
/turf/open/floor/plasteel/white,
/area/ruin/powered)
"cc" = (
/obj/machinery/atmospherics/pipe/simple/scrubbers/hidden{
	dir = 9
	},
/turf/open/floor/plasteel/white,
/area/ruin/powered)
"cd" = (
/obj/item/bedsheet/medical,
/obj/structure/bed,
/turf/open/floor/plasteel/white,
/area/ruin/powered)
"ce" = (
/obj/machinery/door/airlock/medical/glass,
/obj/structure/disposalpipe/segment{
	dir = 1
	},
/obj/machinery/atmospherics/pipe/simple/supply/hidden,
/turf/open/floor/plasteel/white,
/area/ruin/powered)
"cf" = (
/obj/structure/grille,
/obj/structure/window/reinforced/fulltile,
/obj/machinery/atmospherics/pipe/simple/scrubbers/hidden{
	dir = 1
	},
/turf/open/floor/plating,
/area/ruin/powered)
"cg" = (
/obj/machinery/door/airlock/medical/glass,
/obj/machinery/atmospherics/pipe/simple/supply/hidden,
/turf/open/floor/plasteel/white,
/area/ruin/powered)
"ch" = (
/obj/machinery/atmospherics/pipe/simple/scrubbers/hidden,
/turf/closed/wall/r_wall,
/area/ruin/powered)
"ci" = (
/obj/machinery/atmospherics/components/unary/vent_scrubber/on{
	dir = 8
	},
/obj/machinery/atmospherics/pipe/simple/supply/hidden,
/turf/open/floor/plasteel/white,
/area/ruin/powered)
"cj" = (
/obj/machinery/atmospherics/components/unary/vent_pump/on{
	dir = 1
	},
/turf/open/floor/plasteel/white,
/area/ruin/powered)
"ck" = (
/obj/structure/table/glass,
/obj/item/clothing/glasses/blindfold,
/obj/item/clothing/mask/muzzle,
/obj/item/clothing/suit/straight_jacket,
/obj/item/clothing/ears/earmuffs,
/obj/item/storage/box/masks,
/turf/open/floor/plasteel/white,
/area/ruin/powered)
"cl" = (
/obj/machinery/limbgrower,
/turf/open/floor/plasteel/white,
/area/ruin/powered)
"cm" = (
/obj/structure/disposalpipe/segment{
	dir = 5
	},
/obj/machinery/atmospherics/pipe/simple/supply/hidden,
/turf/open/floor/plasteel/white,
/area/ruin/powered)
"cn" = (
/obj/structure/table/glass,
/obj/structure/disposalpipe/segment{
	dir = 4
	},
/obj/item/storage/firstaid/ancient,
/obj/item/storage/firstaid/fire,
/turf/open/floor/plasteel/white,
/area/ruin/powered)
"co" = (
/obj/structure/table/glass,
/obj/structure/disposalpipe/segment{
	dir = 4
	},
/obj/item/storage/firstaid/ancient,
/obj/item/storage/firstaid/brute,
/obj/machinery/atmospherics/pipe/simple/scrubbers/hidden{
	dir = 1
	},
/turf/open/floor/plasteel/white,
/area/ruin/powered)
"cp" = (
/obj/structure/table/glass,
/obj/structure/disposalpipe/segment{
	dir = 4
	},
/obj/item/storage/firstaid/ancient,
/turf/open/floor/plasteel/white,
/area/ruin/powered)
"cq" = (
/obj/structure/table/glass,
/obj/structure/disposalpipe/segment{
	dir = 10
	},
/obj/item/storage/firstaid/ancient,
/turf/open/floor/plasteel/white,
/area/ruin/powered)
"cr" = (
/obj/structure/table,
/obj/item/surgical_drapes,
/obj/item/razor,
/obj/item/clothing/gloves/color/latex,
/turf/open/floor/plasteel/white,
/area/ruin/powered)
"cs" = (
/obj/structure/closet/crate/freezer/blood,
/obj/machinery/atmospherics/pipe/simple/scrubbers/hidden{
	dir = 5
	},
/turf/open/floor/plasteel/white,
/area/ruin/powered)
"ct" = (
/obj/machinery/atmospherics/pipe/simple/scrubbers/hidden{
	dir = 8
	},
/turf/closed/wall/r_wall,
/area/ruin/powered)
"cu" = (
/obj/item/tank/internals/emergency_oxygen/empty,
/turf/open/floor/plasteel/white,
/area/ruin/powered)
"cv" = (
/obj/item/tank/internals/emergency_oxygen/empty,
/obj/machinery/atmospherics/pipe/simple/scrubbers/hidden,
/turf/open/floor/plasteel/white,
/area/ruin/powered)
"cw" = (
/obj/machinery/computer/crew{
	dir = 1
	},
/turf/open/floor/plasteel/white,
/area/ruin/powered)
"cx" = (
/obj/structure/table/glass,
/obj/item/wrench/medical,
/turf/open/floor/plasteel/white,
/area/ruin/powered)
"cy" = (
/obj/structure/table/glass,
/obj/item/clothing/head/helmet/space/fragile,
/turf/open/floor/plasteel/white,
/area/ruin/powered)
"cz" = (
/obj/structure/table/glass,
/obj/item/clothing/suit/space/fragile,
/turf/open/floor/plasteel/white,
/area/ruin/powered)
"cA" = (
/obj/structure/table/glass,
/obj/item/storage/box/medipens,
/obj/item/storage/box/rxglasses,
/obj/item/storage/firstaid/advanced,
/turf/open/floor/plasteel/white,
/area/ruin/powered)
"cB" = (
/obj/machinery/atmospherics/components/unary/vent_pump/on{
	dir = 4
	},
/turf/open/floor/plasteel/white,
/area/ruin/powered)
"cC" = (
/obj/machinery/atmospherics/pipe/simple/supply/hidden{
	dir = 9
	},
/turf/open/floor/plasteel/white,
/area/ruin/powered)
"cD" = (
/obj/machinery/atmospherics/components/unary/vent_scrubber/on{
	dir = 8
	},
/turf/open/floor/plasteel/white,
/area/ruin/powered)
"cE" = (
/obj/machinery/disposal/bin,
/obj/structure/disposalpipe/trunk{
	dir = 1
	},
/turf/open/floor/plasteel/white,
/area/ruin/powered)
"cF" = (
/obj/structure/table,
/obj/item/surgicaldrill,
/obj/item/cautery,
/turf/open/floor/plasteel/white,
/area/ruin/powered)
"cG" = (
/obj/structure/closet/secure_closet/medical2,
/obj/machinery/iv_drip,
/turf/open/floor/plasteel/white,
/area/ruin/powered)
"cH" = (
/obj/machinery/door/airlock/grunge,
/obj/machinery/atmospherics/pipe/simple/scrubbers/hidden,
/turf/open/floor/plating,
/area/ruin/powered)
"cI" = (
/obj/structure/closet/l3closet,
/turf/open/floor/plasteel/white,
/area/ruin/powered)
"cJ" = (
/obj/structure/closet/secure_closet/medical3,
/obj/structure/window/reinforced{
	dir = 4
	},
/obj/machinery/atmospherics/pipe/simple/scrubbers/hidden{
	dir = 8
	},
/turf/open/floor/plasteel/white,
/area/ruin/powered)
"cK" = (
/obj/structure/closet/secure_closet/medical3,
/obj/structure/window/reinforced{
	dir = 8
	},
/obj/machinery/atmospherics/pipe/simple/scrubbers/hidden{
	dir = 8
	},
/turf/open/floor/plasteel/white,
/area/ruin/powered)
"cL" = (
/obj/machinery/atmospherics/pipe/simple/scrubbers/hidden{
	dir = 8
	},
/turf/open/floor/plasteel/white,
/area/ruin/powered)
"cM" = (
/obj/structure/table,
/obj/item/retractor,
/obj/item/hemostat,
/turf/open/floor/plasteel/white,
/area/ruin/powered)
"cN" = (
/obj/structure/table/optable,
/turf/open/floor/plasteel/white,
/area/ruin/powered)
"cO" = (
/obj/structure/bodycontainer/morgue,
/turf/open/floor/plating,
/area/ruin/powered)
"cP" = (
/obj/machinery/atmospherics/pipe/simple/scrubbers/hidden,
/turf/open/floor/plating,
/area/ruin/powered)
"cQ" = (
/obj/machinery/atmospherics/components/unary/vent_scrubber/on,
/turf/open/floor/plating,
/area/ruin/powered)
"cR" = (
/obj/structure/closet/wardrobe/white/medical,
/turf/open/floor/plasteel/white,
/area/ruin/powered)
"cS" = (
/obj/structure/closet/secure_closet/medical3,
/obj/structure/window/reinforced{
	dir = 4
	},
/turf/open/floor/plasteel/white,
/area/ruin/powered)
"cT" = (
/obj/structure/closet/secure_closet/medical3,
/obj/structure/window/reinforced{
	dir = 8
	},
/turf/open/floor/plasteel/white,
/area/ruin/powered)
"cU" = (
/obj/structure/table/glass,
/obj/item/storage/box/syringes,
/turf/open/floor/plasteel/white,
/area/ruin/powered)
"cV" = (
/obj/structure/table,
/obj/item/scalpel{
	pixel_y = 12
	},
/obj/item/circular_saw,
/turf/open/floor/plasteel/white,
/area/ruin/powered)
"cW" = (
/obj/machinery/computer/operating{
	dir = 8
	},
/turf/open/floor/plasteel/white,
/area/ruin/powered)
"cX" = (
/obj/machinery/atmospherics/pipe/simple/scrubbers/hidden{
	dir = 5
	},
/turf/open/floor/plating,
/area/ruin/powered)
"cY" = (
/obj/machinery/atmospherics/pipe/simple/scrubbers/hidden{
	dir = 4
	},
/turf/open/floor/plating,
/area/ruin/powered)
"cZ" = (
/obj/machinery/atmospherics/pipe/manifold/scrubbers/hidden,
/turf/open/floor/plating,
/area/ruin/powered)
"da" = (
/obj/machinery/door/airlock/grunge,
/obj/machinery/atmospherics/pipe/simple/scrubbers/hidden{
	dir = 4
	},
/turf/open/floor/plating,
/area/ruin/powered)
"db" = (
/obj/structure/closet/wardrobe/chemistry_white,
/turf/open/floor/plasteel/white,
/area/ruin/powered)
"dc" = (
/obj/structure/table,
/turf/open/floor/plating,
/area/ruin/powered)
"dd" = (
/obj/structure/table,
/obj/item/storage/box/bodybags,
/turf/open/floor/plating,
/area/ruin/powered)
"de" = (
/obj/machinery/space_heater,
/turf/open/floor/plating,
/area/ruin/powered)
"df" = (
/obj/structure/closet/crate/medical,
/turf/open/floor/plating,
/area/ruin/powered)
"dg" = (
/obj/structure/closet/l3closet,
/turf/open/floor/plating,
/area/ruin/powered)
"dh" = (
/obj/machinery/door/airlock/maintenance,
/obj/effect/mapping_helpers/airlock/abandoned,
/obj/effect/mapping_helpers/airlock/locked,
/turf/open/floor/plating,
/area/ruin/powered)
"di" = (
/obj/structure/closet/crate,
/turf/open/floor/plating,
/area/ruin/powered)
"dj" = (
/obj/structure/closet/firecloset/full,
/turf/open/floor/plating,
/area/ruin/powered)
"dk" = (
/obj/structure/closet/emcloset/anchored,
/turf/open/floor/plating,
/area/ruin/powered)
"xJ" = (
/turf/template_noop,
/area/ruin/powered)
"Bq" = (
/turf/open/floor/plating/asteroid,
/area/ruin/powered)

(1,1,1) = {"
aa
aa
aa
aa
aa
aa
aa
aa
aa
aa
aa
aa
aa
aa
aa
aa
aa
aa
aa
aa
aa
aa
aa
aa
aa
aa
aa
aa
aa
aa
aa
aa
aa
aa
aa
aa
aa
aa
aa
aa
"}
(2,1,1) = {"
aa
aa
aa
aa
aa
aa
aa
aa
aa
aa
aa
aa
aa
aa
aa
aa
aa
aa
aa
aa
aa
aa
aa
aa
aa
aa
aa
aa
aa
aa
aa
aa
aa
aa
aa
aa
aa
aa
aa
aa
"}
(3,1,1) = {"
aa
aa
aa
aa
aa
aa
aa
aa
aa
aa
aa
aa
aa
aa
aa
aa
aa
aa
aa
aa
aa
aa
aa
aa
aa
aa
aa
aa
aa
aa
aa
aa
aa
aa
aa
aa
aa
aa
aa
aa
"}
(4,1,1) = {"
aa
aa
aa
aa
aa
aa
aa
aa
aa
aa
aa
ai
ai
ai
ai
ai
ai
ai
ai
ai
ai
ai
ai
ai
ai
ai
ai
dh
ai
aa
aa
aa
aa
aa
aa
aa
aa
aa
aa
aa
"}
(5,1,1) = {"
aa
aa
aa
aa
aa
aa
aa
aa
aa
aa
ad
aj
ao
ao
ao
ao
ao
ao
ao
ao
ao
ao
ao
ao
ao
ao
ao
ao
ai
aa
aa
aa
aa
aa
aa
aa
aa
aa
aa
aa
"}
(6,1,1) = {"
aa
aa
aa
aa
aa
aa
aa
aa
aa
af
ae
ai
ai
ai
ai
ai
ai
ai
ai
ai
ai
ai
ai
ai
aj
ai
ai
ao
ai
aa
aa
aa
aa
aa
aa
aa
aa
aa
aa
aa
"}
(7,1,1) = {"
aa
aa
aa
aa
aa
aa
aa
aa
aa
ag
af
ak
ap
aH
aH
aw
ak
bv
bJ
bZ
az
cu
ai
cO
ao
dc
ai
ao
ak
aa
aa
aa
aa
aa
aa
aa
aa
aa
aa
aa
"}
(8,1,1) = {"
aa
aa
aa
aa
aa
aa
aa
aa
ad
ae
ah
al
aq
aq
aS
bg
bo
bg
aS
bE
az
az
ai
ao
ao
dd
ai
ao
ak
aa
aa
aa
aa
aa
aa
aa
aa
aa
aa
aa
"}
(9,1,1) = {"
aa
aa
aa
aa
aa
aa
aa
ad
ae
ad
ah
am
ar
aI
aT
bh
bi
bw
bK
ca
bg
cv
cH
cP
cX
dc
ai
ao
ak
aa
aa
aa
aa
aa
aa
aa
aa
aa
aa
aa
"}
(10,1,1) = {"
aa
aa
aa
aa
aa
aa
aa
ad
ad
af
ae
ak
as
az
aw
aw
ak
bx
bL
as
az
cw
ai
cO
cY
cO
ai
ao
ai
aa
aa
aa
aa
aa
aa
aa
aa
aa
aa
aa
"}
(11,1,1) = {"
aa
aa
aa
aa
aa
aa
aa
ab
xJ
ae
xJ
ai
at
aJ
ak
ai
ai
by
bM
cb
cj
cx
ai
cQ
cZ
ao
ai
ao
ak
aa
aa
aa
aa
aa
aa
aa
aa
aa
aa
aa
"}
(12,1,1) = {"
aa
aa
aa
aa
aa
ab
ab
ab
ab
ac
ac
ai
au
aK
ax
ak
bp
bz
bN
cc
az
cy
ai
cO
cY
cO
ai
ao
ak
aa
aa
aa
aa
aa
aa
aa
aa
aa
aa
aa
"}
(13,1,1) = {"
aa
aa
aa
aa
ab
ab
ab
ab
ab
ab
ac
ak
av
aL
aU
ai
bq
bA
bL
cd
cd
cz
ai
ao
cY
ao
ai
ao
ak
aa
aa
aa
aa
aa
aa
aa
aa
aa
aa
aa
"}
(14,1,1) = {"
aa
aa
aa
aa
ab
ab
ab
ab
ab
ac
ac
ak
aw
az
aB
ai
br
bB
bL
ai
ak
ai
ai
ai
da
ai
ai
ao
ai
aa
aa
aa
aa
aa
aa
aa
aa
aa
aa
aa
"}
(15,1,1) = {"
aa
aa
aa
aa
aa
ab
ab
ab
ab
ab
ac
ak
aw
az
aV
ai
ai
bC
bO
ai
ck
cA
cI
cR
as
ai
ao
ao
ai
aa
aa
aa
aa
aa
aa
aa
aa
aa
aa
aa
"}
(16,1,1) = {"
aa
aa
aa
aa
aa
ab
ab
ab
ab
ab
ab
ak
ax
aM
aW
bi
bh
bh
bP
ak
az
cB
bD
bg
cc
ai
ao
di
ai
aa
aa
aa
aa
aa
aa
aa
aa
aa
aa
aa
"}
(17,1,1) = {"
aa
aa
aa
aa
aa
ab
ab
ab
ac
ab
ab
an
ay
az
aX
ai
bs
az
bL
ak
cl
bX
cJ
cS
cS
ai
ao
ai
ai
aa
aa
aa
aa
aa
aa
aa
aa
aa
aa
aa
"}
(18,1,1) = {"
aa
aa
aa
aa
aa
ac
ab
ab
ab
ab
ab
ab
az
aN
aY
ai
bt
az
bQ
ce
cm
cC
cK
cT
cT
ai
ao
ai
aa
aa
aa
aa
aa
aa
aa
aa
aa
aa
aa
aa
"}
(19,1,1) = {"
aa
aa
aa
aa
aa
ac
ac
ac
ac
ab
ab
ab
ak
ak
aZ
ai
bt
az
bL
ak
cn
az
cL
az
az
ai
ao
ak
aa
aa
aa
aa
aa
aa
aa
aa
aa
aa
aa
aa
"}
(20,1,1) = {"
aa
aa
aa
aa
aa
aa
ac
ac
ac
ac
ab
ab
ab
ab
ab
ai
bs
bD
bR
cf
co
aq
cc
az
db
ai
ao
ak
aa
aa
aa
aa
aa
aa
aa
aa
aa
aa
aa
aa
"}
(21,1,1) = {"
aa
aa
aa
aa
aa
aa
aa
aa
ac
ac
ab
ab
ab
ab
ab
bj
bg
bE
bL
ak
cp
cD
az
az
az
ai
ao
ak
aa
aa
aa
aa
aa
aa
aa
aa
aa
aa
aa
aa
"}
(22,1,1) = {"
aa
aa
aa
aa
aa
aa
aa
aa
aa
ac
ac
ab
aA
aA
aA
ai
az
as
bS
ai
cq
cE
aw
cU
aw
ai
ao
ai
aa
aa
aa
aa
aa
aa
aa
aa
aa
aa
aa
aa
"}
(23,1,1) = {"
aa
aa
aa
aa
aa
aa
aa
aa
aa
aa
aa
ai
ak
ak
aZ
ai
ai
as
bL
ai
ak
ak
ak
ai
ai
ai
ao
ai
ai
aa
aa
aa
aa
aa
aa
aa
aa
aa
aa
aa
"}
(24,1,1) = {"
aa
aa
aa
aa
aa
aa
aa
aa
aa
aa
aa
ai
aB
az
ba
bk
ai
as
bL
ak
cr
cF
cM
cV
ai
de
ao
dj
ai
aa
aa
aa
aa
aa
aa
aa
aa
aa
aa
aa
"}
(25,1,1) = {"
aa
aa
aa
aa
aa
aa
aa
aa
aa
aa
aa
ai
aC
aO
bb
bl
bu
bF
bT
cg
cj
az
az
az
ai
df
ao
dk
ai
aa
aa
aa
aa
aa
aa
aa
aa
aa
aa
aa
"}
(26,1,1) = {"
aa
aa
aa
aa
aa
aa
aa
aa
aa
aa
aa
ak
aD
aw
bc
az
ai
bG
bU
cf
cs
cG
cN
cW
ai
dg
ao
ao
ai
aa
aa
aa
aa
aa
aa
aa
aa
aa
aa
aa
"}
(27,1,1) = {"
aa
aa
aa
aa
aa
aa
aa
aa
aa
aa
aa
ak
aE
aP
bc
aG
ai
ai
bV
ai
ct
ai
ai
ai
ai
ai
ai
ao
ai
aa
aa
aa
aa
aa
aa
aa
aa
aa
aa
aa
"}
(28,1,1) = {"
aa
aa
aa
aa
aa
aa
aa
aa
aa
aa
aa
ak
aF
aQ
bd
bm
ai
bH
bW
ch
bE
ab
ab
az
ai
ac
ai
ao
ai
aa
aa
aa
aa
aa
aa
aa
aa
aa
aa
aa
"}
(29,1,1) = {"
aa
aa
aa
aa
aa
aa
aa
aa
aa
aa
aa
ai
az
az
bc
bn
ai
bI
bd
ai
Bq
ab
ab
ab
ac
ac
ab
ab
ab
aa
aa
aa
aa
aa
aa
aa
aa
aa
aa
aa
"}
(30,1,1) = {"
aa
aa
aa
aa
aa
aa
aa
aa
aa
aa
aa
ai
aG
aR
bc
ai
ai
ai
bV
ai
Bq
ab
ab
ab
ab
ab
ab
ab
ab
aa
aa
aa
aa
aa
aa
aa
aa
aa
aa
aa
"}
(31,1,1) = {"
aa
aa
aa
aa
aa
aa
aa
aa
aa
ab
ab
ai
ai
ai
be
ai
Bq
ai
bX
bD
Bq
ab
ab
ab
ab
ab
ab
ab
ab
ab
ab
ab
ab
aa
aa
aa
aa
aa
aa
aa
"}
(32,1,1) = {"
aa
aa
aa
aa
aa
aa
aa
aa
aa
aa
ab
ab
ab
ao
bf
ai
Bq
ai
bY
ci
ab
ab
ab
ac
ac
ab
ab
ab
ab
ab
ab
ab
ab
aa
aa
aa
aa
aa
aa
aa
"}
(33,1,1) = {"
aa
aa
aa
aa
aa
aa
aa
aa
aa
aa
aa
aa
ab
ab
ab
ab
Bq
Bq
Bq
ab
ab
ab
ab
ab
ab
ab
ac
ac
ac
ab
ab
ac
ab
aa
aa
aa
aa
aa
aa
aa
"}
(34,1,1) = {"
aa
aa
aa
aa
aa
aa
aa
aa
aa
aa
aa
aa
aa
ab
ab
ab
ab
ab
Bq
ab
ab
ab
ab
ab
ab
ab
ab
ac
ab
ab
ab
ab
ab
aa
aa
aa
aa
aa
aa
aa
"}
(35,1,1) = {"
aa
aa
aa
aa
aa
aa
aa
aa
aa
aa
aa
aa
ab
ab
ab
ac
ac
ab
ab
ab
ab
ac
ab
ab
ab
ab
ab
ab
ab
ab
aa
aa
aa
aa
aa
aa
aa
aa
aa
aa
"}
(36,1,1) = {"
aa
aa
aa
aa
aa
aa
aa
aa
aa
aa
aa
aa
ab
ab
ab
ab
ac
ac
ab
ab
ab
ab
ab
ab
ab
ab
ab
ac
ac
ab
aa
aa
aa
aa
aa
aa
aa
aa
aa
aa
"}
(37,1,1) = {"
aa
aa
aa
aa
aa
aa
aa
aa
aa
aa
aa
aa
aa
aa
aa
ab
ab
ab
ab
aa
aa
ab
ab
ac
ac
ac
aa
aa
aa
aa
aa
aa
aa
aa
aa
aa
aa
aa
aa
aa
"}
(38,1,1) = {"
aa
aa
aa
aa
aa
aa
aa
aa
aa
aa
aa
aa
aa
aa
aa
aa
ab
ab
aa
aa
aa
aa
ab
ac
ac
aa
aa
aa
aa
aa
aa
aa
aa
aa
aa
aa
aa
aa
aa
aa
"}
(39,1,1) = {"
aa
aa
aa
aa
aa
aa
aa
aa
aa
aa
aa
aa
aa
aa
aa
aa
aa
aa
aa
aa
aa
aa
aa
aa
aa
aa
aa
aa
aa
aa
aa
aa
aa
aa
aa
aa
aa
aa
aa
aa
"}
(40,1,1) = {"
aa
aa
aa
aa
aa
aa
aa
aa
aa
aa
aa
aa
aa
aa
aa
aa
aa
aa
aa
aa
aa
aa
aa
aa
aa
aa
aa
aa
aa
aa
aa
aa
aa
aa
aa
aa
aa
aa
aa
aa
"}
