"a" = (/turf/closed/mineral,/area/ruin/powered)
"b" = (/turf/closed/wall,/area/ruin/powered)
"c" = (/mob/living/simple_animal/slime/random,/turf/open/floor/monotile/dark,/area/ruin/powered)
"d" = (/obj/item/shard,/turf/open/floor/monotile/dark,/area/ruin/powered)
"e" = (/obj/machinery/light{dir = 1},/turf/open/floor/monotile/dark,/area/ruin/powered)
"f" = (/turf/open/floor/monotile/dark,/area/ruin/powered)
"g" = (/obj/structure/window,/turf/open/floor/monotile/dark,/area/ruin/powered)
"h" = (/obj/structure/window,/obj/structure/window{dir = 4},/turf/open/floor/monotile/dark,/area/ruin/powered)
"i" = (/obj/structure/window,/obj/structure/window{dir = 8},/turf/open/floor/monotile/dark,/area/ruin/powered)
"j" = (/obj/machinery/door/airlock/ship{req_one_access_txt = "200"},/turf/open/floor/monotile,/area/ruin/powered)
"k" = (/mob/living/simple_animal/slime,/turf/open/floor/monotile/dark,/area/ruin/powered)
"l" = (/obj/structure/window{dir = 4},/turf/open/floor/monotile/dark,/area/ruin/powered)
"m" = (/obj/structure/chair{dir = 4},/turf/open/floor/monotile,/area/ruin/powered)
"n" = (/obj/structure/table,/turf/open/floor/monotile,/area/ruin/powered)
"o" = (/obj/machinery/light{dir = 1},/obj/structure/chair{dir = 8},/turf/open/floor/monotile,/area/ruin/powered)
"p" = (/turf/open/floor/monotile,/area/ruin/powered)
"q" = (/obj/structure/window,/mob/living/simple_animal/slime,/turf/open/floor/monotile/dark,/area/ruin/powered)
"r" = (/obj/structure/window{dir = 4},/obj/item/shard,/turf/open/floor/monotile/dark,/area/ruin/powered)
"s" = (/obj/machinery/door/airlock/ship{req_one_access_txt = "200"},/turf/open/floor/monotile/dark,/area/ruin/powered)
"t" = (/obj/structure/sign/poster/official/no_erp{pixel_x = 32},/obj/machinery/light{dir = 4},/turf/open/floor/monotile/dark,/area/ruin/powered)
"u" = (/obj/structure/table/glass,/turf/open/floor/monotile,/area/ruin/powered)
"v" = (/obj/structure/table/optable,/turf/open/floor/monotile/dark,/area/ruin/powered)
"w" = (/obj/structure/tank_dispenser,/turf/open/floor/monotile,/area/ruin/powered)
"x" = (/obj/machinery/light,/obj/structure/table/glass,/obj/item/toy/plush/slimeplushie,/turf/open/floor/monotile,/area/ruin/powered)
"y" = (/obj/structure/table/glass,/obj/item/book/random,/turf/open/floor/monotile,/area/ruin/powered)
"z" = (/obj/machinery/smartfridge/extract,/turf/open/floor/monotile,/area/ruin/powered)
"A" = (/obj/machinery/light{dir = 8},/turf/open/floor/monotile/dark,/area/ruin/powered)
"B" = (/obj/effect/mapping_helpers/airlock/cyclelink_helper,/obj/machinery/door/airlock/ship/external/glass,/turf/open/floor/plating,/area/ruin/powered)
"C" = (/obj/machinery/light/small{dir = 8},/turf/open/floor/plating,/area/ruin/powered)
"D" = (/obj/item/shard,/mob/living/simple_animal/slime,/turf/open/floor/monotile/dark,/area/ruin/powered)
"E" = (/turf/template_noop,/area/template_noop)
"F" = (/obj/structure/window{dir = 1},/turf/open/floor/monotile/dark,/area/ruin/powered)
"G" = (/obj/structure/window{dir = 4},/obj/structure/window{dir = 1},/turf/open/floor/monotile/dark,/area/ruin/powered)
"H" = (/obj/effect/mapping_helpers/airlock/cyclelink_helper{dir = 1},/obj/machinery/door/airlock/ship/external/glass,/turf/open/floor/plating,/area/ruin/powered)
"I" = (/obj/structure/lattice,/turf/template_noop,/area/template_noop)
"J" = (/obj/structure/lattice/catwalk,/turf/template_noop,/area/template_noop)

(1,1,1) = {"
EEEEEEEEEEEEEEEEEEEEEEEEEEEEEEEEEEEEEEEE
EEEEEEEEEEEEEEEEEEEEEEEEEEEEEEEEEEEEEEEE
EEEEEEEEEEEEEEEEEEEEEEEEEEEEEEEEEEEEEEEE
EEEEEEEEEEEEEEEEEEEEEEEEEEEEEEEEEEEEEEEE
EEEEEEEEEEEEEEEEEEEEEEEEEEEEEEEEEEEEEEEE
EEEEEEEEEEEEEEEEEEEEEEEEEEEEEEEEEEEEEEEE
EEEEEEEEEEEEEEEEEEEEEEEEEEEEEEEEEEEEEEEE
EEEEEEEEEEEEEEEEEEEEEEEEEEEEEEEEEEEEEEEE
EEEEEEEEEEEEEEEEEEEEEEEEEEEEEEEEEEEEEEEE
EEEEEEEEEEEEEEEEEEEEEEEEEEEEEEEEEEEEEEEE
EEEEEEEEEEEEEEEEEEEEEEEEEEEEEEEEEEEEEEEE
EEEEEEEEEaaaaaaaaaaaaaaaaaaaEEEEEEEEEEEE
EEEEEEEaaaaaaaaaaaaaaaaaaaaaaEEEEEEEEEEE
EEEEEEaaaaaaaaaaaaaaaaaaaaaaaaEEEEEEEEEE
EEEEEEaaaaaaaaaaaaaaaaaaaaaaaaaEEEEEEEEE
EEEEEaaaaaaaaaaaaaaaaaaaaaaaaaaaEEEEEEEE
EEEEEaaaaaaaaaaaaaaaaaaaaaaaaaaaaEEEEEEE
EEEEEaaaaaaaaaaaaaaaaaaaaaaaaaaaaEEEEEEE
EEEEEaaaaaaaaaaaaaaaaaaaaaaaaaaaaaEEEEEE
EEEEEaaaaaaaaaaaaaaaaaaaaaaaaaaaaaEEEEEE
EEEEEaaaaabbbbbbbbaaaaaaaaaaaaaaaaEEEEEE
EEEEaaaaaabcdefdcbaaaaaaaaaaaaaaaaEEEEEE
EEEEaaaaaabghffigbaaaaaaaaaaaaaaaaEEEEEE
EEEEaaaaaabffffffbaaabbbbbbbbbbaaaEEEEEE
EEEEaaaaaabbbbbbjbaaabkflkflffbaaaEEEEEE
EEEEaaaaaaabmnoppbaaabgqrgqrfkbaaaEEEEEE
EEEEaaaaaaabpppppbbbbbffffflffbaaaEEEEEE
EEEEaaaaaaabpppppppppsfffkfdftbaaaEEEEEE
EEEEaaaaaaabuppppppppbfffvflggbaaEEEEEEE
EEEEEaaaaaabbwpppuxyzbAfffflkfbaEEEEEEEE
EEEEEEEaaaaabbbBbbbbbbfcfffdffbaaEEEEEEE
EEEEEEEEaaaaaabCbaaaabDFGdFGfkbaEEEEEEEE
EEEEEEEEEEaaaabHbaaaabfklfklfbbEEEEEEEEE
EEEEEEEEEEEaaIJJJIIaabbbbbbbbbEEEEEEEEEE
EEEEEEEEEEEEEIJJJIEEaaaaaaaaaaEEEEEEEEEE
EEEEEEEEEEEEEEJJJEEEEEaaaaaaaEEEEEEEEEEE
EEEEEEEEEEEEEEEEEEEEEEEEEEEEEEEEEEEEEEEE
EEEEEEEEEEEEEEEEEEEEEEEEEEEEEEEEEEEEEEEE
EEEEEEEEEEEEEEEEEEEEEEEEEEEEEEEEEEEEEEEE
EEEEEEEEEEEEEEEEEEEEEEEEEEEEEEEEEEEEEEEE
"}
