"a" = (/turf/template_noop,/area/template_noop)
"b" = (/turf/open/water{initial_gas_mix = "TEMP=2.7"},/area/ruin/powered)
"c" = (/obj/structure/light_prism,/turf/open/floor/plating/asteroid/airless,/area/ruin/powered)
"d" = (/obj/item/reagent_containers/glass/waterbottle{list_reagents = list(/datum/reagent/snail = 10);name = "bottle of snail juice"},/obj/structure/table/wood,/turf/open/floor/plating/asteroid/airless,/area/ruin/powered)
"g" = (/turf/closed/mineral,/area/ruin/powered)
"h" = (/turf/open/floor/plating/asteroid/airless,/area/ruin/powered)

(1,1,1) = {"
aaaaaaaaaaaaaaaaaaaaaaaaaaaaaaaaaaaaaaaa
aaaaaaaaaaaaaaaaaaaaaaaaaaaaaaaaaaaaaaaa
aaaaaaaaaaaaaaaaaaaaaaaaaaaaaaaaaaaaaaaa
aaaaaaaaaaaaaaaaaaaaaaaaaaaaaaaaaaaaaaaa
aaaaaaaaaaaaaaaaaaaaaaaaaaaaaaaaaaaaaaaa
aaaaaaaaaaaaaaaaaaaaagggaaaaaaaaaaaaaaaa
aaaaaaaaaaaagggaaaaggggggaaaaaaaaaaaaaaa
aaaaaaaaaaagggggagggggggggaaaaaaaaaaaaaa
aaaaaaaaaaaggggggggggggggggggaaaaaaaaaaa
aaaaaaaaaaggggggggggggggggggggggaaaaaaaa
aaaaaaaaaagggggggggggggggggggggggaaaaaaa
aaaaaaaaagggggggggggggggggggggggggggaaaa
aaaaaaaagggggggbbbgggggggggggggggggggaaa
aaaaagggggbbbbgggbggbbbggggggggggggggaaa
aaaagggbbgbggbgggbggbggggggbbgggggggaaaa
aaaagggbbbbggbggbbbbbbbbbbbbbgggggggaaaa
aaagggggbbbggbbbbbbggbgggggbbggggggaaaaa
aaagggggbbbgggggbbbgbbggggggbggggggaaaaa
aaaggggggbgggggbbgggbggggggbbgggggggaaaa
aaaggggggbgggggggggggggggggbggggggggaaaa
aaaagggggbgbgggggggggggggggbggggggggaaaa
aaaaaggbbbbbgggggggggggggbbbbgggggggaaaa
aaaaaggggbbbgggggggggggggbbbbggggggaaaaa
aaaagggggggbgggggggggggggggbggghcgggaaaa
aaaggggggggbgggggggggggggggbbbbhdggggaaa
aaagggggbbgbggggggggbggbbbbbggghcggggaaa
aaaggggggbbbbbggggggbbbbbggbgggggggggaaa
aaaagggbbbbbbbgbbggggggbbggggggggggggaaa
aaaagggggbbbbbggbgggbggbbbbbbgggggggaaaa
aaaaaggggbbbbbbbbbbbbggbggggbgggggggaaaa
aaaaaggggggggggggbgggggbggggbbbggggaaaaa
aaaaaagggggggggggbbbbbbbggggbbbggggaaaaa
aaaaaaagggggggggggggggggggggbbbgggaaaaaa
aaaaaaaaggggggggggggggggggggggggaaaaaaaa
aaaaaaaaaagggggggggggggggggggggaaaaaaaaa
aaaaaaaaaaaaaggggagggggggggggggaaaaaaaaa
aaaaaaaaaaaaaaaaaaaaggggaaggggaaaaaaaaaa
aaaaaaaaaaaaaaaaaaaaaaaaaaaaaaaaaaaaaaaa
aaaaaaaaaaaaaaaaaaaaaaaaaaaaaaaaaaaaaaaa
aaaaaaaaaaaaaaaaaaaaaaaaaaaaaaaaaaaaaaaa
"}
