"a" = (/turf/template_noop,/area/template_noop)
"b" = (/turf/closed/mineral,/area/ruin/powered)
"c" = (/turf/open/floor/plating/asteroid/airless,/area/ruin/powered)
"d" = (/obj/structure/dead_ratvar,/turf/open/floor/plating/asteroid/airless,/area/ruin/powered)
"e" = (/obj/item/stack/tile/brass,/obj/item/stack/tile/brass,/obj/item/stack/tile/brass,/turf/open/floor/plating/asteroid/airless,/area/ruin/powered)

(1,1,1) = {"
aaaaaaaaaaaaaaaaaaaaaaaaaaaaaaaaaaaaaaaa
aaaaaaaaaaaaaaaaaaaaaaaaaaaaaaaaaaaaaaaa
aaaaaaaaaaaaaaaaaaaaaaaaaaaaaaaaaaaaaaaa
aaaaaaaaaaaaaaaaaaaaaaaaaaaaaaaaaaaaaaaa
aaaaaaaaaaaaaaaaaaaaaaaaaaaaaaaaaaaaaaaa
aaaaaaaaaaaaaaaaaaaaaaaaaaaaaaaaaaaaaaaa
aaaaaaaaaabbbbbaaaaaaaaaaaaaaaaaaaaaaaaa
aaaaaaabbbbbbbbbbbaaabbbbbbabbbbbbaaaaaa
aaaaaabbbbbbbbbbbbbbbbbbbbbbbbbbbbbaaaaa
aaaaabbbbbbbbbbbbbbbbbbbbbbbbbbbbbbaaaaa
aaaaabbbbbbbbbbbbbbbbbbbbbbbbbbbbbbbaaaa
aaaaabbbbbbbbbbbbbbbbbbbbbbbbbbbbbbbbaaa
aaaaabbbbbbbbbbbbbbbbbbbbbbbbbbbbbbbbbaa
aaaaabbbbbbbbbbbbbbbbbbbbbbbbbbbbbbbbbba
aaaaaabbbbbbbbbbbbbbbbbbbbbbbbbbbbbbbbba
aaaaaabbbbbbbbbbbbbbbbbbbbbbbbbbbbbbbbba
aaaaaabbbbbbbbbbbbbbbbbbbbbbbbbbbbbbbbba
aaaaabbbbbbbbbbbbbbbbbbbbbbbbbbbbbbbbbba
aaaaabbbbbbbbbbbbbbbbbbbbbbbbbbbbbbbbbba
aaaaabbbbbbbbbbbbbbbbbbbbbbbbbbbbbbbbbba
aaaaabbbbbbbbbbbbbbbbbbbbbbbbbbbbbbbbbba
aaaaaabbbbbbbbbbbbbbbbbbbbbbbbbbbbbbbbba
aaaabbbbbbbbbbbbbbbbbbbbbbbbbbbbbbbbbbba
aaabbbbbbbbbbbbbbbbbbbbbbbbbbbbbbbbbbbba
aaabbbbbbbbbbbbbbbbbbbbbbbbbbbbbbbbbbbaa
aaabbbbbbbbbbbbbbbbbbbbbbbbbbbbbbbbbbbaa
aaabbbbbbbbbbbbbbbbbccbbbbbbbbbbbbbbbaaa
aaaabbbbbbbbbbbbbbbccccbbbbbbbbbbbbbaaaa
aaaabbbbbbbbbbbbbbcccccccbbbbbbbbbbbbaaa
aaaaabbbbbbbbbbbbccccccccccbbbbbbbbbbaaa
aaaaabbbbbbbbbbbccccccccccccbbbbbbbbbaaa
aaaaaabbbbbbbbbccccccccccccccbbbbbbbaaaa
aaaaaaabbbbbbbcdcccccccccccccbbbbbbaaaaa
aaaaaaaaabbbbbbeccccccccccccbbbbbaaaaaaa
aaaaaaaaaabbbbbbbbcccccccbbbbbbaaaaaaaaa
aaaaaaaaaaabbbbbbbbbbbbbbbbbbaaaaaaaaaaa
aaaaaaaaaaabbbabbbbbbbbbbbbbaaaaaaaaaaaa
aaaaaaaaaaaaaaaaabbbbbabbbbaaaaaaaaaaaaa
aaaaaaaaaaaaaaaaaaaaaaaaaaaaaaaaaaaaaaaa
aaaaaaaaaaaaaaaaaaaaaaaaaaaaaaaaaaaaaaaa
"}
