"a" = (/turf/open/space/basic,/area/space)
"b" = (/turf/closed/mineral/random,/area/ruin/powered)
"c" = (/turf/open/floor/plating/asteroid,/area/ruin/powered)
"d" = (/obj/structure/flora/tree/palm,/turf/open/floor/plating/asteroid,/area/ruin/powered)
"e" = (/mob/living/simple_animal/pet/gondola,/turf/open/floor/plating/asteroid,/area/ruin/powered)
"f" = (/obj/structure/flora/ausbushes/palebush,/turf/open/floor/plating/asteroid,/area/ruin/powered)
"g" = (/obj/structure/flora/ausbushes/ywflowers,/turf/open/floor/plating/asteroid,/area/ruin/powered)
"h" = (/obj/structure/flora/ausbushes/stalkybush,/turf/open/floor/plating/asteroid,/area/ruin/powered)
"i" = (/obj/structure/flora/ausbushes/ppflowers,/turf/open/floor/plating/asteroid,/area/ruin/powered)
"j" = (/obj/effect/overlay/coconut,/turf/open/floor/plating/asteroid,/area/ruin/powered)
"k" = (/mob/living/simple_animal/pet/gondola{icon_state = "gondola"; dir = 8},/turf/open/floor/plating/asteroid,/area/ruin/powered)
"l" = (/obj/structure/flora/ausbushes/lavendergrass,/turf/open/floor/plating/asteroid,/area/ruin/powered)
"m" = (/obj/machinery/light,/turf/open/floor/plating/asteroid,/area/ruin/powered)
"n" = (/obj/structure/flora/rock{name = "rock of tranquility"},/turf/open/floor/plating/asteroid,/area/ruin/powered)
"o" = (/obj/structure/flora/ausbushes/fernybush,/turf/open/floor/plating/asteroid,/area/ruin/powered)
"p" = (/turf/closed/wall/steel,/area/ruin/powered)
"q" = (/obj/item/a_gift,/turf/open/floor/plating/asteroid,/area/ruin/powered)
"r" = (/obj/effect/spawner/structure/window/reinforced,/turf/open/floor/plating,/area/ruin/powered)
"s" = (/obj/structure/table/wood/bar,/obj/machinery/chem_dispenser/drinks/beer,/turf/open/floor/carpet/black,/area/ruin/powered)
"t" = (/obj/structure/table/wood/bar,/obj/machinery/chem_dispenser/drinks,/turf/open/floor/carpet/black,/area/ruin/powered)
"u" = (/obj/structure/table/wood/bar,/obj/machinery/reagentgrinder,/turf/open/floor/carpet/black,/area/ruin/powered)
"v" = (/obj/structure/sign/poster/official/help_others{pixel_y = 32},/obj/structure/closet/secure_closet/bar,/turf/open/floor/carpet/black,/area/ruin/powered)
"w" = (/turf/open/floor/carpet/black,/area/ruin/powered)
"x" = (/mob/living/simple_animal/pet/gondola,/turf/open/floor/carpet/black,/area/ruin/powered)
"y" = (/obj/structure/sign/poster/official/no_erp{pixel_x = 32},/turf/open/floor/plating/asteroid,/area/ruin/powered)
"z" = (/obj/structure/table/wood/fancy,/turf/open/floor/carpet/black,/area/ruin/powered)
"A" = (/obj/structure/table/wood/fancy,/obj/item/clothing/head/collectable/tophat,/turf/open/floor/carpet/black,/area/ruin/powered)
"B" = (/mob/living/simple_animal/pet/gondola{icon_state = "gondola"; dir = 4},/turf/open/floor/plating/asteroid,/area/ruin/powered)
"C" = (/obj/machinery/light{dir = 4},/turf/open/floor/plating/asteroid,/area/ruin/powered)
"D" = (/obj/structure/chair/stool/bar,/obj/machinery/light{dir = 8},/turf/open/floor/carpet/black,/area/ruin/powered)
"E" = (/obj/structure/chair/stool/bar,/turf/open/floor/carpet/black,/area/ruin/powered)
"F" = (/obj/structure/table/wood/poker,/turf/open/floor/carpet/black,/area/ruin/powered)
"G" = (/obj/machinery/light{dir = 4},/turf/open/floor/carpet/black,/area/ruin/powered)
"H" = (/obj/machinery/light{dir = 8},/turf/open/floor/plating/asteroid,/area/ruin/powered)
"I" = (/obj/structure/mineral_door/paperframe,/turf/open/floor/plating,/area/ruin/powered)
"J" = (/mob/living/simple_animal/pet/gondola{icon_state = "gondola"; dir = 4},/turf/open/floor/carpet/black,/area/ruin/powered)
"K" = (/obj/structure/table/wood/poker,/obj/item/skub,/turf/open/floor/carpet/black,/area/ruin/powered)
"L" = (/obj/structure/sign/poster/official/no_erp{pixel_x = 32},/mob/living/simple_animal/pet/gondola{icon_state = "gondola"; dir = 8},/turf/open/floor/carpet/black,/area/ruin/powered)
"M" = (/obj/structure/flora/ausbushes/genericbush,/turf/open/floor/plating/asteroid,/area/ruin/powered)
"N" = (/obj/structure/piano,/turf/open/floor/carpet/black,/area/ruin/powered)
"O" = (/obj/structure/chair/wood{icon_state = "wooden_chair"; dir = 8},/turf/open/floor/carpet/black,/area/ruin/powered)
"P" = (/mob/living/simple_animal/pet/gondola{icon_state = "gondola"; dir = 1},/turf/open/floor/carpet/black,/area/ruin/powered)
"Q" = (/obj/machinery/door/airlock/external,/obj/effect/mapping_helpers/airlock/cyclelink_helper,/turf/open/floor/plating,/area/ruin/powered)
"R" = (/obj/structure/closet/cardboard,/mob/living/simple_animal/pet/gondola{name = "benis snake"},/turf/open/floor/plating/asteroid,/area/ruin/powered)
"S" = (/obj/structure/sign/warning/vacuum{pixel_x = 32},/turf/open/floor/plating,/area/ruin/powered)
"T" = (/obj/structure/lattice,/turf/open/space/basic,/area/space)
"U" = (/obj/structure/sign/barsign,/turf/closed/wall/steel,/area/ruin/powered)
"V" = (/obj/machinery/door/airlock/external,/obj/effect/mapping_helpers/airlock/cyclelink_helper{dir = 1},/obj/structure/fans/tiny/invisible,/turf/open/floor/plating,/area/ruin/powered)
"W" = (/obj/structure/lattice/catwalk,/turf/open/space/basic,/area/space)

(1,1,1) = {"
aaaaaaaaaaaaaaaaaaaaaaaaaaaaaaaaaaaaaaaa
aaaaaaaaaaaaaaaaaaaaaaaaaaaaaaaaaaaaaaaa
aaaaaaaaaaaaaaaaaaaaaaaaaaaaaaaaaaaaaaaa
aaaaaaaaaaaaaaaaaaaaaaaaaaaaaaaaaaaaaaaa
aaaaaaaaaaaaaaaaaaaaaaaaaaaaaaaaaaaaaaaa
aaaaaaaaaaaaaaaaaaaaaaaaaaaaaaaaaaaaaaaa
aaaaaaaaaaaaaaaaaaaaaaaaaaaaaaaaaaaaaaaa
aaaaaaaaaaaaaaaaaaaaaaaaaaaaaaaaaaaaaaaa
aaaaaaaaaaaaaaaaaaaaaaaaaaaaaaaaaaaaaaaa
aaaaaaaaaaaaaabbbaaabaaaaabbbbaaaaaaaaaa
aaaaaaaaaaaabbbbbbbabbbbbbbbbbbbbaaaaaaa
aaaaaaaaaaaabbbbbbbbbbbbbbbbbbbbbbaaaaaa
aaaaaaaaaabbbbbbbbbbbbbbbbbbbbbbbbaaaaaa
aaaaaaaabbbbbbbbbbbbbbbbbbbbbbbbbbaaaaaa
aaaaaaaabbbbbbbbbbbbbbbbbbbbbbbbbbbaaaaa
aaaaaaaaabbbbbbbbbbbbbbbbbbbbbbbbbbbaaaa
aaaaaaaaabbbbbbbbbbbbbbbbbbbbbbbbbbbbaaa
aaaaaaaabbbbbbbbbbbbbbbbbbbbbbbbbbbbbbaa
aaaaaaabbbbbbbbbbbbbbbbbbbbbbbbbbbbbbbba
aaaaaabbbbbbbbbbbbbbbbbbbbbbbbbbbbbbbbba
aaaaaabbbbbbcccbbbbbbbbbbbbbbbbbbbbbbbba
aaaaaabbbbbccccccbbbbbbbbbbbbbbbbbbbbbba
aaaaaabbbbcccdceccbbbbbbbbbbbbbbbbbbbbba
aaaaaabbbcefccgcccchccccccccccccbbbbbbaa
aaaaaabbbcccijcgccccccccklccccccbbbbbbaa
aaaaaabbbchcccecccccmcicccccccccbbbbbbba
aaaaaabbbccecnccocppppppccmcccccbbbbbbba
aaaaaaabbccccqciccrstuvppppppcccbbbbbbaa
aaaaaaaabbcgccccccrwxwwwwwwwpcccbbbbbaaa
aaaaaaaabbbceccecypzzAzwwxwwpcBcbbbbbaaa
aaaaaaaaabbbcccccCpDEEEwwFFGpHdcbbbbaaaa
aaaaaaaaaabbbbbbccIwwwwwJKFLpjccbbbaaaaa
aaabbaaaaaabbbbbbcpwwwwwwFFwpMccbbaaaaaa
aabbbbaaaaaaaaabbbpNOwwwwPwwpbbbbbaaaaaa
abbbbbbaaaaaaaaabbpppQpprrrppbbbbaaaaaaa
abbbRbbaaaaaaaaaabbbpSpTTaaaaaaaaaaaaaaa
aabbbbbaaaaaaaaaaabUpVUpTaaaaaaaaaaaaaaa
aaabbbaaaaaaaaaaaaTWWWWWTaaaaaaaaaaaaaaa
aaaaaaaaaaaaaaaaaaaaaaaaaaaaaaaaaaaaaaaa
aaaaaaaaaaaaaaaaaaaaaaaaaaaaaaaaaaaaaaaa
"}
