//MAP CONVERTED BY dmm2tgm.py THIS HEADER COMMENT PREVENTS RECONVERSION, DO NOT REMOVE
"a" = (
/obj/machinery/light,
/obj/structure/closet/crate,
/obj/item/storage/box/lights,
/obj/item/restraints/handcuffs,
/obj/item/restraints/handcuffs,
/obj/item/bodybag,
/turf/open/floor/plating/airless{
	icon_state = "platingdmg1"
	},
/area/ruin/powered)
"c" = (
/obj/structure/table,
/turf/open/floor/plating/airless{
	icon_state = "platingdmg1"
	},
/area/ruin/powered)
"d" = (
/obj/machinery/door/airlock/ship/engineering{
	req_one_access_txt = "200"
	},
/turf/open/floor/plating/airless,
/area/ruin/powered)
"e" = (
/obj/machinery/door/airlock/ship/command{
	name = "Bridge";
	req_one_access_txt = "200"
	},
/turf/open/floor/plating/airless,
/area/ruin/powered)
"f" = (
/obj/machinery/door/airlock/ship/external/glass,
/obj/effect/mapping_helpers/airlock/cyclelink_helper{
	dir = 1
	},
/turf/open/floor/plating/airless,
/area/ruin/powered)
"g" = (
/obj/item/shard{
	icon_state = "small"
	},
/obj/structure/grille/broken,
/turf/open/floor/plating/airless,
/area/ruin/powered)
"h" = (
/obj/structure/shuttle/engine/heater{
	dir = 4
	},
/obj/structure/window/reinforced{
	dir = 8
	},
/turf/open/floor/engine/airless,
/area/ruin/powered)
"j" = (
/obj/machinery/light{
	dir = 1
	},
/turf/open/floor/plating/airless,
/area/ruin/powered)
"k" = (
/turf/open/floor/plating/asteroid/airless,
/area/ruin/powered)
"l" = (
/obj/structure/shuttle/engine/propulsion{
	dir = 4
	},
/turf/template_noop,
/area/ruin/powered)
"m" = (
/obj/item/shard,
/turf/open/floor/plating/airless,
/area/ruin/powered)
"n" = (
/obj/item/reagent_containers/food/drinks/beer,
/turf/open/floor/plating/airless,
/area/ruin/powered)
"o" = (
/obj/structure/frame/computer{
	anchored = 1;
	dir = 4
	},
/turf/open/floor/plating/airless{
	icon_state = "platingdmg1"
	},
/area/ruin/powered)
"p" = (
/obj/structure/closet/crate/freezer,
/obj/item/reagent_containers/food/snacks/meat/slab,
/obj/item/reagent_containers/food/snacks/meat/slab,
/obj/item/organ/appendix,
/turf/open/floor/plating/airless,
/area/ruin/powered)
"q" = (
/obj/structure/closet/secure_closet/freezer/meat/open{
	opened = 1
	},
/turf/open/floor/plating/airless,
/area/ruin/powered)
"r" = (
/turf/closed/wall/mineral/titanium/interior,
/area/ruin/powered)
"s" = (
/obj/structure/closet/crate,
/obj/item/stack/sheet/mineral/uranium{
	amount = 50
	},
/obj/item/stack/sheet/mineral/uranium{
	amount = 50
	},
/turf/open/floor/plating/airless,
/area/ruin/powered)
"t" = (
/obj/item/clothing/glasses/regular/hipster,
/turf/open/floor/plating/airless,
/area/ruin/powered)
"u" = (
/obj/machinery/light/small{
	dir = 8
	},
/turf/open/floor/plating/airless{
	icon_state = "platingdmg1"
	},
/area/ruin/powered)
"v" = (
/turf/open/floor/plating/airless{
	icon_state = "platingdmg1"
	},
/area/ruin/powered)
"w" = (
/obj/item/shard{
	icon_state = "small"
	},
/obj/structure/grille,
/turf/open/floor/plating/airless,
/area/ruin/powered)
"x" = (
/obj/structure/closet/crate/freezer,
/obj/item/organ/brain,
/obj/item/reagent_containers/food/snacks/meat/slab/human/mutant/slime,
/turf/open/floor/plating/airless,
/area/ruin/powered)
"y" = (
/obj/machinery/recharger,
/obj/structure/table,
/turf/open/floor/plating/airless,
/area/ruin/powered)
"z" = (
/obj/structure/table,
/turf/open/floor/plating/airless,
/area/ruin/powered)
"A" = (
/turf/closed/wall/mineral/titanium/overspace,
/area/ruin/powered)
"C" = (
/obj/machinery/teleport/station,
/obj/machinery/light{
	dir = 1
	},
/turf/open/floor/plating/airless,
/area/ruin/powered)
"D" = (
/turf/closed/mineral,
/area/ruin/powered)
"E" = (
/obj/structure/reagent_dispensers/fueltank,
/turf/open/floor/plating/airless,
/area/ruin/powered)
"F" = (
/turf/closed/wall/mineral/titanium/nodiagonal,
/area/ruin/powered)
"H" = (
/obj/structure/table_frame,
/turf/open/floor/plating/airless,
/area/ruin/powered)
"J" = (
/obj/machinery/teleport/hub,
/turf/open/floor/plating/airless,
/area/ruin/powered)
"K" = (
/turf/open/floor/plating/airless,
/area/ruin/powered)
"L" = (
/obj/machinery/light{
	dir = 8
	},
/turf/open/floor/plating/airless{
	icon_state = "platingdmg1"
	},
/area/ruin/powered)
"M" = (
/obj/structure/reagent_dispensers,
/turf/open/floor/plating/airless,
/area/ruin/powered)
"O" = (
/obj/structure/closet/crate,
/obj/item/clothing/under/misc/overalls,
/turf/open/floor/plating/airless,
/area/ruin/powered)
"P" = (
/obj/structure/table,
/obj/machinery/microwave,
/turf/open/floor/plating/airless,
/area/ruin/powered)
"Q" = (
/obj/effect/spawner/structure/window/reinforced,
/turf/open/floor/plating,
/area/ruin/powered)
"R" = (
/obj/structure/rack,
/obj/item/storage/belt/utility/full,
/turf/open/floor/plating/airless,
/area/ruin/powered)
"T" = (
/obj/machinery/computer/teleporter,
/turf/open/floor/plating/airless,
/area/ruin/powered)
"U" = (
/obj/machinery/door/airlock/ship/external/glass,
/obj/effect/mapping_helpers/airlock/cyclelink_helper,
/turf/open/floor/plating/airless,
/area/ruin/powered)
"W" = (
/turf/open/space/basic,
/area/space)
"Y" = (
/obj/structure/ore_box,
/turf/open/floor/plating/airless,
/area/ruin/powered)
"Z" = (
/obj/machinery/light{
	dir = 8
	},
/turf/open/floor/plating/airless,
/area/ruin/powered)

(1,1,1) = {"
W
W
W
W
W
W
W
W
W
W
W
W
W
W
W
W
W
W
W
W
W
W
W
W
W
W
W
W
W
W
W
W
W
W
W
W
W
W
W
W
"}
(2,1,1) = {"
W
W
W
W
W
W
W
W
W
W
W
W
W
W
W
W
W
W
W
W
W
W
W
W
W
W
W
W
W
W
W
W
W
W
W
W
W
W
W
W
"}
(3,1,1) = {"
W
W
W
W
W
W
W
W
W
W
W
W
W
W
W
W
W
W
W
W
W
W
W
W
W
W
W
W
W
W
W
W
W
W
W
W
W
W
W
W
"}
(4,1,1) = {"
W
W
W
W
D
D
D
D
W
W
W
W
W
W
W
W
W
W
W
W
W
W
W
W
W
W
W
W
W
W
W
W
W
W
W
W
W
W
W
W
"}
(5,1,1) = {"
W
W
W
D
D
D
D
D
D
D
W
W
W
W
W
W
W
W
W
W
W
W
W
W
W
W
W
W
W
W
W
W
W
W
W
W
W
W
W
W
"}
(6,1,1) = {"
W
W
D
D
D
D
D
D
D
D
D
W
W
W
W
W
W
W
W
W
W
W
W
W
W
W
W
W
W
W
W
W
W
W
W
W
W
W
W
W
"}
(7,1,1) = {"
W
W
D
D
D
D
D
D
D
D
D
D
W
W
W
W
W
W
W
W
W
W
W
W
W
W
D
D
D
D
W
D
D
D
D
D
W
W
W
W
"}
(8,1,1) = {"
W
D
D
D
D
D
D
D
D
D
D
D
D
W
W
W
W
W
W
W
W
W
W
W
D
D
D
D
D
D
D
D
D
D
D
D
D
W
W
W
"}
(9,1,1) = {"
W
D
D
D
D
D
D
D
D
D
D
D
D
D
W
W
W
W
W
W
W
W
D
D
D
D
D
D
D
D
D
D
D
D
D
D
D
D
W
W
"}
(10,1,1) = {"
D
D
D
D
D
D
D
D
D
D
D
D
D
D
W
W
W
W
W
W
D
D
D
D
D
D
D
D
D
D
D
D
D
D
D
D
D
D
D
W
"}
(11,1,1) = {"
D
D
D
D
D
D
D
D
D
D
D
D
D
W
W
W
W
W
W
W
D
D
D
D
D
D
D
D
D
D
D
D
D
D
D
D
D
D
D
W
"}
(12,1,1) = {"
D
D
D
D
D
D
D
D
D
D
D
D
D
W
W
W
W
D
D
D
D
D
D
D
D
D
D
D
D
D
D
D
D
D
D
D
D
D
D
D
"}
(13,1,1) = {"
D
D
D
D
D
D
D
D
D
D
D
D
W
W
W
W
W
D
D
D
D
D
D
D
D
D
D
D
D
D
D
D
D
D
D
D
D
D
D
D
"}
(14,1,1) = {"
D
D
D
D
D
D
D
D
D
D
D
W
W
W
W
W
D
D
D
D
D
D
D
D
D
D
D
D
D
D
D
D
D
D
D
D
D
D
D
D
"}
(15,1,1) = {"
D
D
D
D
D
D
D
D
D
D
D
W
W
W
W
W
D
D
D
D
D
D
D
D
D
D
D
D
D
D
D
D
D
D
D
D
D
D
D
D
"}
(16,1,1) = {"
D
D
D
D
D
D
D
D
D
D
W
W
W
W
W
W
D
D
D
D
D
D
D
D
D
D
D
D
D
D
D
D
D
D
D
D
D
D
D
D
"}
(17,1,1) = {"
D
D
D
D
D
D
D
D
D
W
W
W
W
W
W
W
D
D
D
D
D
D
D
D
D
D
D
D
D
D
D
D
D
D
D
D
D
D
D
D
"}
(18,1,1) = {"
W
D
D
D
D
D
W
D
W
W
W
W
W
W
W
D
D
D
D
D
D
D
D
D
D
D
D
D
D
D
D
D
D
D
D
D
D
D
D
W
"}
(19,1,1) = {"
W
D
D
D
D
D
W
W
W
W
W
W
W
W
W
D
D
D
D
D
D
D
r
r
w
g
Q
r
r
D
D
D
D
D
D
D
D
D
D
W
"}
(20,1,1) = {"
W
W
D
D
D
W
W
W
W
W
W
W
W
W
W
D
D
D
D
D
D
D
r
y
o
H
o
v
r
D
D
D
D
D
D
D
D
D
W
W
"}
(21,1,1) = {"
W
W
W
W
W
W
W
W
W
W
W
W
W
W
D
D
D
D
D
D
D
D
r
K
v
v
K
K
r
D
D
D
D
D
D
D
D
D
W
W
"}
(22,1,1) = {"
W
W
W
W
W
W
W
W
W
W
W
W
W
D
D
D
D
D
D
D
D
F
F
F
j
v
K
F
F
F
D
D
D
D
D
D
D
D
W
W
"}
(23,1,1) = {"
W
W
W
W
W
W
W
W
W
W
W
W
D
D
D
D
D
D
D
D
D
r
q
F
r
e
r
F
v
r
D
D
D
D
D
D
D
D
W
W
"}
(24,1,1) = {"
W
W
W
W
W
W
W
W
W
W
W
W
D
D
D
D
D
D
D
D
D
r
K
L
P
K
K
Z
K
r
D
D
D
D
D
D
D
W
W
W
"}
(25,1,1) = {"
W
W
W
W
W
W
W
W
W
W
W
D
D
D
D
D
D
D
D
D
F
r
K
m
z
K
v
K
F
F
F
k
D
D
D
D
W
W
W
W
"}
(26,1,1) = {"
W
W
W
W
W
W
W
W
W
W
D
D
D
D
D
D
D
D
D
D
r
p
K
c
z
K
K
K
U
u
f
k
k
D
D
W
W
W
W
W
"}
(27,1,1) = {"
W
W
W
W
W
W
W
W
W
W
W
D
D
D
D
D
D
D
D
D
r
x
K
K
n
K
K
K
U
K
f
k
k
D
D
W
W
W
W
W
"}
(28,1,1) = {"
W
W
W
W
W
W
W
W
W
W
W
D
D
D
D
D
D
D
D
D
F
F
F
d
F
F
d
F
F
F
F
D
D
D
D
W
W
W
W
W
"}
(29,1,1) = {"
W
W
W
W
W
W
W
W
W
W
W
W
D
D
D
D
D
D
D
D
D
r
K
K
K
K
v
m
Y
r
D
D
D
D
D
D
W
W
W
W
"}
(30,1,1) = {"
W
W
W
W
W
W
W
W
W
W
W
W
W
D
D
D
D
D
D
D
D
r
K
v
K
K
v
K
Y
r
D
D
D
D
D
D
D
W
W
W
"}
(31,1,1) = {"
W
W
W
W
W
W
W
W
W
W
W
W
W
W
W
D
D
D
D
D
D
F
r
T
v
K
K
s
r
F
D
D
D
D
D
D
D
W
W
W
"}
(32,1,1) = {"
W
W
W
W
W
W
W
W
W
W
W
W
W
W
W
W
W
D
D
D
D
D
r
C
K
t
K
a
r
D
D
D
D
D
D
D
D
W
W
W
"}
(33,1,1) = {"
W
W
W
W
W
W
W
W
W
W
W
W
W
W
W
W
W
W
W
D
D
D
r
J
v
K
K
O
r
D
D
D
D
D
D
D
W
W
W
W
"}
(34,1,1) = {"
W
W
W
W
W
W
W
W
W
W
W
W
W
W
W
W
W
W
W
W
D
D
F
r
K
K
K
r
r
D
D
W
D
D
D
W
W
W
W
W
"}
(35,1,1) = {"
W
W
W
W
W
W
W
W
W
W
W
W
W
W
W
W
W
W
W
W
W
D
D
r
R
E
M
r
A
W
W
W
W
W
W
W
W
W
W
W
"}
(36,1,1) = {"
W
W
W
W
W
W
W
W
W
W
W
W
W
W
W
W
W
W
W
W
W
W
W
r
h
h
h
r
W
W
W
W
W
W
W
W
W
W
W
W
"}
(37,1,1) = {"
W
W
W
W
W
W
W
W
W
W
W
W
W
W
W
W
W
W
W
W
W
W
W
A
l
l
l
A
W
W
W
W
W
W
W
W
W
W
W
W
"}
(38,1,1) = {"
W
W
W
W
W
W
W
W
W
W
W
W
W
W
W
W
W
W
W
W
W
W
W
W
W
W
W
W
W
W
W
W
W
W
W
W
W
W
W
W
"}
(39,1,1) = {"
W
W
W
W
W
W
W
W
W
W
W
W
W
W
W
W
W
W
W
W
W
W
W
W
W
W
W
W
W
W
W
W
W
W
W
W
W
W
W
W
"}
(40,1,1) = {"
W
W
W
W
W
W
W
W
W
W
W
W
W
W
W
W
W
W
W
W
W
W
W
W
W
W
W
W
W
W
W
W
W
W
W
W
W
W
W
W
"}
