//MAP CONVERTED BY dmm2tgm.py THIS HEADER COMMENT PREVENTS RECONVERSION, DO NOT REMOVE
"aa" = (
/turf/open/floor/plating,
/area/space)
"ab" = (
/turf/closed/wall/r_wall/ship,
/area/space)
"ac" = (
/obj/machinery/clonepod,
/obj/machinery/shower{
	dir = 4
	},
/turf/open/floor/plasteel/white,
/area/space)
"ad" = (
/obj/machinery/computer/cloning,
/obj/machinery/airalarm{
	pixel_y = 26
	},
/turf/open/floor/plasteel/white,
/area/space)
"ae" = (
/obj/machinery/dna_scannernew,
/turf/open/floor/plasteel/white,
/area/space)
"af" = (
/obj/machinery/atmospherics/components/unary/thermomachine/freezer/on/coldroom{
	dir = 1
	},
/obj/item/reagent_containers/glass/beaker/cryoxadone,
/obj/item/wrench/medical,
/turf/open/floor/plasteel/ship/techfloor,
/area/space)
"ag" = (
/obj/machinery/atmospherics/components/unary/portables_connector{
	dir = 2
	},
/obj/machinery/portable_atmospherics/canister/oxygen,
/obj/machinery/power/apc/auto_name/north,
/obj/structure/cable{
	icon_state = "0-2"
	},
/turf/open/floor/plasteel/white,
/area/space)
"ah" = (
/obj/machinery/atmospherics/components/unary/cryo_cell,
/turf/open/floor/plasteel/white,
/area/space)
"ai" = (
/obj/structure/sign/poster/official/random{
	pixel_x = -32
	},
/turf/open/floor/plasteel/white,
/area/space)
"aj" = (
/turf/open/floor/plasteel/white,
/area/space)
"ak" = (
/obj/structure/cable{
	icon_state = "1-2"
	},
/obj/machinery/atmospherics/pipe/manifold/general/hidden{
	dir = 8
	},
/turf/open/floor/plasteel/white,
/area/space)
"al" = (
/obj/effect/turf_decal/tile/green{
	dir = 8
	},
/obj/effect/turf_decal/tile/green{
	dir = 1
	},
/obj/effect/turf_decal/tile/green{
	dir = 4
	},
/obj/structure/closet/l3closet/virology{
	anchored = 1
	},
/turf/open/floor/plasteel/white,
/area/space)
"am" = (
/obj/machinery/atmospherics/pipe/simple/general/hidden{
	dir = 9
	},
/turf/open/floor/plasteel/white,
/area/space)
"an" = (
/obj/effect/landmark/start/geneticist,
/turf/open/floor/plasteel/white,
/area/space)
"ao" = (
/obj/machinery/atmospherics/components/unary/vent_scrubber/on/layer3{
	dir = 4
	},
/turf/open/floor/plasteel/white,
/area/space)
"ap" = (
/obj/machinery/atmospherics/pipe/simple/scrubbers/hidden/layer3{
	dir = 4
	},
/obj/machinery/atmospherics/components/unary/vent_pump/on/layer1{
	dir = 4
	},
/obj/structure/disposalpipe/segment{
	icon_state = "pipe";
	dir = 6
	},
/turf/open/floor/plasteel/white,
/area/space)
"aq" = (
/obj/machinery/atmospherics/pipe/manifold/scrubbers/hidden/layer3{
	dir = 1
	},
/obj/machinery/atmospherics/pipe/manifold/supply/hidden/layer1{
	icon_state = "manifold-1";
	dir = 1
	},
/obj/structure/cable{
	icon_state = "1-4"
	},
/obj/structure/cable{
	icon_state = "2-4"
	},
/obj/structure/disposalpipe/segment{
	dir = 4
	},
/obj/machinery/atmospherics/pipe/simple/general/hidden,
/turf/open/floor/plasteel/white,
/area/space)
"ar" = (
/obj/machinery/atmospherics/pipe/simple/scrubbers/hidden/layer3{
	dir = 4
	},
/obj/machinery/atmospherics/pipe/simple/supply/hidden/layer1{
	icon_state = "pipe11-1";
	dir = 4
	},
/obj/structure/cable{
	icon_state = "4-8"
	},
/obj/structure/disposalpipe/segment{
	dir = 4
	},
/turf/open/floor/plasteel/white,
/area/space)
"as" = (
/obj/machinery/computer/scan_consolenew{
	dir = 1
	},
/obj/machinery/door/window/northleft{
	name = "Genetics Equipment";
	req_one_access_txt = "9"
	},
/turf/open/floor/plasteel/white,
/area/space)
"at" = (
/obj/machinery/dna_scannernew,
/obj/machinery/door/window/northleft{
	name = "Genetics Equipment";
	req_one_access_txt = "9"
	},
/obj/structure/window/reinforced{
	dir = 4
	},
/turf/open/floor/plasteel/white,
/area/space)
"au" = (
/obj/structure/table,
/obj/item/storage/box/monkeycubes,
/obj/item/storage/pill_bottle/mannitol,
/obj/item/storage/pill_bottle/mutadone,
/turf/open/floor/plasteel/white,
/area/space)
"av" = (
/obj/machinery/light,
/obj/structure/disposalpipe/trunk{
	dir = 1
	},
/obj/machinery/disposal/bin,
/turf/open/floor/plasteel/white,
/area/space)
"aw" = (
/obj/machinery/atmospherics/pipe/simple/scrubbers/hidden/layer3,
/obj/machinery/atmospherics/pipe/simple/supply/hidden/layer1,
/obj/structure/cable{
	icon_state = "1-2"
	},
/obj/machinery/atmospherics/pipe/simple/general/hidden,
/turf/open/floor/plasteel/white,
/area/space)
"ax" = (
/obj/machinery/door/window/brigdoor/security{
	dir = 1;
	name = "Security Equipment Storage";
	req_one_access_txt = "63, 5"
	},
/obj/structure/closet/secure_closet/personal/patient,
/obj/structure/window/reinforced{
	dir = 8
	},
/turf/open/floor/plasteel/white,
/area/space)
"ay" = (
/obj/machinery/door/airlock/ship/medical{
	name = "Morgue"
	},
/obj/machinery/atmospherics/pipe/simple/scrubbers/hidden/layer3,
/obj/machinery/atmospherics/pipe/simple/supply/hidden/layer1,
/obj/structure/cable{
	icon_state = "1-2"
	},
/obj/machinery/atmospherics/pipe/simple/general/hidden,
/turf/open/floor/plasteel/ship/techfloor,
/area/space)
"az" = (
/turf/open/floor/plasteel/ship/techfloor,
/area/space)
"aA" = (
/obj/machinery/atmospherics/pipe/simple/general/hidden{
	dir = 6
	},
/turf/open/floor/plasteel/ship/techfloor,
/area/space)
"aB" = (
/obj/machinery/atmospherics/pipe/simple/general/hidden{
	dir = 4
	},
/turf/open/floor/plasteel/ship/techfloor,
/area/space)
"aC" = (
/obj/effect/turf_decal/tile/green{
	dir = 1
	},
/obj/effect/turf_decal/tile/green{
	dir = 4
	},
/obj/machinery/atmospherics/pipe/simple/scrubbers/hidden/layer3{
	dir = 6
	},
/obj/machinery/atmospherics/components/unary/vent_pump/on/layer1{
	dir = 4
	},
/turf/open/floor/plasteel/white,
/area/space)
"aD" = (
/obj/structure/bodycontainer/morgue{
	icon_state = "morgue1";
	dir = 1
	},
/turf/open/floor/plasteel/ship/techfloor,
/area/space)
"aE" = (
/obj/structure/bodycontainer/morgue{
	icon_state = "morgue1";
	dir = 1
	},
/obj/machinery/light,
/turf/open/floor/plasteel/ship/techfloor,
/area/space)
"aF" = (
/obj/machinery/vending/wardrobe,
/turf/open/floor/plasteel/ship/techfloor,
/area/space)
"aG" = (
/obj/machinery/atmospherics/components/unary/vent_scrubber/on/layer3{
	dir = 4
	},
/obj/machinery/power/apc/auto_name/north,
/obj/structure/cable{
	icon_state = "0-4"
	},
/obj/machinery/atmospherics/pipe/simple/general/hidden{
	dir = 4
	},
/turf/open/floor/plasteel/ship/techfloor,
/area/space)
"aH" = (
/obj/machinery/atmospherics/pipe/simple/scrubbers/hidden/layer3{
	dir = 9
	},
/obj/machinery/atmospherics/components/unary/vent_pump/on/layer1{
	dir = 1
	},
/obj/structure/cable{
	icon_state = "1-8"
	},
/obj/machinery/atmospherics/pipe/simple/general/hidden{
	dir = 9
	},
/turf/open/floor/plasteel/ship/techfloor,
/area/space)
"aI" = (
/obj/effect/turf_decal/tile/green{
	dir = 1
	},
/obj/effect/turf_decal/tile/green{
	dir = 4
	},
/obj/machinery/atmospherics/pipe/manifold/supply/hidden/layer1{
	icon_state = "manifold-1";
	dir = 1
	},
/obj/machinery/airalarm{
	pixel_y = 23
	},
/obj/structure/cable{
	icon_state = "2-4"
	},
/obj/machinery/atmospherics/pipe/simple/scrubbers/hidden/layer3{
	dir = 10
	},
/turf/open/floor/plasteel/white,
/area/space)
"aJ" = (
/obj/effect/turf_decal/tile/green{
	dir = 1
	},
/obj/effect/turf_decal/tile/green{
	dir = 4
	},
/obj/machinery/atmospherics/pipe/simple/supply/hidden/layer1{
	icon_state = "pipe11-1";
	dir = 4
	},
/obj/machinery/light/small{
	dir = 1
	},
/obj/structure/cable{
	icon_state = "4-8"
	},
/turf/open/floor/plasteel/white,
/area/space)
"aK" = (
/obj/effect/turf_decal/tile/green,
/obj/effect/turf_decal/tile/green{
	dir = 1
	},
/obj/effect/turf_decal/tile/green{
	dir = 4
	},
/obj/machinery/atmospherics/pipe/simple/supply/hidden/layer1{
	icon_state = "pipe11-1";
	dir = 4
	},
/obj/item/radio/intercom{
	pixel_y = 23
	},
/obj/structure/cable{
	icon_state = "4-8"
	},
/turf/open/floor/plasteel/white,
/area/space)
"aL" = (
/obj/machinery/atmospherics/pipe/simple/supply/hidden/layer1{
	icon_state = "pipe11-1";
	dir = 4
	},
/obj/machinery/door/airlock/ship/medical{
	dir = 4;
	id_tag = "virology_airlock_exterior";
	name = "Virology";
	req_one_access_txt = "39"
	},
/obj/effect/mapping_helpers/airlock/locked,
/obj/machinery/doorButtons/access_button{
	idDoor = "virology_airlock_exterior";
	idSelf = "virology_airlock_control";
	name = "Virology Access Button";
	pixel_y = 24;
	req_access_txt = "39"
	},
/obj/structure/cable{
	icon_state = "4-8"
	},
/turf/open/floor/plasteel/white,
/area/space)
"aM" = (
/obj/effect/turf_decal/tile/green,
/obj/effect/turf_decal/tile/green{
	dir = 8
	},
/obj/effect/turf_decal/tile/green{
	dir = 1
	},
/obj/structure/closet/l3closet/virology{
	anchored = 1
	},
/obj/machinery/camera/autoname{
	dir = 4
	},
/turf/open/floor/plasteel/white,
/area/space)
"aN" = (
/obj/effect/turf_decal/tile/green,
/obj/effect/turf_decal/tile/green{
	dir = 8
	},
/obj/machinery/atmospherics/components/unary/vent_scrubber/on/layer3{
	dir = 1
	},
/obj/machinery/shower{
	dir = 1
	},
/turf/open/floor/plasteel/white,
/area/space)
"aO" = (
/obj/effect/turf_decal/tile/green,
/obj/effect/turf_decal/tile/green{
	dir = 8
	},
/obj/machinery/atmospherics/pipe/simple/scrubbers/hidden/layer3,
/obj/machinery/atmospherics/pipe/simple/supply/hidden/layer1,
/obj/structure/cable{
	icon_state = "1-2"
	},
/turf/open/floor/plasteel/white,
/area/space)
"aP" = (
/obj/effect/turf_decal/tile/green,
/obj/effect/turf_decal/tile/green{
	dir = 8
	},
/obj/machinery/shower{
	dir = 1
	},
/turf/open/floor/plasteel/white,
/area/space)
"aQ" = (
/obj/effect/turf_decal/tile/green,
/obj/effect/turf_decal/tile/green{
	dir = 8
	},
/obj/effect/turf_decal/tile/green{
	dir = 4
	},
/obj/machinery/shower{
	dir = 1
	},
/turf/open/floor/plasteel/white,
/area/space)
"aR" = (
/obj/structure/sign/departments/minsky/medical/virology/virology1,
/turf/closed/wall/r_wall/ship,
/area/space)
"aS" = (
/obj/machinery/door/airlock/ship/medical{
	dir = 2;
	id_tag = "virology_airlock_interior";
	name = "Virology";
	req_one_access_txt = "39"
	},
/obj/effect/mapping_helpers/airlock/locked,
/obj/machinery/doorButtons/access_button{
	idDoor = "virology_airlock_interior";
	idSelf = "virology_airlock_control";
	name = "Virology Access Button";
	pixel_x = 30;
	req_access_txt = "39"
	},
/obj/structure/cable{
	icon_state = "1-2"
	},
/obj/machinery/atmospherics/pipe/simple/scrubbers/hidden/layer3,
/obj/machinery/atmospherics/pipe/simple/supply/hidden/layer1,
/turf/open/floor/plasteel/white,
/area/space)
"aT" = (
/obj/structure/table,
/obj/machinery/airalarm{
	dir = 4;
	pixel_x = -23
	},
/obj/item/storage/box/beakers,
/obj/item/reagent_containers/spray/cleaner,
/obj/item/reagent_containers/dropper,
/obj/effect/turf_decal/tile/green{
	dir = 8
	},
/obj/effect/turf_decal/tile/green{
	dir = 1
	},
/obj/effect/turf_decal/tile/green{
	dir = 4
	},
/obj/item/radio/intercom{
	pixel_y = 23
	},
/turf/open/floor/plasteel/white,
/area/space)
"aU" = (
/obj/machinery/atmospherics/components/unary/vent_scrubber/on/layer3,
/obj/structure/table,
/obj/structure/reagent_dispensers/virusfood{
	pixel_y = 30
	},
/obj/effect/turf_decal/tile/green{
	dir = 1
	},
/obj/effect/turf_decal/tile/green{
	dir = 4
	},
/turf/open/floor/plasteel/white,
/area/space)
"aV" = (
/obj/effect/turf_decal/tile/green{
	dir = 1
	},
/obj/effect/turf_decal/tile/green{
	dir = 4
	},
/obj/machinery/atmospherics/pipe/simple/scrubbers/hidden/layer3,
/obj/machinery/atmospherics/pipe/simple/supply/hidden/layer1,
/obj/structure/cable{
	icon_state = "1-2"
	},
/turf/open/floor/plasteel/white,
/area/space)
"aW" = (
/obj/effect/turf_decal/tile/green{
	dir = 1
	},
/obj/effect/turf_decal/tile/green{
	dir = 4
	},
/obj/structure/table/optable{
	name = "Experimentation Table"
	},
/turf/open/floor/plasteel/white,
/area/space)
"aX" = (
/obj/effect/turf_decal/tile/green,
/obj/effect/turf_decal/tile/green{
	dir = 4
	},
/obj/effect/turf_decal/tile/green{
	dir = 1
	},
/obj/machinery/vending/cigarette,
/turf/open/floor/plasteel/white,
/area/space)
"aY" = (
/obj/machinery/computer/pandemic,
/obj/machinery/light{
	dir = 8
	},
/obj/effect/turf_decal/tile/green{
	dir = 8
	},
/obj/effect/turf_decal/tile/green{
	dir = 1
	},
/turf/open/floor/plasteel/white,
/area/space)
"aZ" = (
/obj/machinery/atmospherics/pipe/simple/scrubbers/hidden/layer3{
	dir = 5
	},
/obj/machinery/atmospherics/components/unary/vent_pump/on/layer1{
	dir = 4
	},
/obj/effect/landmark/start/virologist,
/obj/structure/chair/office{
	dir = 8
	},
/turf/open/floor/plasteel/white,
/area/space)
"ba" = (
/obj/machinery/atmospherics/pipe/simple/supply/hidden/layer1{
	icon_state = "pipe11-1";
	dir = 9
	},
/obj/structure/cable{
	icon_state = "1-4"
	},
/obj/machinery/atmospherics/pipe/manifold/scrubbers/hidden/layer3,
/turf/open/floor/plasteel/white,
/area/space)
"bb" = (
/obj/structure/cable{
	icon_state = "4-8"
	},
/obj/effect/landmark/nuclear_waste_spawner,
/obj/machinery/atmospherics/pipe/simple/scrubbers/hidden/layer3{
	dir = 4
	},
/turf/open/floor/plasteel/white,
/area/space)
"bc" = (
/obj/effect/turf_decal/tile/green,
/obj/effect/turf_decal/tile/green{
	dir = 4
	},
/obj/structure/table,
/obj/machinery/reagentgrinder,
/obj/structure/cable{
	icon_state = "2-8"
	},
/obj/machinery/atmospherics/pipe/simple/scrubbers/hidden/layer3{
	dir = 10
	},
/turf/open/floor/plasteel/white,
/area/space)
"bd" = (
/obj/structure/table,
/obj/item/stack/sheet/mineral/plasma{
	amount = 2
	},
/obj/effect/turf_decal/tile/green{
	dir = 8
	},
/obj/effect/turf_decal/tile/green{
	dir = 1
	},
/obj/effect/turf_decal/tile/green,
/turf/open/floor/plasteel/white,
/area/space)
"be" = (
/obj/structure/table,
/obj/item/storage/box/gloves,
/obj/effect/turf_decal/tile/green{
	dir = 8
	},
/obj/effect/turf_decal/tile/green,
/obj/machinery/firealarm{
	pixel_y = -27
	},
/turf/open/floor/plasteel/white,
/area/space)
"bf" = (
/obj/effect/turf_decal/tile/green,
/obj/effect/turf_decal/tile/green{
	dir = 8
	},
/obj/machinery/smartfridge/chemistry/virology/preloaded,
/obj/machinery/camera/autoname{
	dir = 1
	},
/turf/open/floor/plasteel/white,
/area/space)
"bg" = (
/obj/effect/turf_decal/tile/green,
/obj/effect/turf_decal/tile/green{
	dir = 8
	},
/obj/machinery/vending/wardrobe/viro_wardrobe,
/turf/open/floor/plasteel/white,
/area/space)
"bh" = (
/obj/machinery/doorButtons/airlock_controller{
	idExterior = "virology_airlock_exterior";
	idInterior = "virology_airlock_interior";
	idSelf = "virology_airlock_control";
	name = "Virology Access Console";
	pixel_x = 22;
	pixel_y = 8;
	req_access_txt = "39"
	},
/obj/machinery/power/apc/auto_name/south,
/obj/effect/turf_decal/tile/green,
/obj/effect/turf_decal/tile/green{
	dir = 4
	},
/obj/effect/turf_decal/tile/green{
	dir = 8
	},
/obj/machinery/disposal/bin,
/obj/structure/disposalpipe/trunk,
/obj/structure/cable,
/obj/machinery/atmospherics/pipe/simple/scrubbers/hidden/layer3,
/turf/open/floor/plasteel/white,
/area/space)
"bi" = (
/obj/structure/disposalpipe/segment,
/obj/machinery/atmospherics/pipe/simple/scrubbers/hidden/layer3,
/turf/closed/wall/r_wall/ship,
/area/space)
"bj" = (
/turf/open/space/basic,
/area/space)
"bk" = (
/obj/structure/disposalpipe/trunk{
	dir = 1
	},
/obj/structure/disposaloutlet,
/obj/machinery/atmospherics/pipe/simple/scrubbers/hidden/layer3{
	dir = 5
	},
/turf/open/floor/plating/airless,
/area/space)
"bl" = (
/obj/structure/table,
/turf/open/floor/plasteel/white,
/area/space)
"bm" = (
/obj/machinery/door/airlock/ship/medical{
	name = "Medbay Reception";
	req_one_access_txt = "5"
	},
/turf/open/floor/plasteel/white,
/area/space)
"bn" = (
/obj/machinery/door/airlock/ship/medical{
	dir = 2;
	name = "Medical Storage";
	req_one_access_txt = "5"
	},
/turf/open/floor/plasteel/white,
/area/space)
"bo" = (
/obj/machinery/door/airlock/ship/medical{
	dir = 2;
	name = "Surgery";
	req_one_access_txt = "45"
	},
/turf/open/floor/plating,
/area/space)
"bp" = (
/obj/machinery/door/airlock/ship/medical{
	name = "Chemistry";
	req_one_access_txt = "5, 33"
	},
/turf/open/floor/plasteel/white,
/area/space)

(1,1,1) = {"
ab
ab
ab
ab
ab
ab
ab
ab
ab
bj
bj
bj
bj
bj
bj
bj
bj
bj
bj
bj
bj
bj
bj
bj
bj
bj
bj
bj
bj
bj
bj
"}
(2,1,1) = {"
ab
ac
ai
an
as
ab
aA
af
ab
ab
ab
ab
ab
ab
ab
ab
bj
bj
bj
bj
bj
bj
bj
bj
bj
bj
bj
bj
bj
bj
bj
"}
(3,1,1) = {"
ab
ad
aj
aj
at
ab
aB
aD
ab
al
aM
ab
aT
aY
bd
ab
bj
bj
bj
bj
bj
bj
bj
bj
bj
bj
bj
bj
bj
bj
bj
"}
(4,1,1) = {"
ab
ae
aj
ao
au
ab
aB
aD
ab
aC
aN
ab
aU
aZ
be
ab
bj
bj
bj
bj
bj
bj
bj
bj
bj
bj
bj
bj
bj
bj
bj
"}
(5,1,1) = {"
aj
aj
aj
ap
av
ab
aG
aE
ab
aI
aO
aS
aV
ba
bf
ab
bj
bj
bj
bj
bj
bj
bj
bj
bj
bj
bj
bj
bj
bj
bj
"}
(6,1,1) = {"
ab
ag
ak
aq
aw
ay
aH
aD
ab
aJ
aP
ab
aW
bb
bg
ab
bj
bj
bj
bj
bj
bj
bj
bj
bj
bj
bj
bj
bj
bj
bj
"}
(7,1,1) = {"
ab
ah
am
ar
ax
ab
az
aF
ab
aK
aQ
ab
aX
bc
bh
bi
bk
bj
bj
bj
bj
bj
bj
bj
bj
bj
bj
bj
bj
bj
bj
"}
(8,1,1) = {"
ab
ab
ab
aj
ab
ab
ab
ab
ab
aL
aR
ab
ab
ab
ab
ab
bj
bj
bj
bj
bj
bj
bj
bj
bj
bj
bj
bj
bj
bj
bj
"}
(9,1,1) = {"
ab
aj
aj
aj
aj
aj
aj
aj
aj
aj
aj
aj
ab
bj
bj
bj
bj
bj
bj
ab
ab
aa
aa
ab
ab
bj
bj
bj
bj
bj
bj
"}
(10,1,1) = {"
ab
aj
aj
aj
aj
aj
aj
aj
aj
aj
aj
aj
ab
ab
ab
ab
ab
ab
ab
ab
aj
aj
aj
aj
ab
bj
bj
bj
bj
bj
bj
"}
(11,1,1) = {"
ab
ab
ab
aa
aa
aa
ab
ab
ab
aj
aj
aj
aj
aj
aj
aj
aj
aj
aj
aa
aj
aj
aj
aj
aa
bj
bj
bj
bj
bj
bj
"}
(12,1,1) = {"
ab
aj
aj
aj
aj
aj
aj
aj
ab
aj
aj
aj
aj
aj
aj
aj
aj
aj
aj
aj
aj
aj
aj
aj
aa
bj
bj
bj
bj
bj
bj
"}
(13,1,1) = {"
ab
aj
aj
aj
aj
aj
aj
aj
aa
aj
aj
aj
aj
aj
aj
aj
aj
aj
aj
aa
aj
aj
aj
aj
aa
bj
bj
bj
bj
bj
bj
"}
(14,1,1) = {"
ab
aj
aj
aj
aj
aj
aj
aj
aa
aj
aj
aj
ab
ab
aa
aa
aa
ab
ab
ab
aj
aj
aj
aj
ab
bj
bj
bj
bj
bj
bj
"}
(15,1,1) = {"
ab
aj
aj
aj
aj
aj
aj
aj
ab
aj
aj
aj
ab
aj
aj
aj
aj
aj
aj
ab
ab
ab
ab
ab
ab
bj
bj
bj
bj
bj
bj
"}
(16,1,1) = {"
ab
aj
aj
aj
aj
aj
aj
aj
bp
aj
aj
aj
aj
aj
aj
aj
aj
aj
aj
aa
aa
aa
aa
aa
aa
aa
aa
aa
aa
aa
aa
"}
(17,1,1) = {"
ab
aj
aj
aj
aj
aj
aj
aj
ab
aj
aj
aj
ab
aj
aj
aj
aj
aj
aj
ab
aa
aa
aa
aa
aa
aa
aa
aa
aa
aa
aa
"}
(18,1,1) = {"
ab
ab
aa
aa
ab
aa
aa
ab
ab
aj
aj
aj
ab
ab
aa
aj
aj
aa
ab
ab
ab
ab
ab
ab
ab
aa
aa
aa
aa
aa
aa
"}
(19,1,1) = {"
ab
aj
aj
aj
aj
aj
aj
aj
ab
aj
aj
aj
aa
aj
aj
aj
aj
aj
aj
ab
aj
aj
aj
aj
ab
aa
aa
aa
aa
aa
aa
"}
(20,1,1) = {"
ab
aj
aj
aj
aj
aj
aj
aj
ab
aj
aj
aj
ab
aj
aj
aj
aj
aj
aj
aa
aj
aj
aj
aj
ab
aa
aa
aa
aa
aa
aa
"}
(21,1,1) = {"
aj
aj
aj
aj
aj
aj
aj
aj
aj
aj
aj
aj
aj
aj
aj
aj
aj
aj
aj
ab
aj
aj
aj
aj
ab
aa
aa
aa
aa
aa
aa
"}
(22,1,1) = {"
aj
aj
aj
aj
aj
aj
aj
aj
aj
aj
aj
aj
aj
aj
aj
aj
aj
aj
aj
bo
aj
aj
aj
aj
ab
aa
aa
aa
aa
aa
aa
"}
(23,1,1) = {"
aj
aj
aj
aj
aj
aj
aj
aj
aj
aj
aj
aj
aj
aj
aj
aj
aj
aj
aj
ab
aj
aj
aj
aj
ab
aa
aa
aa
aa
aa
aa
"}
(24,1,1) = {"
ab
aj
aj
aj
aj
aj
aj
aj
ab
aj
aj
aj
ab
aj
aj
aj
aj
aj
aj
aa
aj
aj
aj
aj
ab
aa
aa
aa
aa
aa
aa
"}
(25,1,1) = {"
ab
aj
aj
aj
aj
aj
aj
aj
aa
aj
aj
aj
aa
aj
aj
aj
aj
aj
aj
ab
aj
aj
aj
aj
ab
aa
aa
aa
aa
aa
aa
"}
(26,1,1) = {"
aj
aj
aj
aj
aj
bl
bl
bl
aa
aj
aj
aj
ab
ab
aa
aa
aa
aa
ab
ab
ab
ab
ab
ab
ab
aa
aa
aa
aa
aa
aa
"}
(27,1,1) = {"
aj
aj
aj
aj
aj
bl
aj
aj
aa
aj
aj
aj
ab
aj
aj
aj
aj
aj
aj
ab
aa
aa
aa
aa
aa
aa
aa
aa
aa
aa
aa
"}
(28,1,1) = {"
aj
aj
aj
aj
aj
bl
aj
aj
ab
aj
aj
aj
bn
aj
aj
aj
aj
aj
aj
aa
aa
aa
aa
aa
aa
aa
aa
aa
aa
aa
aa
"}
(29,1,1) = {"
ab
aj
aj
aj
aj
bl
aj
aj
bm
aj
aj
aj
bn
aj
aj
aj
aj
aj
aj
aa
aa
aa
aa
aa
aa
aa
aa
aa
aa
aa
aa
"}
(30,1,1) = {"
ab
aj
aj
aj
aj
bl
aj
aj
ab
aj
aj
aj
ab
aj
aj
aj
aj
aj
aj
ab
aa
aa
aa
aa
aa
aa
aa
aa
aa
aa
aa
"}
(31,1,1) = {"
ab
ab
ab
ab
ab
ab
ab
ab
ab
ab
aa
ab
ab
ab
ab
ab
ab
ab
ab
ab
aa
aa
aa
aa
aa
aa
aa
aa
aa
aa
aa
"}
