//MAP CONVERTED BY dmm2tgm.py THIS HEADER COMMENT PREVENTS RECONVERSION, DO NOT REMOVE
"aa" = (
/turf/open/space/basic,
/area/space)
"ab" = (
/turf/closed/wall/r_wall,
/area/space)
"ac" = (
/obj/machinery/door/airlock/external,
/turf/open/floor/plating,
/area/space)
"ad" = (
/turf/open/floor/plasteel,
/area/space)
"ae" = (
/turf/open/floor/plating,
/area/space)
"af" = (
/turf/open/floor/plating/asteroid/airless,
/area/space)
"ag" = (
/obj/structure/grille,
/obj/structure/window/reinforced/fulltile,
/turf/open/floor/plating,
/area/space)
"ah" = (
/obj/machinery/door/airlock/maintenance,
/turf/open/floor/plating,
/area/space)
"ai" = (
/obj/machinery/door/airlock/atmos,
/turf/open/floor/plasteel,
/area/space)
"aj" = (
/obj/structure/table,
/turf/open/floor/plasteel,
/area/space)
"ak" = (
/obj/machinery/door/airlock/atmos,
/turf/open/floor/engine,
/area/space)
"al" = (
/turf/open/floor/plating/airless,
/area/space)
"am" = (
/turf/open/floor/engine,
/area/space)
"an" = (
/obj/structure/shuttle/engine/huge{
	dir = 8
	},
/turf/open/floor/plating/airless,
/area/space)
"ao" = (
/obj/structure/shuttle/engine/large{
	dir = 8
	},
/turf/open/floor/plating/airless,
/area/space)
"ap" = (
/turf/closed/mineral/random,
/area/space)
"aq" = (
/turf/open/floor/plasteel/airless,
/area/space)
"ar" = (
/turf/open/floor/engine/airless,
/area/space)
"as" = (
/turf/open/floor/plating/airless{
	icon_state = "floorscorched2"
	},
/area/space)
"at" = (
/turf/open/floor/plating/airless{
	icon_state = "noslip-scorched1_standard"
	},
/area/space)
"au" = (
/turf/open/floor/plating/airless{
	icon_state = "panelscorched"
	},
/area/space)
"av" = (
/turf/open/floor/plating/airless{
	icon_state = "platingdmg3"
	},
/area/space)
"aw" = (
/obj/machinery/door/airlock/maintenance,
/turf/open/floor/plating/airless,
/area/space)
"ax" = (
/turf/open/floor/plating/airless{
	icon_state = "platingdmg2"
	},
/area/space)
"ay" = (
/turf/open/floor/plating/airless{
	icon_state = "platingdmg1"
	},
/area/space)
"az" = (
/turf/open/floor/plating/airless{
	icon_state = "damaged4"
	},
/area/space)
"aA" = (
/turf/open/floor/plating/airless{
	icon_state = "damaged2"
	},
/area/space)
"aB" = (
/turf/open/floor/plating/airless{
	icon_state = "damaged5"
	},
/area/space)
"aC" = (
/obj/structure/grille,
/obj/structure/window/reinforced/fulltile,
/turf/closed/mineral/random,
/area/space)
"aD" = (
/obj/structure/window/reinforced{
	dir = 1
	},
/obj/structure/window/reinforced{
	dir = 4
	},
/turf/open/floor/engine/air,
/area/space)
"aE" = (
/obj/structure/window/reinforced{
	dir = 4
	},
/obj/machinery/portable_atmospherics/canister/air,
/turf/open/floor/engine/air,
/area/space)
"aF" = (
/obj/structure/window/reinforced,
/obj/structure/window/reinforced{
	dir = 4
	},
/turf/open/floor/engine/air,
/area/space)
"aG" = (
/obj/structure/window/reinforced{
	dir = 1
	},
/obj/structure/window/reinforced{
	dir = 4
	},
/turf/open/floor/engine/n2,
/area/space)
"aH" = (
/obj/structure/window/reinforced{
	dir = 4
	},
/obj/machinery/portable_atmospherics/canister/nitrogen,
/turf/open/floor/engine/n2,
/area/space)
"aI" = (
/obj/structure/window/reinforced,
/obj/structure/window/reinforced{
	dir = 4
	},
/turf/open/floor/engine/n2,
/area/space)
"aJ" = (
/obj/structure/window/reinforced{
	dir = 1
	},
/obj/structure/window/reinforced{
	dir = 4
	},
/turf/open/floor/engine/o2,
/area/space)
"aK" = (
/obj/structure/window/reinforced{
	dir = 4
	},
/obj/machinery/portable_atmospherics/canister/oxygen,
/turf/open/floor/engine/o2,
/area/space)
"aL" = (
/obj/structure/window/reinforced,
/obj/structure/window/reinforced{
	dir = 4
	},
/turf/open/floor/engine/o2,
/area/space)
"aM" = (
/obj/structure/window/reinforced{
	dir = 1
	},
/obj/structure/window/reinforced{
	dir = 4
	},
/turf/open/floor/engine/co2,
/area/space)
"aN" = (
/obj/structure/window/reinforced{
	dir = 4
	},
/obj/machinery/portable_atmospherics/canister/carbon_dioxide,
/turf/open/floor/engine/co2,
/area/space)
"aO" = (
/obj/structure/window/reinforced,
/obj/structure/window/reinforced{
	dir = 4
	},
/turf/open/floor/engine/co2,
/area/space)
"aP" = (
/obj/structure/window/reinforced{
	dir = 1
	},
/turf/open/floor/plasteel/airless,
/area/space)
"aQ" = (
/obj/structure/window/reinforced{
	dir = 8
	},
/turf/open/floor/plasteel/airless,
/area/space)
"aR" = (
/obj/structure/window/reinforced{
	dir = 8
	},
/turf/open/floor/plating/airless{
	icon_state = "damaged4"
	},
/area/space)
"aS" = (
/obj/structure/window/reinforced,
/turf/open/floor/plasteel,
/area/space)
"aT" = (
/obj/structure/window/reinforced,
/obj/structure/window/reinforced{
	dir = 1
	},
/obj/machinery/portable_atmospherics/canister/air,
/turf/open/floor/plasteel,
/area/space)
"aU" = (
/obj/structure/window/reinforced,
/obj/structure/window/reinforced{
	dir = 1
	},
/obj/machinery/portable_atmospherics/canister/oxygen,
/turf/open/floor/plasteel,
/area/space)
"aV" = (
/obj/structure/window/reinforced,
/obj/structure/window/reinforced{
	dir = 1
	},
/obj/machinery/portable_atmospherics/canister{
	icon_state = "orange"
	},
/turf/open/floor/plasteel,
/area/space)
"aW" = (
/obj/structure/window/reinforced,
/obj/structure/window/reinforced{
	dir = 1
	},
/obj/machinery/portable_atmospherics/canister/nitrogen,
/turf/open/floor/plasteel,
/area/space)
"aX" = (
/obj/structure/window/reinforced,
/obj/structure/window/reinforced{
	dir = 1
	},
/obj/machinery/portable_atmospherics/canister/nitrous_oxide,
/turf/open/floor/plasteel,
/area/space)
"aY" = (
/obj/structure/window/reinforced,
/obj/structure/window/reinforced{
	dir = 1
	},
/obj/machinery/portable_atmospherics/canister,
/turf/open/floor/plasteel,
/area/space)
"aZ" = (
/obj/structure/window/reinforced,
/obj/structure/window/reinforced{
	dir = 1
	},
/obj/machinery/portable_atmospherics/canister/carbon_dioxide,
/turf/open/floor/plasteel,
/area/space)
"ba" = (
/obj/machinery/power/port_gen/pacman,
/obj/structure/cable{
	icon_state = "0-2"
	},
/turf/open/floor/plating/airless,
/area/space)
"bb" = (
/obj/machinery/suit_storage_unit,
/turf/open/floor/plasteel,
/area/space)
"bc" = (
/obj/structure/closet/wardrobe/atmospherics_yellow,
/turf/open/floor/plasteel,
/area/space)
"bd" = (
/obj/structure/closet/firecloset/full,
/turf/open/floor/plasteel,
/area/space)
"be" = (
/obj/structure/closet/emcloset/anchored,
/turf/open/floor/plasteel,
/area/space)
"bf" = (
/obj/structure/closet/secure_closet/atmospherics,
/turf/open/floor/plasteel,
/area/space)
"bg" = (
/obj/machinery/portable_atmospherics/scrubber/huge,
/turf/open/floor/plasteel,
/area/space)
"bh" = (
/obj/machinery/computer/atmos_alert{
	icon_state = "computer";
	dir = 8
	},
/turf/open/floor/plasteel,
/area/space)
"bi" = (
/obj/machinery/space_heater,
/turf/open/floor/plasteel,
/area/space)
"bj" = (
/obj/machinery/computer/atmos_control{
	icon_state = "computer";
	dir = 8
	},
/turf/open/floor/plasteel,
/area/space)
"bk" = (
/obj/structure/cable{
	icon_state = "1-2"
	},
/turf/open/floor/plating/airless,
/area/space)
"bl" = (
/obj/machinery/atmospherics/components/unary/portables_connector,
/turf/open/floor/plasteel,
/area/space)
"bm" = (
/obj/machinery/portable_atmospherics/pump,
/obj/machinery/atmospherics/components/unary/portables_connector,
/turf/open/floor/plasteel,
/area/space)
"bn" = (
/obj/item/beacon,
/turf/open/floor/engine,
/area/space)
"bo" = (
/obj/structure/tank_dispenser/oxygen,
/turf/open/floor/plasteel,
/area/space)
"bp" = (
/obj/machinery/disposal/bin,
/obj/structure/disposalpipe/trunk,
/turf/open/floor/plasteel,
/area/space)
"bq" = (
/obj/machinery/autolathe,
/turf/open/floor/engine,
/area/space)
"br" = (
/obj/structure/table/optable,
/turf/open/floor/engine,
/area/space)
"bs" = (
/obj/structure/reagent_dispensers/water_cooler,
/turf/open/floor/plasteel,
/area/space)
"bt" = (
/obj/structure/cable{
	icon_state = "1-8"
	},
/obj/structure/cable{
	icon_state = "4-8"
	},
/turf/open/floor/plasteel,
/area/space)
"bu" = (
/obj/machinery/door/airlock/atmos,
/obj/structure/disposalpipe/segment{
	dir = 4
	},
/turf/open/floor/plasteel,
/area/space)
"bv" = (
/obj/machinery/power/apc/auto_name/north,
/obj/structure/cable{
	icon_state = "0-2"
	},
/turf/open/floor/plasteel/airless,
/area/space)
"bw" = (
/obj/structure/disposalpipe/segment{
	dir = 4
	},
/turf/open/floor/plasteel/airless,
/area/space)
"bx" = (
/obj/structure/rack,
/turf/open/floor/plasteel,
/area/space)
"by" = (
/obj/machinery/door/airlock/external,
/obj/structure/cable{
	icon_state = "1-2"
	},
/turf/open/floor/plating,
/area/space)
"bz" = (
/obj/structure/cable{
	icon_state = "1-2"
	},
/turf/open/floor/plasteel,
/area/space)
"bA" = (
/obj/structure/cable{
	icon_state = "2-4"
	},
/turf/open/floor/plasteel,
/area/space)
"bB" = (
/obj/structure/cable{
	icon_state = "4-8"
	},
/turf/open/floor/plasteel,
/area/space)
"bC" = (
/obj/machinery/door/airlock/atmos,
/obj/structure/cable{
	icon_state = "4-8"
	},
/turf/open/floor/plasteel,
/area/space)
"bD" = (
/obj/structure/disposalpipe/segment{
	dir = 5
	},
/obj/structure/cable{
	icon_state = "2-8"
	},
/obj/structure/cable{
	icon_state = "4-8"
	},
/turf/open/floor/plasteel,
/area/space)
"bE" = (
/obj/machinery/door/airlock/atmos,
/obj/structure/cable{
	icon_state = "1-2"
	},
/turf/open/floor/engine,
/area/space)
"bF" = (
/obj/structure/cable{
	icon_state = "1-4"
	},
/turf/open/floor/engine,
/area/space)
"bG" = (
/obj/structure/cable{
	icon_state = "4-8"
	},
/turf/open/floor/engine,
/area/space)
"bH" = (
/obj/machinery/blackbox_recorder,
/obj/structure/cable{
	icon_state = "2-8"
	},
/turf/open/floor/engine,
/area/space)
"bI" = (
/obj/structure/cable{
	icon_state = "1-2"
	},
/turf/open/floor/engine,
/area/space)
"bJ" = (
/obj/structure/cable{
	icon_state = "2-4"
	},
/turf/open/floor/engine,
/area/space)
"bK" = (
/obj/structure/bed,
/obj/item/bedsheet,
/obj/structure/cable{
	icon_state = "1-8"
	},
/turf/open/floor/engine,
/area/space)
"bL" = (
/obj/structure/cable{
	icon_state = "0-4"
	},
/turf/open/floor/engine,
/area/space)
"bM" = (
/obj/structure/cable{
	icon_state = "1-8"
	},
/turf/open/floor/engine,
/area/space)
"bN" = (
/obj/structure/cable,
/obj/machinery/power/apc/auto_name/east,
/turf/open/floor/plasteel,
/area/space)
"bO" = (
/obj/structure/cable{
	icon_state = "4-8"
	},
/obj/structure/cable{
	icon_state = "0-8"
	},
/obj/machinery/power/apc/auto_name/north,
/turf/open/floor/engine,
/area/space)
"bP" = (
/obj/machinery/door/airlock/atmos,
/obj/structure/disposalpipe/segment{
	dir = 4
	},
/obj/structure/cable{
	icon_state = "4-8"
	},
/turf/open/floor/plasteel,
/area/space)
"bQ" = (
/obj/structure/disposalpipe/segment{
	dir = 4
	},
/obj/structure/cable{
	icon_state = "4-8"
	},
/turf/open/floor/plasteel,
/area/space)
"bR" = (
/obj/structure/disposalpipe/segment{
	dir = 4
	},
/obj/structure/cable{
	icon_state = "4-8"
	},
/turf/open/floor/plasteel/airless,
/area/space)
"bS" = (
/obj/structure/disposalpipe/segment{
	dir = 4
	},
/obj/structure/cable{
	icon_state = "1-8"
	},
/turf/open/floor/plasteel/airless,
/area/space)
"bT" = (
/obj/machinery/atmospherics/components/unary/portables_connector{
	dir = 4
	},
/obj/machinery/portable_atmospherics/canister,
/turf/open/floor/plasteel,
/area/space)
"bU" = (
/obj/machinery/atmospherics/components/unary/portables_connector{
	dir = 8
	},
/obj/machinery/portable_atmospherics/pump,
/turf/open/floor/plasteel,
/area/space)
"bV" = (
/obj/structure/window/reinforced,
/obj/structure/window/reinforced{
	dir = 1
	},
/turf/open/floor/plasteel,
/area/space)
"bW" = (
/obj/structure/cable{
	icon_state = "1-2"
	},
/obj/structure/cable{
	icon_state = "1-8"
	},
/turf/open/floor/engine,
/area/space)
"bX" = (
/obj/machinery/portable_atmospherics/scrubber,
/obj/machinery/atmospherics/components/unary/portables_connector{
	dir = 4
	},
/turf/open/floor/plasteel,
/area/space)

(1,1,1) = {"
aa
aa
aa
aa
aa
aa
aa
aa
aa
aa
aa
aa
aa
aa
aa
aa
aa
aa
aa
aa
aa
aa
aa
aa
aa
aa
aa
aa
aa
aa
aa
aa
aa
aa
aa
aa
aa
aa
aa
aa
"}
(2,1,1) = {"
aa
aa
aa
aa
aa
aa
aa
aa
aa
aa
aa
aa
aa
aa
aa
aa
aa
aa
aa
aa
aa
aa
aa
aa
aa
aa
aa
aa
aa
aa
aa
aa
aa
aa
aa
aa
aa
aa
aa
aa
"}
(3,1,1) = {"
aa
aa
aa
aa
aa
aa
aa
aa
aa
aa
aa
aa
aa
aa
aa
aa
aa
aa
aa
al
al
an
al
ao
al
ao
aa
aa
aa
aa
aa
aa
aa
aa
aa
aa
aa
aa
aa
aa
"}
(4,1,1) = {"
aa
aa
aa
aa
aa
aa
aa
aa
aa
aa
aa
aa
aa
aa
al
al
an
al
ao
al
al
al
al
al
al
al
aa
aa
aa
aa
aa
aa
aa
aa
aa
aa
aa
aa
aa
aa
"}
(5,1,1) = {"
aa
aa
aa
aa
aa
aa
aa
aa
aa
aa
aa
aa
aa
aa
al
al
al
al
al
al
al
al
ab
ab
ab
ab
ab
aa
aa
aa
aa
aa
aa
aa
aa
aa
aa
aa
aa
aa
"}
(6,1,1) = {"
aa
aa
aa
aa
aa
aa
aa
aa
aa
aa
aa
aa
aa
ab
al
al
al
ab
ab
ab
ab
ab
ab
am
am
am
ag
aa
aa
aa
aa
aa
aa
aa
aa
aa
aa
aa
aa
aa
"}
(7,1,1) = {"
aa
aa
aa
aa
aa
aa
aa
aa
aa
ab
ag
ag
ag
ab
ab
ab
ab
ab
am
bq
ab
br
am
am
am
am
ag
aa
aa
aa
aa
aa
aa
aa
aa
aa
aa
aa
aa
aa
"}
(8,1,1) = {"
aa
aa
aa
aa
aa
aa
aa
aa
aa
ab
bo
bX
bX
ab
am
bn
am
am
am
am
ag
am
am
am
am
am
ag
aa
aa
aa
aa
aa
aa
aa
aa
aa
aa
aa
aa
aa
"}
(9,1,1) = {"
aa
aa
aa
aa
aa
aa
aa
aa
ab
ab
ad
ad
ad
ab
am
am
am
am
am
am
ag
am
am
am
bL
am
ab
ab
aa
aa
aa
aa
aa
aa
aa
aa
aa
aa
aa
aa
"}
(10,1,1) = {"
aa
aa
aa
aa
aa
aa
aa
aa
ab
bl
ad
bA
bz
bE
bF
am
am
bL
am
am
ab
am
am
am
bG
am
am
ag
aa
aa
aa
aa
aa
aa
aa
aa
aa
aa
aa
aa
"}
(11,1,1) = {"
aa
aa
aa
aa
aa
aa
aa
aa
ab
bm
ad
bB
bi
ab
bO
am
am
bG
am
bJ
bE
bI
bI
bI
bM
am
am
ag
aa
aa
aa
aa
aa
aa
aa
aa
aa
aa
aa
aa
"}
(12,1,1) = {"
aa
aa
aa
aa
aa
aa
aa
aa
ab
ab
ab
bC
ab
ab
bH
bI
bI
bW
bI
bK
ab
ab
ak
ab
ab
ab
ab
ab
ab
aa
aa
aa
aa
aa
aa
aa
aa
aa
aa
aa
"}
(13,1,1) = {"
aa
aa
aa
aa
aa
aa
aa
aa
ab
bf
ad
bB
aj
ab
ab
ab
ab
ab
ab
ab
ab
ad
ad
ad
ad
ad
ab
al
ab
aa
aa
aa
aa
aa
aa
aa
aa
aa
aa
aa
"}
(14,1,1) = {"
aa
aa
aa
aa
aa
aa
aa
ab
ab
bf
ad
bB
aj
bg
bg
bi
aj
aj
ab
ad
ad
ad
ad
ad
ad
ad
ah
al
ab
ab
ab
ab
aa
aa
aa
aa
aa
aa
aa
aa
"}
(15,1,1) = {"
aa
aa
aa
aa
ab
ay
ab
ab
bb
ad
ad
bB
ad
ad
ad
ad
ad
ad
ai
ad
ad
aS
aX
aV
bV
aZ
ab
al
ab
aa
aa
aa
aa
aa
aa
aa
aa
aa
aa
aa
"}
(16,1,1) = {"
aa
aa
aa
aa
ay
ba
bk
by
bz
bz
bz
bt
ad
ad
ad
ad
ad
bx
ab
aT
aU
aW
aX
aV
aY
aZ
ab
al
ac
aa
aa
aa
aa
aa
aa
aa
aa
aa
aa
aa
"}
(17,1,1) = {"
aa
aa
aa
aa
aa
ay
ay
ab
bc
bs
bp
bD
bN
bh
bh
bj
bd
be
ab
aT
aU
aW
aX
aV
aY
aZ
ab
al
ab
aa
aa
aa
aa
aa
aa
aa
aa
aa
aa
aa
"}
(18,1,1) = {"
aa
aa
aa
aa
aa
aa
aa
ab
ab
ab
ab
bP
ab
ab
ab
ab
ab
ab
ab
ab
ab
ab
ab
ab
ab
ab
ab
al
ab
ab
ab
ab
aa
aa
aa
aa
aa
aa
aa
aa
"}
(19,1,1) = {"
aa
aa
aa
aa
aa
aa
aa
aa
al
ah
ad
bQ
bT
aw
al
al
al
al
al
al
al
al
al
al
al
al
al
al
ab
aa
aa
aa
aa
aa
aa
aa
aa
aa
aa
aa
"}
(20,1,1) = {"
aa
aa
aa
aa
aa
aa
aa
aa
al
ab
ad
bQ
bU
ab
ab
ab
ab
ab
ab
ab
ab
ab
ab
ab
ab
ab
ab
al
ac
aa
aa
aa
aa
aa
aa
aa
aa
aa
aa
aa
"}
(21,1,1) = {"
aa
aa
aa
aa
aa
aa
aa
aa
al
ab
ab
bP
ab
aD
aE
aF
aG
aH
aI
aJ
aK
aL
aM
aN
aO
aP
ab
al
ab
aa
aa
aa
aa
aa
aa
aa
aa
aa
aa
aa
"}
(22,1,1) = {"
aa
aa
aa
aa
aa
af
ap
ap
al
ab
aq
bR
aq
aQ
aQ
aQ
aQ
aQ
aQ
aQ
aQ
aQ
aR
aQ
aQ
aq
ab
al
ab
ab
ab
ab
aa
aa
aa
aa
aa
aa
aa
aa
"}
(23,1,1) = {"
aa
aa
aa
af
af
af
ap
ap
ap
ab
bv
bS
aq
aq
aq
aq
aq
aq
az
aq
aq
aq
aq
aa
az
aq
ab
al
ac
ae
ae
ac
aa
aa
aa
aa
aa
aa
aa
aa
"}
(24,1,1) = {"
aa
aa
af
af
af
ap
ap
ap
ap
ap
aq
bw
aq
aq
aq
aq
aq
aq
aq
aq
az
aq
aA
aq
aq
aq
ab
al
ab
ae
ae
ab
aa
aa
aa
aa
aa
aa
aa
aa
"}
(25,1,1) = {"
aa
af
af
ap
ap
af
ap
ap
ap
ap
ap
bw
aq
aq
aq
aq
aq
aq
as
aq
aq
aq
aB
aq
aB
aA
ab
al
ab
ab
ab
ab
aa
aa
aa
aa
aa
aa
aa
aa
"}
(26,1,1) = {"
aa
af
ap
ap
ap
ap
ap
ap
ap
ap
ap
bw
aq
aq
aq
aq
aq
as
as
as
as
as
aA
aA
av
aA
ab
al
av
ag
aa
aa
aa
aa
aa
aa
aa
aa
aa
aa
"}
(27,1,1) = {"
aa
af
ap
af
af
ap
ap
ap
aC
ap
ap
ap
aq
aq
aq
as
as
as
as
as
as
as
as
as
aA
av
av
av
av
ag
aa
aa
aa
aa
aa
aa
aa
aa
aa
aa
"}
(28,1,1) = {"
aa
af
ap
ap
ap
ap
ap
ap
ap
ap
ap
ap
aq
aq
as
as
as
at
at
at
at
au
au
as
as
av
av
aa
aa
ab
ab
aa
aa
aa
aa
aa
aa
aa
aa
aa
"}
(29,1,1) = {"
aa
af
af
ap
ap
ap
ap
ap
ap
ap
ap
ap
ap
aq
aq
as
at
at
at
at
au
au
au
au
as
as
av
ax
av
ax
ab
aa
aa
aa
aa
aa
aa
aa
aa
aa
"}
(30,1,1) = {"
aa
aa
af
af
ap
ap
ap
ap
ap
ap
ap
ap
aq
aq
as
as
at
at
au
au
au
au
au
au
au
as
av
ay
ay
av
ag
aa
aa
aa
aa
aa
aa
aa
aa
aa
"}
(31,1,1) = {"
aa
af
af
af
ap
ap
ap
ap
ap
ap
ap
bw
aq
as
as
as
at
au
au
au
au
au
au
au
au
au
ab
ax
aa
av
ax
aa
aa
aa
aa
aa
aa
aa
aa
aa
"}
(32,1,1) = {"
aa
af
af
af
af
ap
ap
ap
ap
ap
ap
bw
aq
as
as
as
as
au
au
au
au
au
au
au
au
as
ab
av
ax
av
aa
aa
aa
aa
aa
aa
aa
aa
aa
aa
"}
(33,1,1) = {"
aa
aa
ap
af
ap
af
ap
ap
ap
ab
ap
bu
ab
ar
ar
ar
ar
ar
ar
au
aa
au
ar
ar
ar
as
ab
aa
av
al
ab
aa
aa
aa
aa
aa
aa
aa
aa
aa
"}
(34,1,1) = {"
aa
af
af
af
af
af
af
ap
ap
ab
aq
bw
aq
ab
ab
ab
ab
ab
ab
ab
ab
ab
ab
ab
ab
ab
ab
ab
ah
ab
ab
aa
aa
aa
aa
aa
aa
aa
aa
aa
"}
(35,1,1) = {"
aa
aa
aa
af
af
aa
aa
aa
aa
aa
aa
aa
aa
aa
aa
aa
aa
aa
aa
aa
aa
aa
aa
aa
aa
aa
aa
aa
aa
aa
aa
aa
aa
aa
aa
aa
aa
aa
aa
aa
"}
(36,1,1) = {"
aa
aa
aa
af
af
aa
aa
aa
aa
aa
aa
aa
aa
aa
aa
aa
aa
aa
aa
aa
aa
aa
aa
aa
aa
aa
aa
aa
aa
aa
aa
aa
aa
aa
aa
aa
aa
aa
aa
aa
"}
(37,1,1) = {"
aa
aa
aa
aa
aa
aa
aa
aa
aa
aa
aa
aa
aa
aa
aa
aa
aa
aa
aa
aa
aa
aa
aa
aa
aa
aa
aa
aa
aa
aa
aa
aa
aa
aa
aa
aa
aa
aa
aa
aa
"}
(38,1,1) = {"
aa
aa
aa
aa
aa
aa
aa
aa
aa
aa
aa
aa
aa
aa
aa
aa
aa
aa
aa
aa
aa
aa
aa
aa
aa
aa
aa
aa
aa
aa
aa
aa
aa
aa
aa
aa
aa
aa
aa
aa
"}
(39,1,1) = {"
aa
aa
aa
aa
aa
aa
aa
aa
aa
aa
aa
aa
aa
aa
aa
aa
aa
aa
aa
aa
aa
aa
aa
aa
aa
aa
aa
aa
aa
aa
aa
aa
aa
aa
aa
aa
aa
aa
aa
aa
"}
(40,1,1) = {"
aa
aa
aa
aa
aa
aa
aa
aa
aa
aa
aa
aa
aa
aa
aa
aa
aa
aa
aa
aa
aa
aa
aa
aa
aa
aa
aa
aa
aa
aa
aa
aa
aa
aa
aa
aa
aa
aa
aa
aa
"}
