//MAP CONVERTED BY dmm2tgm.py THIS HEADER COMMENT PREVENTS RECONVERSION, DO NOT REMOVE
"aa" = (
/turf/template_noop,
/area/template_noop)
"ab" = (
/obj/structure/disposalpipe/segment{
	color = "#f00";
	dir = 6;
	name = "to-space disposal pipe"
	},
/turf/open/floor/plating,
/area/template_noop)
"ac" = (
/obj/structure/disposalpipe/segment{
	color = "#f00";
	dir = 10;
	name = "to-space disposal pipe"
	},
/turf/open/floor/plating,
/area/template_noop)
"ad" = (
/obj/structure/disposalpipe/segment{
	color = "#afa";
	dir = 6;
	name = "mail trunk disposal pipe"
	},
/turf/open/floor/plating,
/area/template_noop)
"ae" = (
/obj/structure/disposalpipe/segment{
	color = "#afa";
	dir = 10;
	name = "mail trunk disposal pipe"
	},
/turf/open/floor/plating,
/area/template_noop)
"af" = (
/obj/structure/disposalpipe/segment{
	color = "#faa";
	dir = 6;
	name = "return trunk disposal pipe"
	},
/turf/open/floor/plating,
/area/template_noop)
"ag" = (
/obj/structure/disposalpipe/segment{
	color = "#faa";
	dir = 10;
	name = "return trunk disposal pipe"
	},
/turf/open/floor/plating,
/area/template_noop)
"ah" = (
/obj/machinery/atmospherics/pipe/simple/scrubbers/visible,
/obj/machinery/atmospherics/pipe/simple/scrubbers/visible/layer2,
/obj/machinery/atmospherics/pipe/simple/scrubbers/visible/layer4,
/turf/open/floor/plating,
/area/template_noop)
"ai" = (
/obj/machinery/atmospherics/pipe/simple/scrubbers/visible{
	dir = 4
	},
/obj/machinery/atmospherics/pipe/simple/scrubbers/visible/layer2{
	dir = 8
	},
/obj/machinery/atmospherics/pipe/simple/scrubbers/visible/layer4{
	dir = 8
	},
/turf/open/floor/plating,
/area/template_noop)
"aj" = (
/obj/machinery/atmospherics/pipe/simple/scrubbers/visible{
	dir = 10
	},
/obj/machinery/atmospherics/pipe/simple/scrubbers/visible/layer2{
	dir = 10
	},
/obj/machinery/atmospherics/pipe/simple/scrubbers/visible/layer4{
	dir = 10
	},
/turf/open/floor/plating,
/area/template_noop)
"ak" = (
/obj/machinery/atmospherics/pipe/simple/scrubbers/visible{
	dir = 6
	},
/obj/machinery/atmospherics/pipe/simple/scrubbers/visible/layer2{
	dir = 6
	},
/obj/machinery/atmospherics/pipe/simple/scrubbers/visible/layer4{
	dir = 6
	},
/turf/open/floor/plating,
/area/template_noop)
"al" = (
/obj/machinery/atmospherics/pipe/simple/scrubbers/visible{
	dir = 9
	},
/obj/machinery/atmospherics/pipe/simple/scrubbers/visible/layer2{
	dir = 9
	},
/obj/machinery/atmospherics/pipe/simple/scrubbers/visible/layer4{
	dir = 9
	},
/turf/open/floor/plating,
/area/template_noop)
"am" = (
/obj/machinery/atmospherics/pipe/simple/scrubbers/visible{
	dir = 5
	},
/obj/machinery/atmospherics/pipe/simple/scrubbers/visible/layer2{
	dir = 5
	},
/obj/machinery/atmospherics/pipe/simple/scrubbers/visible/layer4{
	dir = 5
	},
/turf/open/floor/plating,
/area/template_noop)
"an" = (
/obj/structure/disposalpipe/segment{
	color = "#f00";
	dir = 5;
	name = "to-space disposal pipe"
	},
/turf/open/floor/plating,
/area/template_noop)
"ao" = (
/obj/structure/disposalpipe/segment{
	color = "#f00";
	dir = 9;
	name = "to-space disposal pipe"
	},
/turf/open/floor/plating,
/area/template_noop)
"ap" = (
/obj/structure/disposalpipe/segment{
	color = "#afa";
	dir = 5;
	name = "mail trunk disposal pipe"
	},
/turf/open/floor/plating,
/area/template_noop)
"aq" = (
/obj/structure/disposalpipe/segment{
	color = "#afa";
	dir = 9;
	name = "mail trunk disposal pipe"
	},
/turf/open/floor/plating,
/area/template_noop)
"ar" = (
/obj/structure/disposalpipe/segment{
	color = "#faa";
	dir = 5;
	name = "return trunk disposal pipe"
	},
/turf/open/floor/plating,
/area/template_noop)
"as" = (
/obj/structure/disposalpipe/segment{
	color = "#faa";
	dir = 9;
	name = "return trunk disposal pipe"
	},
/turf/open/floor/plating,
/area/template_noop)
"at" = (
/obj/machinery/atmospherics/pipe/simple/supply/visible,
/obj/machinery/atmospherics/pipe/simple/supply/visible/layer2,
/obj/machinery/atmospherics/pipe/simple/supply/visible/layer4,
/turf/open/floor/plating,
/area/template_noop)
"au" = (
/obj/machinery/atmospherics/pipe/simple/supply/visible{
	dir = 4
	},
/obj/machinery/atmospherics/pipe/simple/supply/visible/layer4{
	dir = 4
	},
/obj/machinery/atmospherics/pipe/simple/supply/visible/layer2{
	dir = 4
	},
/turf/open/floor/plating,
/area/template_noop)
"av" = (
/obj/machinery/atmospherics/pipe/simple/supply/visible{
	dir = 10
	},
/obj/machinery/atmospherics/pipe/simple/supply/visible/layer2{
	dir = 10
	},
/obj/machinery/atmospherics/pipe/simple/supply/visible/layer4{
	dir = 10
	},
/turf/open/floor/plating,
/area/template_noop)
"aw" = (
/obj/machinery/atmospherics/pipe/simple/supply/visible{
	dir = 6
	},
/obj/machinery/atmospherics/pipe/simple/supply/visible/layer2{
	dir = 6
	},
/obj/machinery/atmospherics/pipe/simple/supply/visible/layer4{
	dir = 6
	},
/turf/open/floor/plating,
/area/template_noop)
"ax" = (
/obj/machinery/atmospherics/pipe/simple/supply/visible{
	dir = 9
	},
/obj/machinery/atmospherics/pipe/simple/supply/visible/layer2{
	dir = 9
	},
/obj/machinery/atmospherics/pipe/simple/supply/visible/layer4{
	dir = 9
	},
/turf/open/floor/plating,
/area/template_noop)
"ay" = (
/obj/machinery/atmospherics/pipe/simple/supply/visible{
	dir = 5
	},
/obj/machinery/atmospherics/pipe/simple/supply/visible/layer2{
	dir = 5
	},
/obj/machinery/atmospherics/pipe/simple/supply/visible/layer4{
	dir = 5
	},
/turf/open/floor/plating,
/area/template_noop)
"az" = (
/obj/structure/disposalpipe/segment{
	color = "#f00";
	name = "to-space disposal pipe"
	},
/turf/open/floor/plating,
/area/template_noop)
"aA" = (
/obj/structure/disposalpipe/segment{
	color = "#f00";
	dir = 4;
	name = "to-space disposal pipe"
	},
/turf/open/floor/plating,
/area/template_noop)
"aB" = (
/obj/structure/disposalpipe/segment{
	color = "#afa";
	name = "mail trunk disposal pipe"
	},
/turf/open/floor/plating,
/area/template_noop)
"aC" = (
/obj/structure/disposalpipe/segment{
	color = "#afa";
	dir = 4;
	name = "mail trunk disposal pipe"
	},
/turf/open/floor/plating,
/area/template_noop)
"aD" = (
/obj/structure/disposalpipe/segment{
	color = "#faa";
	dir = 4;
	name = "return trunk disposal pipe"
	},
/turf/open/floor/plating,
/area/template_noop)
"aE" = (
/obj/structure/disposalpipe/segment{
	color = "#faa";
	name = "return trunk disposal pipe"
	},
/turf/open/floor/plating,
/area/template_noop)
"aF" = (
/obj/machinery/atmospherics/pipe/manifold/supply/visible,
/obj/machinery/atmospherics/pipe/manifold/supply/visible/layer2,
/obj/machinery/atmospherics/pipe/manifold/supply/visible/layer4,
/turf/open/floor/plating,
/area/template_noop)
"aG" = (
/obj/machinery/atmospherics/pipe/manifold/supply/visible{
	dir = 8
	},
/obj/machinery/atmospherics/pipe/manifold/supply/visible/layer2{
	dir = 8
	},
/obj/machinery/atmospherics/pipe/manifold/supply/visible/layer4{
	dir = 8
	},
/turf/open/floor/plating,
/area/template_noop)
"aH" = (
/obj/machinery/atmospherics/pipe/manifold/supply/visible{
	dir = 4
	},
/obj/machinery/atmospherics/pipe/manifold/supply/visible/layer2{
	dir = 4
	},
/obj/machinery/atmospherics/pipe/manifold/supply/visible/layer4{
	dir = 4
	},
/turf/open/floor/plating,
/area/template_noop)
"aI" = (
/obj/machinery/atmospherics/pipe/manifold/supply/visible{
	dir = 1
	},
/obj/machinery/atmospherics/pipe/manifold/supply/visible/layer2{
	dir = 1
	},
/obj/machinery/atmospherics/pipe/manifold/supply/visible/layer4{
	dir = 1
	},
/turf/open/floor/plating,
/area/template_noop)
"aJ" = (
/obj/machinery/atmospherics/pipe/layer_manifold/visible,
/turf/open/floor/plating,
/area/template_noop)
"aK" = (
/obj/machinery/atmospherics/pipe/layer_manifold/visible{
	dir = 4
	},
/turf/open/floor/plating,
/area/template_noop)
"aL" = (
/obj/machinery/atmospherics/pipe/manifold/scrubbers/visible/layer2,
/obj/machinery/atmospherics/pipe/manifold/scrubbers/visible/layer4,
/obj/machinery/atmospherics/pipe/manifold/scrubbers/visible,
/turf/open/floor/plating,
/area/template_noop)
"aM" = (
/obj/machinery/atmospherics/pipe/manifold/scrubbers/visible/layer2{
	dir = 8
	},
/obj/machinery/atmospherics/pipe/manifold/scrubbers/visible/layer4{
	dir = 8
	},
/obj/machinery/atmospherics/pipe/manifold/scrubbers/visible{
	dir = 8
	},
/turf/open/floor/plating,
/area/template_noop)
"aN" = (
/obj/machinery/atmospherics/pipe/manifold/scrubbers/visible/layer2{
	dir = 4
	},
/obj/machinery/atmospherics/pipe/manifold/scrubbers/visible/layer4{
	dir = 4
	},
/obj/machinery/atmospherics/pipe/manifold/scrubbers/visible{
	dir = 4
	},
/turf/open/floor/plating,
/area/template_noop)
"aO" = (
/obj/machinery/atmospherics/pipe/manifold/scrubbers/visible/layer2{
	dir = 1
	},
/obj/machinery/atmospherics/pipe/manifold/scrubbers/visible/layer4{
	dir = 1
	},
/obj/machinery/atmospherics/pipe/manifold/scrubbers/visible{
	dir = 1
	},
/turf/open/floor/plating,
/area/template_noop)
"aP" = (
/obj/effect/decal/cleanable/crayon{
	icon_state = "v"
	},
/turf/open/floor/plating,
/area/template_noop)
"aQ" = (
/obj/machinery/atmospherics/pipe/simple/scrubbers/hidden/layer2,
/turf/open/floor/plating,
/area/template_noop)
"aR" = (
/obj/machinery/atmospherics/components/unary/vent_scrubber/on/layer2,
/turf/open/floor/plating,
/area/template_noop)
"aS" = (
/obj/machinery/atmospherics/pipe/manifold4w/scrubbers/hidden/layer2,
/obj/machinery/atmospherics/pipe/manifold4w/supply/hidden/layer4,
/turf/open/floor/plating,
/area/template_noop)
"aT" = (
/obj/machinery/atmospherics/components/unary/vent_pump/on/layer4,
/turf/open/floor/plating,
/area/template_noop)
"aU" = (
/obj/machinery/atmospherics/pipe/simple/supply/hidden/layer4,
/turf/open/floor/plating,
/area/template_noop)
"aV" = (
/obj/machinery/atmospherics/pipe/simple/scrubbers/hidden/layer2{
	dir = 6
	},
/turf/open/floor/plating,
/area/template_noop)
"aW" = (
/obj/machinery/atmospherics/components/unary/vent_scrubber/on/layer2{
	dir = 8
	},
/turf/open/floor/plating,
/area/template_noop)
"aX" = (
/obj/machinery/atmospherics/pipe/manifold/supply/hidden/layer4,
/obj/machinery/atmospherics/pipe/manifold/scrubbers/hidden/layer2,
/turf/open/floor/plating,
/area/template_noop)
"aY" = (
/obj/machinery/atmospherics/components/unary/vent_pump/on/layer4{
	dir = 8
	},
/turf/open/floor/plating,
/area/template_noop)
"aZ" = (
/obj/machinery/atmospherics/pipe/simple/supply/hidden/layer4{
	dir = 5
	},
/turf/open/floor/plating,
/area/template_noop)
"ba" = (
/obj/machinery/atmospherics/pipe/simple/scrubbers/hidden/layer2{
	dir = 8
	},
/turf/open/floor/plating,
/area/template_noop)
"bb" = (
/obj/machinery/atmospherics/components/unary/vent_scrubber/on/layer2{
	dir = 1
	},
/turf/open/floor/plating,
/area/template_noop)
"bc" = (
/obj/machinery/atmospherics/pipe/manifold/supply/hidden/layer4{
	dir = 1
	},
/obj/machinery/atmospherics/pipe/manifold/scrubbers/hidden/layer2{
	dir = 1
	},
/turf/open/floor/plating,
/area/template_noop)
"bd" = (
/obj/machinery/atmospherics/components/unary/vent_pump/on/layer4{
	dir = 4
	},
/turf/open/floor/plating,
/area/template_noop)
"be" = (
/obj/machinery/atmospherics/pipe/simple/supply/hidden/layer4{
	dir = 6
	},
/turf/open/floor/plating,
/area/template_noop)
"bf" = (
/obj/machinery/atmospherics/pipe/simple/scrubbers/hidden/layer2{
	dir = 5
	},
/turf/open/floor/plating,
/area/template_noop)
"bg" = (
/obj/machinery/atmospherics/components/unary/vent_scrubber/on/layer2{
	dir = 4
	},
/turf/open/floor/plating,
/area/template_noop)
"bh" = (
/obj/machinery/atmospherics/pipe/manifold/supply/hidden/layer4{
	dir = 8
	},
/obj/machinery/atmospherics/pipe/manifold/scrubbers/hidden/layer2{
	dir = 8
	},
/turf/open/floor/plating,
/area/template_noop)
"bi" = (
/obj/machinery/atmospherics/components/unary/vent_pump/on/layer4{
	dir = 1
	},
/turf/open/floor/plating,
/area/template_noop)
"bj" = (
/obj/machinery/atmospherics/pipe/simple/supply/hidden/layer4{
	dir = 8
	},
/turf/open/floor/plating,
/area/template_noop)
"bk" = (
/obj/machinery/atmospherics/pipe/simple/scrubbers/hidden/layer2{
	dir = 10
	},
/turf/open/floor/plating,
/area/template_noop)
"bl" = (
/obj/machinery/atmospherics/pipe/simple/scrubbers/hidden/layer2{
	dir = 9
	},
/turf/open/floor/plating,
/area/template_noop)
"bm" = (
/obj/machinery/atmospherics/pipe/manifold/supply/hidden/layer4{
	dir = 4
	},
/obj/machinery/atmospherics/pipe/manifold/scrubbers/hidden/layer2{
	dir = 4
	},
/turf/open/floor/plating,
/area/template_noop)
"bn" = (
/obj/machinery/atmospherics/pipe/simple/supply/hidden/layer4{
	dir = 10
	},
/turf/open/floor/plating,
/area/template_noop)
"bo" = (
/obj/machinery/atmospherics/pipe/simple/supply/hidden/layer4{
	dir = 9
	},
/turf/open/floor/plating,
/area/template_noop)
"bp" = (
/obj/effect/turf_decal/plaque,
/turf/open/floor/monotile/dark{
	desc = "\"This is a plaque in honour of the retired Aegis class vessels. Hopefully <strike>the new line of vessels</strike> <i>literally anything else</i> can live up to your <strike>fame and fortune</strike> <i>utter lack of polish</i>.\" Scratched in beneath that is a crude image of a meteor and a spaceman. The spaceman is laughing. The meteor is exploding.";
	name = "memorial plaque"
	},
/area/template_noop)
"bq" = (
/obj/effect/decal/cleanable/crayon{
	icon_state = "s"
	},
/obj/effect/decal/cleanable/crayon{
	icon_state = "i";
	pixel_x = -16
	},
/turf/open/floor/plating,
/area/template_noop)
"br" = (
/obj/effect/decal/cleanable/crayon{
	icon_state = "h"
	},
/turf/open/floor/plating,
/area/template_noop)
"bs" = (
/obj/effect/decal/cleanable/crayon{
	icon_state = "i"
	},
/turf/open/floor/plating,
/area/template_noop)
"bt" = (
/obj/effect/decal/cleanable/crayon{
	icon_state = "d"
	},
/turf/open/floor/plating,
/area/template_noop)
"bu" = (
/turf/open/floor/plating,
/area/template_noop)
"bv" = (
/obj/machinery/atmospherics/pipe/manifold/dark/visible{
	dir = 4
	},
/obj/machinery/atmospherics/pipe/manifold/dark/visible/layer2{
	dir = 4
	},
/obj/machinery/atmospherics/pipe/manifold/dark/visible/layer4{
	dir = 4
	},
/turf/open/floor/plating,
/area/template_noop)
"bw" = (
/obj/machinery/atmospherics/pipe/manifold/dark/visible{
	dir = 1
	},
/obj/machinery/atmospherics/pipe/manifold/dark/visible/layer2{
	dir = 1
	},
/obj/machinery/atmospherics/pipe/manifold/dark/visible/layer4{
	dir = 1
	},
/turf/open/floor/plating,
/area/template_noop)
"bx" = (
/obj/machinery/atmospherics/pipe/manifold/dark/visible{
	dir = 8
	},
/obj/machinery/atmospherics/pipe/manifold/dark/visible/layer2{
	dir = 8
	},
/obj/machinery/atmospherics/pipe/manifold/dark/visible/layer4{
	dir = 8
	},
/turf/open/floor/plating,
/area/template_noop)
"by" = (
/obj/machinery/atmospherics/pipe/manifold/dark/visible,
/obj/machinery/atmospherics/pipe/manifold/dark/visible/layer2,
/obj/machinery/atmospherics/pipe/manifold/dark/visible/layer4,
/turf/open/floor/plating,
/area/template_noop)
"bz" = (
/obj/machinery/atmospherics/pipe/simple/dark/visible,
/obj/machinery/atmospherics/pipe/simple/dark/visible/layer2,
/obj/machinery/atmospherics/pipe/simple/dark/visible/layer4,
/turf/open/floor/plating,
/area/template_noop)
"bA" = (
/obj/machinery/atmospherics/pipe/simple/dark/visible{
	dir = 4
	},
/obj/machinery/atmospherics/pipe/simple/dark/visible/layer2{
	dir = 4
	},
/obj/machinery/atmospherics/pipe/simple/dark/visible/layer4{
	dir = 4
	},
/turf/open/floor/plating,
/area/template_noop)
"bB" = (
/obj/machinery/atmospherics/pipe/simple/dark/visible{
	dir = 10
	},
/obj/machinery/atmospherics/pipe/simple/dark/visible/layer2{
	dir = 10
	},
/obj/machinery/atmospherics/pipe/simple/dark/visible/layer4{
	dir = 10
	},
/turf/open/floor/plating,
/area/template_noop)
"bC" = (
/obj/machinery/atmospherics/pipe/simple/dark/visible/layer2{
	dir = 6
	},
/obj/machinery/atmospherics/pipe/simple/dark/visible{
	dir = 6
	},
/obj/machinery/atmospherics/pipe/simple/dark/visible/layer4{
	dir = 6
	},
/turf/open/floor/plating,
/area/template_noop)
"bD" = (
/obj/machinery/atmospherics/pipe/simple/dark/visible{
	dir = 9
	},
/obj/machinery/atmospherics/pipe/simple/dark/visible/layer2{
	dir = 9
	},
/obj/machinery/atmospherics/pipe/simple/dark/visible/layer4{
	dir = 9
	},
/turf/open/floor/plating,
/area/template_noop)
"bE" = (
/obj/machinery/atmospherics/pipe/simple/dark/visible{
	dir = 5
	},
/obj/machinery/atmospherics/pipe/simple/dark/visible/layer2{
	dir = 5
	},
/obj/machinery/atmospherics/pipe/simple/dark/visible/layer4{
	dir = 5
	},
/turf/open/floor/plating,
/area/template_noop)
"bF" = (
/obj/machinery/atmospherics/pipe/manifold/orange/visible/layer2{
	dir = 4
	},
/obj/machinery/atmospherics/pipe/manifold/orange/visible/layer4{
	dir = 4
	},
/obj/machinery/atmospherics/pipe/manifold/orange/visible{
	dir = 4
	},
/turf/open/floor/plating,
/area/template_noop)
"bG" = (
/obj/machinery/atmospherics/pipe/manifold/orange/visible/layer2{
	dir = 1
	},
/obj/machinery/atmospherics/pipe/manifold/orange/visible/layer4{
	dir = 1
	},
/obj/machinery/atmospherics/pipe/manifold/orange/visible{
	dir = 1
	},
/turf/open/floor/plating,
/area/template_noop)
"bH" = (
/obj/machinery/atmospherics/pipe/manifold/orange/visible/layer2{
	dir = 8
	},
/obj/machinery/atmospherics/pipe/manifold/orange/visible/layer4{
	dir = 8
	},
/obj/machinery/atmospherics/pipe/manifold/orange/visible{
	dir = 8
	},
/turf/open/floor/plating,
/area/template_noop)
"bI" = (
/obj/machinery/atmospherics/pipe/manifold/orange/visible/layer2,
/obj/machinery/atmospherics/pipe/manifold/orange/visible/layer4,
/obj/machinery/atmospherics/pipe/manifold/orange/visible,
/turf/open/floor/plating,
/area/template_noop)
"bJ" = (
/obj/machinery/atmospherics/pipe/simple/orange/visible,
/obj/machinery/atmospherics/pipe/simple/orange/visible/layer2,
/obj/machinery/atmospherics/pipe/simple/orange/visible/layer4,
/turf/open/floor/plating,
/area/template_noop)
"bK" = (
/obj/machinery/atmospherics/pipe/simple/orange/visible{
	dir = 4
	},
/obj/machinery/atmospherics/pipe/simple/orange/visible/layer2{
	dir = 4
	},
/obj/machinery/atmospherics/pipe/simple/orange/visible/layer4{
	dir = 4
	},
/turf/open/floor/plating,
/area/template_noop)
"bL" = (
/obj/machinery/atmospherics/pipe/simple/orange/visible{
	dir = 10
	},
/obj/machinery/atmospherics/pipe/simple/orange/visible/layer2{
	dir = 10
	},
/obj/machinery/atmospherics/pipe/simple/orange/visible/layer4{
	dir = 10
	},
/turf/open/floor/plating,
/area/template_noop)
"bM" = (
/obj/machinery/atmospherics/pipe/simple/orange/visible{
	dir = 6
	},
/obj/machinery/atmospherics/pipe/simple/orange/visible/layer2{
	dir = 6
	},
/obj/machinery/atmospherics/pipe/simple/orange/visible/layer4{
	dir = 6
	},
/turf/open/floor/plating,
/area/template_noop)
"bN" = (
/obj/machinery/atmospherics/pipe/simple/orange/visible{
	dir = 9
	},
/obj/machinery/atmospherics/pipe/simple/orange/visible/layer2{
	dir = 9
	},
/obj/machinery/atmospherics/pipe/simple/orange/visible/layer4{
	dir = 9
	},
/turf/open/floor/plating,
/area/template_noop)
"bO" = (
/obj/machinery/atmospherics/pipe/simple/orange/visible{
	dir = 5
	},
/obj/machinery/atmospherics/pipe/simple/orange/visible/layer2{
	dir = 5
	},
/obj/machinery/atmospherics/pipe/simple/orange/visible/layer4{
	dir = 5
	},
/turf/open/floor/plating,
/area/template_noop)
"bP" = (
/obj/machinery/atmospherics/pipe/manifold/cyan/visible{
	dir = 4
	},
/obj/machinery/atmospherics/pipe/manifold/cyan/visible/layer2{
	dir = 4
	},
/obj/machinery/atmospherics/pipe/manifold/cyan/visible/layer4{
	dir = 4
	},
/turf/open/floor/plating,
/area/template_noop)
"bQ" = (
/obj/machinery/atmospherics/pipe/manifold/cyan/visible{
	dir = 1
	},
/obj/machinery/atmospherics/pipe/manifold/cyan/visible/layer2{
	dir = 1
	},
/obj/machinery/atmospherics/pipe/manifold/cyan/visible/layer4{
	dir = 1
	},
/turf/open/floor/plating,
/area/template_noop)
"bR" = (
/obj/machinery/atmospherics/pipe/manifold/cyan/visible{
	dir = 8
	},
/obj/machinery/atmospherics/pipe/manifold/cyan/visible/layer2{
	dir = 8
	},
/obj/machinery/atmospherics/pipe/manifold/cyan/visible/layer4{
	dir = 8
	},
/turf/open/floor/plating,
/area/template_noop)
"bS" = (
/obj/machinery/atmospherics/pipe/manifold/cyan/visible,
/obj/machinery/atmospherics/pipe/manifold/cyan/visible/layer2,
/obj/machinery/atmospherics/pipe/manifold/cyan/visible/layer4,
/turf/open/floor/plating,
/area/template_noop)
"bT" = (
/obj/machinery/atmospherics/pipe/simple/cyan/visible,
/obj/machinery/atmospherics/pipe/simple/cyan/visible/layer2,
/obj/machinery/atmospherics/pipe/simple/cyan/visible/layer4,
/turf/open/floor/plating,
/area/template_noop)
"bU" = (
/obj/machinery/atmospherics/pipe/simple/cyan/visible/layer2{
	dir = 4
	},
/obj/machinery/atmospherics/pipe/simple/cyan/visible/layer4{
	dir = 4
	},
/obj/machinery/atmospherics/pipe/simple/cyan/visible{
	dir = 4
	},
/turf/open/floor/plating,
/area/template_noop)
"bV" = (
/obj/machinery/atmospherics/pipe/simple/cyan/visible/layer2{
	dir = 10
	},
/obj/machinery/atmospherics/pipe/simple/cyan/visible/layer4{
	dir = 10
	},
/obj/machinery/atmospherics/pipe/simple/cyan/visible{
	dir = 10
	},
/turf/open/floor/plating,
/area/template_noop)
"bW" = (
/obj/machinery/atmospherics/pipe/simple/cyan/visible/layer2{
	dir = 6
	},
/obj/machinery/atmospherics/pipe/simple/cyan/visible/layer4{
	dir = 6
	},
/obj/machinery/atmospherics/pipe/simple/cyan/visible{
	dir = 6
	},
/turf/open/floor/plating,
/area/template_noop)
"bX" = (
/obj/machinery/atmospherics/pipe/simple/cyan/visible/layer2{
	dir = 9
	},
/obj/machinery/atmospherics/pipe/simple/cyan/visible/layer4{
	dir = 9
	},
/obj/machinery/atmospherics/pipe/simple/cyan/visible{
	dir = 9
	},
/turf/open/floor/plating,
/area/template_noop)
"bY" = (
/obj/machinery/atmospherics/pipe/simple/cyan/visible/layer2{
	dir = 5
	},
/obj/machinery/atmospherics/pipe/simple/cyan/visible/layer4{
	dir = 5
	},
/obj/machinery/atmospherics/pipe/simple/cyan/visible{
	dir = 5
	},
/turf/open/floor/plating,
/area/template_noop)
"bZ" = (
/obj/machinery/atmospherics/pipe/manifold/general/visible{
	dir = 4
	},
/obj/machinery/atmospherics/pipe/manifold/general/visible/layer2{
	dir = 4
	},
/obj/machinery/atmospherics/pipe/manifold/general/visible/layer4{
	dir = 4
	},
/turf/open/floor/plating,
/area/template_noop)
"ca" = (
/obj/machinery/atmospherics/pipe/manifold/general/visible{
	dir = 1
	},
/obj/machinery/atmospherics/pipe/manifold/general/visible/layer2{
	dir = 1
	},
/obj/machinery/atmospherics/pipe/manifold/general/visible/layer4{
	dir = 1
	},
/turf/open/floor/plating,
/area/template_noop)
"cb" = (
/obj/machinery/atmospherics/pipe/manifold/general/visible{
	dir = 8
	},
/obj/machinery/atmospherics/pipe/manifold/general/visible/layer2{
	dir = 8
	},
/obj/machinery/atmospherics/pipe/manifold/general/visible/layer4{
	dir = 8
	},
/turf/open/floor/plating,
/area/template_noop)
"cc" = (
/obj/machinery/atmospherics/pipe/manifold/general/visible,
/obj/machinery/atmospherics/pipe/manifold/general/visible/layer2,
/obj/machinery/atmospherics/pipe/manifold/general/visible/layer4,
/turf/open/floor/plating,
/area/template_noop)
"cd" = (
/obj/machinery/atmospherics/pipe/simple/general/visible,
/obj/machinery/atmospherics/pipe/simple/general/visible/layer2,
/obj/machinery/atmospherics/pipe/simple/general/visible/layer4,
/turf/open/floor/plating,
/area/template_noop)
"ce" = (
/obj/machinery/atmospherics/pipe/simple/general/visible/layer4{
	dir = 8
	},
/obj/machinery/atmospherics/pipe/simple/general/visible/layer2{
	dir = 4
	},
/obj/machinery/atmospherics/pipe/simple/general/visible{
	dir = 8
	},
/turf/open/floor/plating,
/area/template_noop)
"cf" = (
/obj/machinery/atmospherics/pipe/simple/general/visible{
	dir = 10
	},
/obj/machinery/atmospherics/pipe/simple/general/visible/layer2{
	dir = 10
	},
/obj/machinery/atmospherics/pipe/simple/general/visible/layer4{
	dir = 10
	},
/turf/open/floor/plating,
/area/template_noop)
"cg" = (
/obj/machinery/atmospherics/pipe/simple/general/visible{
	dir = 6
	},
/obj/machinery/atmospherics/pipe/simple/general/visible/layer2{
	dir = 6
	},
/obj/machinery/atmospherics/pipe/simple/general/visible/layer4{
	dir = 6
	},
/turf/open/floor/plating,
/area/template_noop)
"ch" = (
/obj/machinery/atmospherics/pipe/simple/general/visible{
	dir = 9
	},
/obj/machinery/atmospherics/pipe/simple/general/visible/layer2{
	dir = 9
	},
/obj/machinery/atmospherics/pipe/simple/general/visible/layer4{
	dir = 9
	},
/turf/open/floor/plating,
/area/template_noop)
"ci" = (
/obj/machinery/atmospherics/pipe/simple/general/visible{
	dir = 5
	},
/obj/machinery/atmospherics/pipe/simple/general/visible/layer2{
	dir = 5
	},
/obj/machinery/atmospherics/pipe/simple/general/visible/layer4{
	dir = 5
	},
/turf/open/floor/plating,
/area/template_noop)

(1,1,1) = {"
aa
aa
aa
aa
aa
aa
aa
aa
aa
aa
aa
aa
aa
aa
aa
aa
aa
aa
aa
aa
"}
(2,1,1) = {"
aa
aa
aa
aa
aa
aa
aa
aa
aa
aa
aa
aa
aa
aa
aa
aa
aa
aa
aa
aa
"}
(3,1,1) = {"
aa
aa
aa
aa
aa
aa
aa
aa
bv
bF
bP
bZ
aN
aH
bu
bu
aa
aa
aa
aa
"}
(4,1,1) = {"
aa
aa
aa
aa
aa
bu
aa
aa
bw
bG
bQ
ca
aO
aI
bu
bu
aa
aa
aa
aa
"}
(5,1,1) = {"
aa
aa
aa
aa
aa
bu
bu
aa
bx
bH
bR
cb
aM
aG
bu
bu
aa
aa
aa
aa
"}
(6,1,1) = {"
aa
aa
aa
aa
aa
bu
bu
aa
by
bI
bS
cc
aL
aF
bu
bu
aa
aa
aa
aa
"}
(7,1,1) = {"
aa
ab
an
az
aa
bu
bu
aa
bz
bJ
bT
cd
ah
at
bu
bu
aa
aa
aa
aa
"}
(8,1,1) = {"
aa
ac
ao
aA
aa
bu
bu
aa
bA
bK
bU
ce
ai
au
bu
bu
aa
aa
aa
aa
"}
(9,1,1) = {"
aa
ad
ap
aB
aa
bu
aa
aa
bB
bL
bV
cf
aj
av
bu
bu
aa
aa
aa
aa
"}
(10,1,1) = {"
aa
ae
aq
aC
aa
aa
aa
aa
bC
bM
bW
cg
ak
aw
bu
bu
aa
aa
aa
aa
"}
(11,1,1) = {"
aa
af
ar
aD
aa
aa
aa
aa
bD
bN
bX
ch
al
ax
aJ
aP
aa
aa
aa
aa
"}
(12,1,1) = {"
aa
ag
as
aE
aa
bp
aa
aa
bE
bO
bY
ci
am
ay
aK
bq
aa
aa
aa
aa
"}
(13,1,1) = {"
aa
aa
aa
aa
aa
aa
aa
aa
aa
aa
aa
aa
aa
aa
aa
aa
aa
aa
aa
aa
"}
(14,1,1) = {"
aa
ah
at
aF
aL
aa
aQ
aV
ba
bf
bk
aa
aa
aa
aa
aa
aa
aa
aa
aa
"}
(15,1,1) = {"
aa
ai
au
aG
aM
aa
aR
aW
bb
bg
bl
aa
aa
aa
aa
aa
aa
aa
aa
aa
"}
(16,1,1) = {"
aa
aj
av
aH
aN
aa
aS
aX
bc
bh
bm
aa
aa
aa
aa
aa
aa
aa
aa
aa
"}
(17,1,1) = {"
aa
ak
aw
aI
aO
aa
aT
aY
bd
bi
bn
aa
aa
aa
aa
aa
aa
aa
aa
aa
"}
(18,1,1) = {"
aa
al
ax
aJ
aP
aa
aU
aZ
be
bj
bo
aa
aa
aa
aa
aa
aa
aa
aa
aa
"}
(19,1,1) = {"
aa
am
ay
aK
bq
aa
aa
br
bs
bt
aa
aa
aa
aa
aa
aa
aa
aa
aa
aa
"}
(20,1,1) = {"
aa
aa
aa
aa
aa
aa
aa
aa
aa
aa
aa
aa
aa
aa
aa
aa
aa
aa
aa
aa
"}
