//MAP CONVERTED BY dmm2tgm.py THIS HEADER COMMENT PREVENTS RECONVERSION, DO NOT REMOVE
"a" = (
/turf/closed/wall/mineral/titanium/nodiagonal,
/area/shuttle/pod_1)
"g" = (
/obj/effect/turf_decal/stripes/line{
	dir = 4
	},
/obj/structure/chair/fancy/shuttle{
	dir = 4
	},
/turf/open/floor/monofloor{
	dir = 8
	},
/area/shuttle/pod_1)
"h" = (
/turf/open/floor/plasteel/grid/techfloor,
/area/shuttle/pod_1)
"k" = (
/obj/effect/turf_decal/stripes/line{
	dir = 8
	},
/obj/structure/chair/fancy/shuttle{
	dir = 8
	},
/turf/open/floor/monofloor{
	dir = 4
	},
/area/shuttle/pod_1)
"p" = (
/obj/machinery/light/small{
	bulb_colour = "#FF3232";
	bulb_vacuum_colour = "#FF3232";
	color = "#FF3232";
	dir = 1;
	nightshift_light_color = "#FF3232"
	},
/obj/machinery/computer/shuttle_flight/pod{
	pixel_y = 28
	},
/obj/item/storage/pod{
	pixel_x = -24;
	pixel_y = 30
	},
/obj/item/radio/intercom{
	pixel_x = 30;
	pixel_y = 28
	},
/turf/open/floor/plasteel/grid/techfloor,
/area/shuttle/pod_1)
"q" = (
/turf/closed/wall/mineral/titanium,
/area/shuttle/pod_1)
"w" = (
/obj/effect/turf_decal/stripes/line{
	dir = 4
	},
/obj/structure/chair/fancy/shuttle{
	dir = 4
	},
/obj/machinery/status_display/ai/west,
/turf/open/floor/monofloor{
	dir = 8
	},
/area/shuttle/pod_1)
"x" = (
/obj/effect/spawner/structure/window/shuttle,
/obj/structure/grille,
/turf/open/floor/plating,
/area/shuttle/pod_1)
"A" = (
/obj/structure/chair/fancy/shuttle{
	dir = 4
	},
/obj/effect/turf_decal/stripes/line{
	dir = 4
	},
/turf/open/floor/monofloor{
	dir = 8
	},
/area/shuttle/pod_1)
"F" = (
/obj/structure/chair/fancy/shuttle{
	dir = 8
	},
/obj/effect/turf_decal/stripes/line{
	dir = 8
	},
/turf/open/floor/monofloor{
	dir = 4
	},
/area/shuttle/pod_1)
"I" = (
/obj/structure/shuttle/engine/propulsion/burst,
/turf/closed/wall/mineral/titanium,
/area/shuttle/pod_1)
"K" = (
/obj/effect/turf_decal/stripes/line{
	dir = 8
	},
/obj/structure/chair/fancy/shuttle{
	dir = 8
	},
/obj/machinery/status_display/evac/east,
/turf/open/floor/monofloor{
	dir = 4
	},
/area/shuttle/pod_1)
"R" = (
/obj/machinery/door/airlock/titanium{
	name = "Escape Pod Airlock"
	},
/obj/docking_port/mobile/pod{
	dwidth = 2;
	height = 6;
	port_direction = 2;
	width = 5
	},
/turf/open/floor/plasteel/grid/techfloor,
/area/shuttle/pod_1)

(1,1,1) = {"
q
q
x
x
q
a
"}
(2,1,1) = {"
q
g
A
A
w
I
"}
(3,1,1) = {"
q
p
h
h
h
R
"}
(4,1,1) = {"
q
k
F
F
K
I
"}
(5,1,1) = {"
q
q
x
x
q
a
"}
