//MAP CONVERTED BY dmm2tgm.py THIS HEADER COMMENT PREVENTS RECONVERSION, DO NOT REMOVE
"a" = (
/turf/template_noop,
/area/template_noop)
"e" = (
/turf/open/floor/plating/asteroid/snow/airless,
/area/template_noop)
"f" = (
/turf/closed/mineral/random/high_chance/icesteroid,
/area/template_noop)
"n" = (
/turf/closed/mineral/random/low_chance/icesteroid,
/area/template_noop)
"q" = (
/turf/open/floor/plating/ice/smooth/airless,
/area/template_noop)
"D" = (
/turf/closed/mineral/random/icesteroid,
/area/template_noop)
"H" = (
/turf/closed/mineral/icesteroid,
/area/template_noop)

(1,1,1) = {"
a
a
a
a
a
a
a
a
a
a
a
a
a
a
a
a
a
a
a
a
a
a
a
a
a
a
a
a
a
a
a
a
a
a
a
a
a
a
a
a
"}
(2,1,1) = {"
a
a
a
a
a
a
a
a
a
a
a
a
a
a
a
a
a
a
a
a
a
a
a
a
a
a
a
a
a
a
a
a
a
a
a
a
a
a
a
a
"}
(3,1,1) = {"
a
a
a
a
a
a
a
a
a
a
e
e
a
a
a
a
a
a
a
a
a
a
a
a
a
a
a
a
a
a
a
a
a
a
a
a
a
a
a
a
"}
(4,1,1) = {"
a
a
a
a
a
a
a
e
e
e
e
e
e
e
a
a
a
a
a
a
a
a
a
a
a
a
a
a
a
a
a
a
a
a
a
a
a
a
a
a
"}
(5,1,1) = {"
a
a
a
a
a
a
e
e
e
e
e
e
e
e
e
e
e
a
a
a
a
a
a
a
a
a
a
a
a
a
a
a
a
a
a
a
a
a
a
a
"}
(6,1,1) = {"
a
a
a
a
a
a
e
e
e
e
e
e
e
e
e
e
e
e
e
e
e
e
e
e
a
a
a
a
a
a
a
a
a
a
a
a
a
a
a
a
"}
(7,1,1) = {"
a
a
a
a
a
e
e
e
D
n
e
e
e
e
e
e
e
e
e
e
e
e
e
e
e
a
a
a
a
a
a
a
a
a
a
a
a
a
a
a
"}
(8,1,1) = {"
a
a
a
a
e
e
e
D
D
n
n
e
H
H
H
e
e
e
e
e
e
e
e
e
e
a
a
a
e
a
a
a
a
a
a
a
a
a
a
a
"}
(9,1,1) = {"
a
a
a
e
D
D
D
D
D
n
n
H
H
H
H
H
e
e
e
e
e
e
e
e
e
e
e
a
e
e
e
a
a
a
a
a
a
a
a
a
"}
(10,1,1) = {"
a
a
a
e
e
e
D
D
n
n
H
H
H
H
H
H
H
e
e
e
e
e
e
e
e
e
q
q
q
e
e
a
a
a
a
a
a
a
a
a
"}
(11,1,1) = {"
a
a
a
a
e
e
D
D
H
H
H
H
H
H
H
H
H
H
H
e
e
e
e
q
q
q
q
q
q
e
e
e
a
a
a
a
a
a
a
a
"}
(12,1,1) = {"
a
a
a
a
a
a
e
e
H
H
H
H
H
n
n
n
H
H
H
H
H
e
q
q
e
e
e
e
e
e
e
e
e
a
a
a
a
a
a
a
"}
(13,1,1) = {"
a
a
a
a
a
a
a
a
e
e
H
H
H
n
n
n
n
n
n
H
H
H
q
e
e
e
e
e
e
e
e
e
e
a
a
a
a
a
a
a
"}
(14,1,1) = {"
a
a
a
a
a
a
a
a
a
e
e
H
H
H
n
n
n
n
H
H
H
H
H
H
H
e
e
e
e
e
e
e
e
a
a
a
a
a
a
a
"}
(15,1,1) = {"
a
a
a
a
a
a
a
a
a
a
e
e
H
H
H
H
H
H
H
H
H
H
H
H
H
H
e
e
e
e
e
e
e
a
a
a
a
a
a
a
"}
(16,1,1) = {"
a
a
a
a
a
a
a
a
a
a
a
e
H
H
H
H
H
H
H
H
H
H
H
H
H
H
e
e
e
e
e
e
e
e
a
a
a
a
a
a
"}
(17,1,1) = {"
a
a
a
a
a
a
a
a
a
a
e
e
H
H
H
H
H
H
H
H
H
H
H
H
H
H
H
e
e
e
e
e
e
e
a
a
a
a
a
a
"}
(18,1,1) = {"
a
a
a
a
a
a
e
a
a
a
e
e
H
H
H
H
H
H
H
H
H
H
H
H
H
H
H
e
e
e
e
e
e
e
e
a
a
a
a
a
"}
(19,1,1) = {"
a
a
a
e
e
e
e
e
a
e
e
e
H
H
H
H
H
H
H
H
H
H
H
H
H
H
e
e
e
e
e
e
H
H
e
a
a
a
a
a
"}
(20,1,1) = {"
a
a
a
e
e
e
e
e
e
q
q
q
H
H
H
H
H
H
H
H
H
H
H
H
H
H
H
e
e
e
e
e
D
D
a
a
a
a
a
a
"}
(21,1,1) = {"
a
a
a
a
a
e
e
e
q
q
e
H
H
H
H
H
H
H
H
H
H
H
H
H
H
H
H
e
e
e
e
D
D
f
a
a
a
a
a
a
"}
(22,1,1) = {"
a
a
a
a
a
a
e
q
q
e
e
H
H
H
H
H
H
H
H
H
H
H
H
H
H
H
e
e
e
e
H
n
D
e
a
a
a
a
a
a
"}
(23,1,1) = {"
a
a
a
a
a
a
q
q
e
e
e
H
H
H
H
H
H
H
H
H
H
H
H
H
H
H
e
e
e
e
H
n
n
e
a
a
a
a
a
a
"}
(24,1,1) = {"
a
a
a
a
a
a
e
e
e
e
H
H
H
H
H
H
H
H
H
H
H
H
H
H
H
H
e
e
e
H
H
n
H
a
a
a
a
a
a
a
"}
(25,1,1) = {"
a
a
a
a
a
a
e
e
e
e
H
H
H
H
H
H
H
H
H
H
H
H
H
H
D
e
e
e
e
H
H
H
e
a
a
a
a
a
a
a
"}
(26,1,1) = {"
a
a
a
a
a
a
e
e
e
e
e
H
H
H
H
H
H
H
H
H
H
H
H
D
D
e
e
e
e
H
H
H
a
a
a
a
a
a
a
a
"}
(27,1,1) = {"
a
a
a
a
a
a
a
e
e
e
e
e
H
H
H
q
H
H
H
H
H
H
D
D
e
e
e
e
e
H
D
H
a
a
a
a
a
a
a
a
"}
(28,1,1) = {"
a
a
a
a
a
a
a
e
e
e
e
e
e
e
q
q
q
e
e
H
H
D
D
D
e
e
e
e
e
D
D
e
a
a
a
a
a
a
a
a
"}
(29,1,1) = {"
a
a
a
a
a
a
a
a
e
e
e
e
e
e
q
q
q
e
e
e
D
D
D
D
e
e
e
e
D
D
D
e
a
a
a
a
a
a
a
a
"}
(30,1,1) = {"
a
a
a
a
a
a
a
a
e
n
n
H
e
e
e
q
q
e
e
e
e
e
e
e
e
e
e
e
H
f
D
e
a
a
a
a
a
a
a
a
"}
(31,1,1) = {"
a
a
a
a
a
a
a
a
a
n
n
n
H
H
e
q
q
q
e
e
e
e
e
e
e
e
e
e
H
D
D
a
a
a
a
a
a
a
a
a
"}
(32,1,1) = {"
a
a
a
a
a
a
a
a
a
a
e
n
n
H
H
H
q
q
e
e
e
e
e
e
e
e
e
e
e
D
a
a
a
a
a
a
a
a
a
a
"}
(33,1,1) = {"
a
a
a
a
a
a
a
a
a
a
e
n
D
D
H
H
H
H
e
e
e
e
e
e
e
e
e
a
a
e
a
a
a
a
a
a
a
a
a
a
"}
(34,1,1) = {"
a
a
a
a
a
a
a
a
a
e
e
D
f
D
D
H
H
H
H
H
H
e
e
e
e
e
e
a
a
a
a
a
a
a
a
a
a
a
a
a
"}
(35,1,1) = {"
a
a
a
a
a
a
a
a
a
e
e
D
D
D
D
H
H
H
H
H
H
H
e
e
e
e
a
a
a
a
a
a
a
a
a
a
a
a
a
a
"}
(36,1,1) = {"
a
a
a
a
a
a
a
a
a
e
H
D
D
H
a
a
a
H
H
H
H
H
e
e
e
a
a
a
a
a
a
a
a
a
a
a
a
a
a
a
"}
(37,1,1) = {"
a
a
a
a
a
a
a
a
a
e
H
a
a
a
a
a
a
a
a
H
a
a
a
a
a
a
a
a
a
a
a
a
a
a
a
a
a
a
a
a
"}
(38,1,1) = {"
a
a
a
a
a
a
a
a
a
e
a
a
a
a
a
a
a
a
a
a
a
a
a
a
a
a
a
a
a
a
a
a
a
a
a
a
a
a
a
a
"}
(39,1,1) = {"
a
a
a
a
a
a
a
a
a
a
a
a
a
a
a
a
a
a
a
a
a
a
a
a
a
a
a
a
a
a
a
a
a
a
a
a
a
a
a
a
"}
(40,1,1) = {"
a
a
a
a
a
a
a
a
a
a
a
a
a
a
a
a
a
a
a
a
a
a
a
a
a
a
a
a
a
a
a
a
a
a
a
a
a
a
a
a
"}
