//MAP CONVERTED BY dmm2tgm.py THIS HEADER COMMENT PREVENTS RECONVERSION, DO NOT REMOVE
"a" = (
/turf/template_noop,
/area/template_noop)
"m" = (
/turf/open/floor/plating/asteroid/snow/airless,
/area/template_noop)
"t" = (
/turf/closed/mineral/random/high_chance/icesteroid,
/area/template_noop)
"x" = (
/turf/closed/mineral/icesteroid,
/area/template_noop)
"E" = (
/turf/closed/mineral/random/low_chance/icesteroid,
/area/template_noop)
"M" = (
/turf/closed/mineral/random/icesteroid,
/area/template_noop)
"T" = (
/turf/open/floor/plating/ice/smooth/airless,
/area/template_noop)

(1,1,1) = {"
a
a
a
a
a
a
a
a
a
a
a
a
a
a
a
a
a
a
a
a
a
a
a
a
a
a
a
a
a
a
a
a
a
a
a
a
a
a
a
a
"}
(2,1,1) = {"
a
a
a
a
a
a
a
a
a
a
a
a
a
a
a
a
a
a
a
a
a
a
a
a
a
a
a
a
a
a
a
a
a
a
a
a
a
a
a
a
"}
(3,1,1) = {"
a
a
a
a
a
a
a
a
a
a
a
a
a
a
a
a
a
a
a
a
a
a
a
a
a
a
a
a
a
a
a
a
a
a
a
a
a
a
a
a
"}
(4,1,1) = {"
a
a
a
x
x
m
a
a
a
a
a
a
a
a
a
a
a
a
a
a
a
a
a
a
a
a
a
a
a
a
a
a
a
a
a
a
a
a
a
a
"}
(5,1,1) = {"
a
a
a
M
M
x
m
a
a
a
a
a
a
a
a
a
a
a
a
a
a
a
a
a
a
a
a
a
a
a
a
a
a
a
a
a
a
a
a
a
"}
(6,1,1) = {"
a
a
a
m
M
t
x
a
a
a
a
a
a
a
a
a
a
a
a
a
a
a
a
a
a
a
a
a
a
a
a
a
a
a
a
a
a
a
a
a
"}
(7,1,1) = {"
a
a
a
m
M
E
x
a
a
a
a
a
a
a
a
a
a
a
a
a
a
a
a
a
a
a
a
a
a
a
a
a
a
m
m
a
a
a
a
a
"}
(8,1,1) = {"
a
a
a
a
m
a
a
a
a
a
a
a
a
a
a
a
a
a
a
a
a
a
a
a
a
a
a
a
a
a
a
a
m
x
M
m
a
a
a
a
"}
(9,1,1) = {"
a
a
a
a
a
a
a
a
a
a
a
m
a
a
a
a
a
a
a
a
a
a
a
a
a
a
a
a
a
a
a
a
x
M
M
m
a
a
a
a
"}
(10,1,1) = {"
a
a
a
a
a
a
a
a
a
a
a
m
m
a
a
m
a
a
a
a
a
a
a
a
a
x
x
x
x
a
a
a
m
x
m
a
a
a
a
a
"}
(11,1,1) = {"
a
a
a
a
a
a
a
a
a
a
T
M
m
a
m
m
a
a
a
a
a
a
a
a
x
x
x
x
x
x
m
m
m
m
m
a
a
a
a
a
"}
(12,1,1) = {"
a
a
a
a
a
a
a
a
a
M
M
M
x
x
x
m
a
a
a
a
a
a
a
a
x
E
E
E
x
x
x
x
x
x
a
a
a
a
a
a
"}
(13,1,1) = {"
a
a
a
a
a
a
a
a
a
M
M
M
M
x
x
a
a
a
a
a
m
m
m
x
x
E
E
E
x
x
m
m
x
a
a
a
a
a
a
a
"}
(14,1,1) = {"
a
a
a
a
a
a
a
a
a
M
M
M
M
M
x
x
m
m
m
m
m
m
x
x
x
E
t
E
E
x
m
a
a
a
a
a
a
a
a
a
"}
(15,1,1) = {"
a
a
a
a
a
a
a
a
a
M
M
M
M
M
M
x
x
m
x
m
m
x
x
x
x
M
M
t
E
x
x
a
a
a
a
a
a
a
a
a
"}
(16,1,1) = {"
a
a
a
a
a
a
a
a
x
x
x
t
M
M
M
M
x
m
E
m
m
x
x
x
x
M
M
M
E
x
x
a
a
a
a
a
a
a
a
a
"}
(17,1,1) = {"
a
a
a
a
a
a
a
a
x
x
x
x
M
M
M
x
x
E
E
m
m
x
x
x
x
M
M
x
E
x
x
x
a
a
a
a
a
a
a
a
"}
(18,1,1) = {"
a
a
a
a
a
a
a
a
x
x
x
x
x
M
M
x
E
E
E
E
m
m
x
x
x
x
x
x
x
x
x
x
a
a
a
a
a
a
a
a
"}
(19,1,1) = {"
a
a
a
a
a
a
a
a
x
x
x
x
x
x
x
x
x
E
E
E
m
m
x
x
x
x
x
m
x
x
x
x
m
a
a
a
a
a
a
a
"}
(20,1,1) = {"
a
a
a
a
a
a
a
a
x
x
M
x
x
x
x
x
x
E
E
E
T
T
m
m
x
x
x
m
T
T
T
T
m
a
a
a
a
a
a
a
"}
(21,1,1) = {"
a
a
a
a
a
a
a
a
a
M
M
x
x
x
x
x
m
m
m
T
T
T
T
T
x
x
x
m
m
x
m
m
a
a
a
a
a
a
a
a
"}
(22,1,1) = {"
a
a
a
a
a
a
a
a
a
a
a
m
T
T
T
T
T
T
x
x
x
T
T
T
T
T
T
m
x
x
x
m
a
a
a
a
a
a
a
a
"}
(23,1,1) = {"
a
a
a
a
a
a
a
a
a
a
a
m
T
T
T
T
t
t
x
x
x
m
m
T
T
m
x
x
x
x
x
m
a
a
a
a
a
a
a
a
"}
(24,1,1) = {"
a
a
a
a
a
a
a
a
a
a
a
a
m
m
x
x
x
x
x
x
x
m
T
T
m
x
x
M
M
M
x
x
a
a
a
a
a
a
a
a
"}
(25,1,1) = {"
a
a
a
a
a
a
a
a
a
a
a
a
m
m
x
M
M
M
x
x
x
x
x
T
m
x
x
M
M
t
E
x
x
a
a
a
a
a
a
a
"}
(26,1,1) = {"
a
a
a
a
a
a
a
a
a
a
a
a
m
x
x
M
M
M
M
M
x
x
x
T
m
m
M
M
M
E
E
x
x
a
a
a
a
a
a
a
"}
(27,1,1) = {"
a
a
a
a
a
a
a
a
a
a
a
a
a
E
E
E
M
M
M
M
M
x
x
m
m
m
m
M
x
E
E
E
x
a
a
a
a
a
a
a
"}
(28,1,1) = {"
a
a
a
a
a
a
a
a
a
a
a
a
a
E
E
E
M
M
M
M
M
M
x
x
m
m
m
x
x
x
x
E
a
a
a
a
a
a
a
a
"}
(29,1,1) = {"
a
a
a
a
a
a
a
a
a
a
a
a
a
E
E
E
M
M
M
M
M
M
x
x
m
m
m
x
x
x
x
x
a
a
a
a
a
a
a
a
"}
(30,1,1) = {"
a
a
a
a
a
a
a
a
a
a
a
a
a
x
E
E
E
M
M
M
x
x
x
x
x
T
T
T
T
T
x
x
a
a
a
a
a
a
a
a
"}
(31,1,1) = {"
a
a
a
a
a
a
a
a
a
a
a
a
a
x
E
E
E
E
x
E
E
x
x
x
x
m
m
m
m
T
T
m
a
a
a
a
a
a
a
a
"}
(32,1,1) = {"
a
a
a
a
a
a
a
a
a
a
a
a
a
x
E
E
E
E
x
x
E
t
x
x
x
x
m
m
m
m
m
a
a
a
a
a
a
a
a
a
"}
(33,1,1) = {"
a
a
a
a
a
a
a
a
a
a
a
a
a
a
a
a
E
E
x
x
x
x
x
x
x
x
x
m
m
m
m
a
a
a
a
a
a
a
a
a
"}
(34,1,1) = {"
a
a
a
a
a
a
a
a
a
a
a
a
a
a
a
a
a
a
x
x
x
x
x
x
x
x
x
x
m
m
a
a
a
a
a
a
a
a
a
a
"}
(35,1,1) = {"
a
a
a
a
a
a
a
a
a
a
a
a
a
a
a
a
a
a
a
x
x
x
x
x
x
x
m
m
m
a
a
a
a
a
a
a
a
a
a
a
"}
(36,1,1) = {"
a
a
a
a
a
a
a
a
a
a
a
a
a
a
a
a
a
a
a
a
x
x
x
x
x
a
a
a
a
a
a
a
a
a
a
a
a
a
a
a
"}
(37,1,1) = {"
a
a
a
a
a
a
a
a
a
a
a
a
a
a
a
a
a
a
a
a
a
a
a
a
a
a
a
a
a
a
a
a
a
a
a
a
a
a
a
a
"}
(38,1,1) = {"
a
a
a
a
a
a
a
a
a
a
a
a
a
a
a
a
a
a
a
a
a
a
a
a
a
a
a
a
a
a
a
a
a
a
a
a
a
a
a
a
"}
(39,1,1) = {"
a
a
a
a
a
a
a
a
a
a
a
a
a
a
a
a
a
a
a
a
a
a
a
a
a
a
a
a
a
a
a
a
a
a
a
a
a
a
a
a
"}
(40,1,1) = {"
a
a
a
a
a
a
a
a
a
a
a
a
a
a
a
a
a
a
a
a
a
a
a
a
a
a
a
a
a
a
a
a
a
a
a
a
a
a
a
a
"}
