//MAP CONVERTED BY dmm2tgm.py THIS HEADER COMMENT PREVENTS RECONVERSION, DO NOT REMOVE
"b" = (
/turf/template_noop,
/area/template_noop)
"c" = (
/turf/template_gen/open,
/area/template_noop)
"e" = (
/turf/template_gen/closed,
/area/template_noop)
"j" = (
/obj/effect/landmark/dropship_entry,
/turf/template_noop,
/area/template_noop)

(1,1,1) = {"
b
b
b
b
b
b
b
b
b
b
b
b
b
b
b
b
b
b
b
b
b
b
b
b
b
b
b
b
b
b
b
b
b
b
b
b
b
b
b
b
"}
(2,1,1) = {"
b
b
b
b
b
b
b
b
b
b
b
b
b
b
b
b
b
b
b
b
b
b
b
b
b
b
b
b
b
b
b
b
b
b
b
b
b
b
b
b
"}
(3,1,1) = {"
b
b
b
b
b
b
b
b
b
b
b
b
b
e
b
b
b
b
b
b
b
b
b
b
b
b
b
b
b
b
b
b
b
b
b
b
b
b
b
b
"}
(4,1,1) = {"
b
b
b
b
b
b
b
b
b
b
b
b
e
e
e
e
e
b
b
b
b
b
b
b
b
b
b
b
b
b
b
b
b
b
b
b
b
b
b
b
"}
(5,1,1) = {"
b
b
b
b
b
b
b
b
b
b
b
b
b
e
e
e
e
e
b
b
b
b
b
b
b
b
b
b
b
b
b
b
b
b
b
b
b
b
b
b
"}
(6,1,1) = {"
b
b
b
b
b
b
b
b
b
b
b
b
b
b
e
e
e
e
b
b
b
b
b
b
b
b
b
b
b
b
b
b
b
b
b
b
b
b
b
b
"}
(7,1,1) = {"
b
b
b
b
b
b
b
b
b
b
b
e
e
e
e
c
e
e
b
b
b
b
b
b
b
b
b
b
b
b
b
b
b
b
b
b
b
b
b
b
"}
(8,1,1) = {"
b
b
b
b
b
b
b
b
b
b
b
e
e
e
e
c
c
e
e
e
b
b
b
b
b
b
b
b
b
b
b
b
b
b
b
b
b
b
b
b
"}
(9,1,1) = {"
b
b
b
b
b
b
b
b
b
b
b
b
e
e
e
e
c
e
e
e
e
e
e
b
b
b
b
e
b
e
b
b
b
b
b
b
b
b
b
b
"}
(10,1,1) = {"
b
b
b
b
b
b
b
b
b
b
b
e
b
e
e
e
c
c
c
e
e
e
e
e
e
b
b
e
c
e
b
b
b
b
b
b
b
b
b
b
"}
(11,1,1) = {"
b
b
b
b
b
b
b
b
b
b
b
e
b
b
c
c
c
c
c
e
e
e
e
e
e
c
b
e
e
e
e
b
b
b
b
b
b
b
b
b
"}
(12,1,1) = {"
b
b
b
b
b
b
b
b
b
b
b
b
b
b
c
c
c
c
e
e
c
c
e
e
e
b
b
e
e
e
b
b
b
b
b
b
b
b
b
b
"}
(13,1,1) = {"
b
b
b
b
b
b
b
b
b
b
b
b
b
c
c
c
c
c
c
c
c
c
c
c
c
b
b
c
e
e
e
b
b
b
b
b
b
b
b
b
"}
(14,1,1) = {"
b
b
b
b
b
b
b
b
b
b
e
b
b
c
c
c
e
e
e
e
c
c
c
c
c
c
b
e
e
e
e
e
b
b
b
b
b
b
b
b
"}
(15,1,1) = {"
b
b
b
b
b
b
b
b
b
b
b
b
c
c
c
c
e
e
e
e
e
e
e
e
e
c
b
b
e
e
e
b
b
b
b
b
b
b
b
b
"}
(16,1,1) = {"
b
b
b
b
b
b
b
b
b
b
b
b
c
c
c
e
e
e
e
e
e
e
e
e
e
c
c
c
b
e
e
b
b
b
b
b
b
b
b
b
"}
(17,1,1) = {"
b
b
b
b
b
b
b
b
b
b
b
b
c
c
e
e
e
e
e
e
e
e
e
e
e
c
c
c
b
b
e
b
b
b
b
b
b
b
b
b
"}
(18,1,1) = {"
b
b
b
b
b
b
b
b
b
b
b
b
c
c
c
e
e
e
e
e
e
e
e
e
e
e
e
c
c
b
b
b
b
b
b
b
b
b
b
b
"}
(19,1,1) = {"
b
b
b
b
b
b
b
b
b
b
b
b
b
c
c
c
e
e
e
e
e
e
e
e
e
e
e
c
c
b
b
b
b
b
b
b
b
b
b
b
"}
(20,1,1) = {"
b
b
b
b
b
b
b
b
b
b
b
b
b
c
c
c
e
e
e
e
e
e
e
e
e
e
e
c
c
b
b
b
b
b
b
j
b
b
b
b
"}
(21,1,1) = {"
b
b
b
b
b
b
b
b
b
b
b
b
b
b
c
c
e
e
e
e
e
e
e
e
e
e
e
e
c
b
b
b
b
b
b
b
b
b
b
b
"}
(22,1,1) = {"
b
b
b
b
b
b
b
b
b
b
b
b
b
b
c
c
e
e
e
e
e
e
e
e
e
e
e
e
c
c
b
b
b
b
b
b
b
b
b
b
"}
(23,1,1) = {"
b
b
b
b
b
b
b
b
b
b
b
b
b
b
c
c
c
c
c
e
e
e
e
e
e
e
e
e
e
c
b
b
b
b
b
b
b
b
b
b
"}
(24,1,1) = {"
b
b
b
b
b
b
b
b
b
b
b
b
b
b
b
b
c
c
c
e
e
e
e
e
e
e
e
e
e
c
b
b
b
b
b
b
b
b
b
b
"}
(25,1,1) = {"
b
b
b
b
b
b
b
b
b
b
b
b
b
b
b
b
b
b
c
c
c
e
e
e
e
e
c
c
c
c
b
b
b
b
b
b
b
b
b
b
"}
(26,1,1) = {"
b
b
b
b
b
b
b
b
b
b
b
b
b
c
b
b
b
b
c
c
c
c
c
c
c
c
c
c
b
b
b
b
b
b
b
b
b
b
b
b
"}
(27,1,1) = {"
b
b
b
b
b
b
b
b
b
b
b
b
b
c
c
b
b
b
b
b
c
c
c
c
c
c
c
b
b
b
b
b
b
b
b
b
b
b
b
b
"}
(28,1,1) = {"
b
b
b
b
b
b
b
b
b
b
b
b
b
b
b
b
b
b
b
b
c
c
c
c
c
c
c
b
b
b
b
b
b
b
b
b
b
b
b
b
"}
(29,1,1) = {"
b
b
b
b
b
b
b
b
b
b
b
b
c
b
b
b
b
b
b
b
b
b
b
b
b
b
b
b
e
e
b
b
b
b
b
b
b
b
b
b
"}
(30,1,1) = {"
b
b
b
b
b
b
b
b
b
b
b
b
b
b
b
b
b
b
b
b
b
b
b
b
b
b
e
e
e
e
e
b
b
b
b
b
b
b
b
b
"}
(31,1,1) = {"
b
b
b
b
b
b
b
b
b
b
b
b
b
b
b
b
b
b
b
b
e
e
e
e
e
e
e
e
e
e
e
e
b
b
b
b
b
b
b
b
"}
(32,1,1) = {"
b
b
b
b
b
b
b
b
b
b
b
b
b
b
b
b
b
b
b
b
b
e
e
e
e
e
e
e
e
e
b
e
e
b
b
b
b
b
b
b
"}
(33,1,1) = {"
b
b
b
b
b
b
b
b
b
b
b
b
b
b
b
b
b
b
b
b
b
e
e
e
e
e
e
e
e
e
e
e
e
b
b
b
b
b
b
b
"}
(34,1,1) = {"
b
b
b
b
b
b
b
b
b
b
b
b
b
b
b
b
b
b
b
b
b
e
e
e
e
e
e
e
e
e
e
b
b
b
b
b
b
b
b
b
"}
(35,1,1) = {"
b
b
b
b
b
b
b
b
b
b
b
b
b
b
b
b
b
b
b
b
b
b
b
b
e
e
e
e
e
e
e
b
b
b
b
b
b
b
b
b
"}
(36,1,1) = {"
b
b
b
b
b
b
b
b
b
b
b
b
b
b
b
b
b
b
b
b
b
b
b
b
b
b
b
b
e
e
b
b
b
b
b
b
b
b
b
b
"}
(37,1,1) = {"
b
b
b
b
b
b
b
b
b
b
b
b
b
b
b
b
b
b
b
b
b
b
b
b
b
b
b
b
b
b
b
b
b
b
b
b
b
b
b
b
"}
(38,1,1) = {"
b
b
b
b
b
b
b
b
b
b
b
b
b
b
b
b
b
b
b
b
b
b
b
b
b
b
b
b
b
b
b
b
b
b
b
b
b
b
b
b
"}
(39,1,1) = {"
b
b
b
b
b
b
b
b
b
b
b
b
b
b
b
b
b
b
b
b
b
b
b
b
b
b
b
b
b
b
b
b
b
b
b
b
b
b
b
b
"}
(40,1,1) = {"
b
b
b
b
b
b
b
b
b
b
b
b
b
b
b
b
b
b
b
b
b
b
b
b
b
b
b
b
b
b
b
b
b
b
b
b
b
b
b
b
"}
