//MAP CONVERTED BY dmm2tgm.py THIS HEADER COMMENT PREVENTS RECONVERSION, DO NOT REMOVE
"a" = (
/turf/closed/mineral,
/area/template_noop)
"b" = (
/turf/template_noop,
/area/template_noop)
"c" = (
/turf/closed/mineral/random,
/area/template_noop)
"d" = (
/turf/open/floor/plating/asteroid/airless,
/area/template_noop)
"M" = (
/turf/closed/mineral/random/high_chance,
/area/template_noop)

(1,1,1) = {"
b
b
b
b
b
b
b
b
b
b
b
b
b
b
b
b
b
b
b
b
b
b
b
b
b
b
b
b
b
b
b
b
b
b
b
b
b
b
b
b
"}
(2,1,1) = {"
b
b
b
b
b
b
b
b
b
b
b
b
b
b
b
b
b
b
b
b
b
b
b
b
b
b
b
b
b
b
b
b
b
b
b
b
b
b
b
b
"}
(3,1,1) = {"
b
b
b
b
b
b
b
b
b
b
a
a
b
b
b
b
b
b
b
b
b
b
b
b
b
b
b
b
b
b
b
b
b
b
b
b
b
b
b
b
"}
(4,1,1) = {"
b
b
b
b
b
b
b
b
b
b
b
b
b
b
b
b
b
b
b
b
b
b
b
b
b
b
b
b
b
b
b
b
b
b
b
b
b
b
b
b
"}
(5,1,1) = {"
b
b
b
b
b
b
b
b
d
d
a
a
a
b
b
b
b
b
b
b
b
b
b
b
b
b
b
b
b
b
b
b
b
b
b
b
b
b
b
b
"}
(6,1,1) = {"
b
b
b
b
b
b
b
b
d
d
a
a
a
a
b
b
b
b
b
b
b
b
b
b
b
b
b
b
b
b
b
b
b
b
b
b
b
b
b
b
"}
(7,1,1) = {"
b
b
b
b
b
b
b
b
d
a
a
a
a
a
b
b
b
b
b
b
b
b
b
b
b
b
b
b
b
b
b
b
b
b
b
b
b
b
b
b
"}
(8,1,1) = {"
b
b
b
b
b
b
b
d
a
a
a
a
a
b
b
b
b
d
d
d
b
b
b
b
b
b
b
b
b
b
d
d
b
b
b
b
b
b
b
b
"}
(9,1,1) = {"
b
b
b
b
b
b
b
d
a
a
M
a
a
d
d
d
d
d
d
d
d
d
b
b
b
b
b
b
d
d
a
a
d
b
b
b
b
b
b
b
"}
(10,1,1) = {"
b
b
b
b
b
b
b
d
a
a
a
a
d
d
d
d
c
c
c
c
d
d
d
d
b
b
b
b
a
a
a
d
b
b
b
b
b
b
b
b
"}
(11,1,1) = {"
b
b
b
b
b
b
b
d
a
a
a
a
d
c
c
c
c
c
c
c
c
d
d
d
d
d
d
a
a
a
d
d
b
b
b
b
b
b
b
b
"}
(12,1,1) = {"
b
b
b
b
b
b
b
d
a
a
d
d
c
c
c
c
c
c
c
c
c
c
c
c
a
a
a
a
a
a
d
d
b
b
b
b
b
b
b
b
"}
(13,1,1) = {"
b
b
b
b
b
b
b
d
a
a
d
d
c
c
c
c
c
c
c
c
c
c
c
c
a
a
a
a
a
a
d
d
b
b
b
b
b
b
b
b
"}
(14,1,1) = {"
b
b
b
b
b
b
b
d
d
d
d
c
c
c
c
c
c
c
c
c
c
c
c
a
a
a
a
a
a
b
b
b
b
b
b
b
b
b
b
b
"}
(15,1,1) = {"
b
b
b
b
b
b
d
d
d
d
c
c
c
c
c
c
c
c
c
c
c
c
c
c
a
a
a
a
a
a
b
b
b
b
b
b
b
b
b
b
"}
(16,1,1) = {"
b
b
b
b
b
b
d
d
d
d
d
c
c
c
c
c
c
c
c
c
c
c
c
a
a
a
M
a
a
d
b
b
b
b
b
b
b
b
b
b
"}
(17,1,1) = {"
b
b
b
b
b
b
d
d
d
c
c
d
d
d
d
d
c
c
c
c
c
c
a
a
a
c
a
c
a
d
d
b
b
b
b
b
b
b
b
b
"}
(18,1,1) = {"
b
b
b
b
b
b
d
d
d
c
c
c
c
c
d
d
d
d
c
c
c
c
a
a
c
c
c
a
a
d
d
b
b
b
b
b
b
b
b
b
"}
(19,1,1) = {"
b
b
b
b
b
b
d
d
d
c
d
d
d
d
d
d
d
d
d
d
d
c
d
c
c
c
c
c
c
d
d
b
b
b
b
b
b
b
b
b
"}
(20,1,1) = {"
b
b
b
b
b
b
b
d
d
c
c
d
c
c
c
d
d
c
d
d
d
d
d
d
d
c
c
c
c
c
d
d
b
b
b
b
b
b
b
b
"}
(21,1,1) = {"
b
b
b
b
b
b
b
d
d
c
c
d
d
c
c
c
c
c
a
a
c
d
d
d
d
d
d
d
c
c
d
d
b
b
b
b
b
b
b
b
"}
(22,1,1) = {"
b
b
b
b
b
b
b
d
d
c
c
c
d
c
c
c
c
c
a
c
c
c
d
d
d
c
c
d
c
d
d
d
b
b
b
b
b
b
b
b
"}
(23,1,1) = {"
b
b
b
b
b
b
b
b
d
c
c
c
d
c
c
c
c
a
a
c
c
c
c
c
d
c
c
d
d
d
d
a
b
b
b
b
b
b
b
b
"}
(24,1,1) = {"
b
b
b
b
b
b
b
a
d
d
c
c
c
c
c
c
c
a
M
c
c
c
c
c
c
c
c
c
d
d
d
a
a
a
b
b
b
b
b
b
"}
(25,1,1) = {"
b
b
b
b
b
b
d
a
a
d
d
c
c
c
c
c
c
a
c
c
c
c
c
c
c
c
c
c
d
d
d
a
a
a
b
b
b
b
b
b
"}
(26,1,1) = {"
b
b
b
b
b
d
d
a
a
d
d
d
c
c
c
c
c
a
c
c
c
c
c
c
c
c
c
c
c
d
d
a
a
b
b
b
b
b
b
b
"}
(27,1,1) = {"
b
b
b
b
b
d
d
a
a
d
d
d
c
c
c
c
c
a
c
c
c
c
c
c
c
c
c
c
c
d
d
a
a
b
b
b
b
b
b
b
"}
(28,1,1) = {"
b
b
b
b
b
d
a
a
a
a
d
d
d
c
c
c
c
a
c
c
c
c
c
c
c
c
c
c
d
d
d
a
b
b
b
b
b
b
b
b
"}
(29,1,1) = {"
b
b
b
b
b
d
a
a
a
a
a
a
a
d
d
c
d
d
c
c
c
c
c
c
c
c
c
c
c
d
d
b
b
b
b
b
b
b
b
b
"}
(30,1,1) = {"
b
b
b
b
b
b
d
a
a
a
a
a
a
a
d
d
d
c
c
c
c
c
c
c
c
M
c
c
d
d
b
b
b
d
b
b
b
b
b
b
"}
(31,1,1) = {"
b
b
b
b
b
b
d
d
a
a
a
M
a
a
a
d
d
d
c
c
c
c
c
c
c
c
c
d
d
d
b
b
d
d
a
a
b
b
b
b
"}
(32,1,1) = {"
b
b
b
b
b
b
b
b
d
d
a
a
a
a
a
d
d
d
d
c
c
c
c
c
c
c
c
d
d
b
b
b
d
a
a
a
d
b
b
b
"}
(33,1,1) = {"
b
b
b
b
b
b
b
b
b
b
d
d
d
a
a
a
a
d
d
d
c
c
c
c
d
d
d
d
b
b
b
b
d
a
M
a
d
b
b
b
"}
(34,1,1) = {"
b
b
b
b
b
b
b
b
b
b
b
d
d
a
a
a
a
a
a
d
d
d
d
d
d
d
b
b
b
b
b
b
d
a
d
d
b
b
b
b
"}
(35,1,1) = {"
b
b
b
b
b
b
b
b
b
b
b
b
b
b
a
a
a
a
a
b
d
d
d
d
b
b
b
b
b
b
b
b
d
d
d
d
b
b
b
b
"}
(36,1,1) = {"
b
b
b
b
b
b
b
b
b
b
b
b
b
b
b
b
b
b
b
b
b
b
b
b
b
b
b
b
b
b
b
b
d
d
d
b
b
b
b
b
"}
(37,1,1) = {"
b
b
b
b
b
b
b
b
b
b
b
b
b
b
b
b
b
b
b
b
b
b
b
b
b
b
b
b
b
b
b
b
b
b
b
b
b
b
b
b
"}
(38,1,1) = {"
b
b
b
b
b
b
b
b
b
b
b
b
b
b
b
b
b
b
b
b
b
b
b
b
b
b
b
b
b
b
b
b
b
b
b
b
b
b
b
b
"}
(39,1,1) = {"
b
b
b
b
b
b
b
b
b
b
b
b
b
b
b
b
b
b
b
b
b
b
b
b
b
b
b
b
b
b
b
b
b
b
b
b
b
b
b
b
"}
(40,1,1) = {"
b
b
b
b
b
b
b
b
b
b
b
b
b
b
b
b
b
b
b
b
b
b
b
b
b
b
b
b
b
b
b
b
b
b
b
b
b
b
b
b
"}
