//MAP CONVERTED BY dmm2tgm.py THIS HEADER COMMENT PREVENTS RECONVERSION, DO NOT REMOVE
"a" = (
/turf/template_noop,
/area/template_noop)
"y" = (
/turf/open/floor/plating/asteroid/airless,
/area/template_noop)
"K" = (
/obj/effect/landmark/dropship_entry,
/turf/template_noop,
/area/template_noop)
"U" = (
/turf/closed/mineral,
/area/template_noop)

(1,1,1) = {"
a
a
a
a
a
a
a
a
a
a
a
a
a
a
a
a
a
a
a
a
a
a
a
a
a
a
a
a
a
a
a
a
a
a
a
a
a
a
a
a
"}
(2,1,1) = {"
a
a
a
a
a
a
a
a
a
a
a
a
a
a
a
a
a
a
a
a
a
a
a
a
a
a
a
a
a
a
a
a
a
a
a
a
a
a
a
a
"}
(3,1,1) = {"
a
a
a
a
a
a
a
a
a
a
a
a
a
a
a
a
a
a
a
a
a
a
a
a
a
a
a
a
a
a
a
a
a
a
a
a
a
a
a
a
"}
(4,1,1) = {"
a
a
a
a
a
a
a
a
a
a
a
a
a
a
a
a
a
a
a
a
a
a
a
a
a
a
a
a
a
a
a
a
a
a
a
a
a
a
a
a
"}
(5,1,1) = {"
a
a
a
a
a
a
a
a
a
a
a
a
a
a
a
a
a
a
a
a
a
a
a
a
a
a
a
a
a
a
a
a
a
a
a
a
a
a
a
a
"}
(6,1,1) = {"
a
a
a
a
a
a
a
a
a
a
a
a
a
a
a
a
a
a
a
a
a
a
a
a
a
a
a
a
U
U
U
U
a
a
a
a
a
a
a
a
"}
(7,1,1) = {"
a
a
a
a
a
a
a
a
a
a
a
a
a
a
a
a
a
a
a
a
a
a
a
a
a
a
a
U
U
U
y
U
U
a
a
a
a
a
a
a
"}
(8,1,1) = {"
a
a
a
a
a
a
a
a
a
a
a
a
a
a
a
a
a
a
a
a
a
a
a
a
a
a
U
U
U
y
y
y
U
U
a
a
a
a
a
a
"}
(9,1,1) = {"
a
a
a
a
a
a
a
a
a
a
a
a
a
a
a
a
a
a
a
a
a
a
a
a
a
U
U
U
U
y
y
y
U
U
U
a
a
a
a
a
"}
(10,1,1) = {"
a
a
a
a
a
a
a
a
a
a
a
a
a
a
a
a
a
a
a
a
a
a
a
a
a
U
U
U
U
U
y
y
U
U
U
a
a
a
a
a
"}
(11,1,1) = {"
a
a
a
a
a
a
a
a
a
a
a
a
a
a
a
a
a
a
a
a
a
a
a
a
a
U
U
U
U
U
U
y
U
U
U
U
a
a
a
a
"}
(12,1,1) = {"
a
a
a
a
a
a
a
a
a
a
a
a
a
a
a
a
a
a
a
a
a
a
a
a
y
y
U
U
U
U
U
U
U
U
U
U
a
a
a
a
"}
(13,1,1) = {"
a
a
a
a
a
a
a
a
a
a
a
a
U
U
a
a
U
U
U
U
a
a
a
a
y
y
U
U
U
U
U
U
U
U
U
U
a
a
a
a
"}
(14,1,1) = {"
a
a
a
a
a
a
a
a
a
a
a
U
U
U
U
U
U
U
U
U
U
a
U
y
y
y
U
U
U
U
U
U
U
U
U
U
a
a
a
a
"}
(15,1,1) = {"
a
a
a
a
a
a
a
a
a
a
U
U
U
U
U
U
U
U
U
U
U
U
U
y
y
y
U
U
U
U
U
U
a
a
U
U
a
a
a
a
"}
(16,1,1) = {"
a
a
a
a
a
a
a
a
a
U
U
U
U
y
a
U
U
U
U
U
U
U
U
U
y
y
U
U
U
U
U
U
a
a
a
U
a
a
a
a
"}
(17,1,1) = {"
a
a
a
a
a
a
a
U
U
U
U
U
y
a
a
U
U
U
U
U
U
U
U
U
y
y
y
U
U
U
U
y
a
U
U
U
a
a
a
a
"}
(18,1,1) = {"
a
a
a
a
a
a
a
U
U
U
U
U
y
a
a
a
U
U
U
U
U
U
U
y
y
y
y
U
U
U
U
a
a
U
U
a
a
a
a
a
"}
(19,1,1) = {"
a
a
a
a
a
U
U
U
U
U
U
U
y
a
a
a
U
U
U
U
U
U
U
U
y
y
y
U
U
U
U
U
U
U
U
a
a
a
a
a
"}
(20,1,1) = {"
a
a
a
a
U
U
U
U
U
U
U
U
a
a
a
U
U
U
U
U
U
U
U
U
U
y
y
y
U
U
U
U
U
U
U
a
a
a
a
a
"}
(21,1,1) = {"
a
a
a
a
U
U
U
U
U
U
U
U
U
a
U
U
U
U
U
U
U
U
U
U
y
y
a
y
U
U
U
U
U
U
U
a
a
a
a
a
"}
(22,1,1) = {"
a
a
a
a
U
U
U
U
U
U
U
U
U
U
U
U
U
U
U
U
U
U
U
U
y
a
a
a
U
a
a
a
U
U
a
a
a
a
a
a
"}
(23,1,1) = {"
a
a
a
a
U
U
U
U
U
U
U
U
U
U
U
U
U
U
U
U
U
U
U
U
a
a
a
a
a
a
a
a
a
a
a
a
a
a
a
a
"}
(24,1,1) = {"
a
a
a
a
U
U
U
U
U
U
U
U
U
U
U
U
U
U
U
U
U
U
U
U
y
a
a
a
a
a
a
a
a
a
a
a
a
a
a
a
"}
(25,1,1) = {"
a
a
a
a
U
U
U
U
U
U
U
U
U
U
U
U
U
U
U
a
U
U
U
U
U
U
a
a
a
a
a
a
a
a
a
a
a
a
a
a
"}
(26,1,1) = {"
a
a
a
a
U
U
y
y
U
U
U
U
U
U
U
U
U
a
a
a
a
U
U
U
U
U
a
a
a
a
a
a
a
a
a
a
a
a
a
a
"}
(27,1,1) = {"
a
a
a
a
U
y
a
y
U
U
U
U
U
U
U
U
U
a
a
a
a
U
U
U
U
a
a
a
a
a
a
a
a
a
a
a
a
a
a
a
"}
(28,1,1) = {"
a
a
a
a
U
a
a
y
U
U
U
U
U
U
U
y
y
a
a
a
a
y
U
U
U
a
a
a
a
a
a
a
a
a
a
a
a
a
a
a
"}
(29,1,1) = {"
a
a
a
a
U
U
a
a
a
U
U
U
U
U
y
y
y
y
a
a
y
y
y
U
U
a
a
a
a
a
a
a
a
a
a
a
a
a
a
a
"}
(30,1,1) = {"
a
a
a
a
a
U
U
U
U
U
U
U
U
U
U
y
y
y
y
y
y
U
U
U
U
a
a
a
a
a
a
a
a
a
a
a
a
a
a
a
"}
(31,1,1) = {"
a
a
a
a
a
a
U
U
U
U
U
U
U
U
U
U
y
y
y
y
y
U
U
U
a
a
a
a
a
a
a
a
a
a
a
a
a
a
a
a
"}
(32,1,1) = {"
a
a
a
a
a
a
a
a
a
U
U
U
U
U
U
U
a
a
y
y
U
U
U
a
a
a
a
a
a
a
a
a
K
a
a
a
a
a
a
a
"}
(33,1,1) = {"
a
a
a
a
a
a
a
a
a
a
a
a
a
a
a
a
a
a
a
a
a
a
a
a
a
a
a
a
a
a
a
a
a
a
a
a
a
a
a
a
"}
(34,1,1) = {"
a
a
a
a
a
a
a
a
a
a
a
a
a
a
a
a
a
a
a
a
a
a
a
a
a
a
a
a
a
a
a
a
a
a
a
a
a
a
a
a
"}
(35,1,1) = {"
a
a
a
a
a
a
a
a
a
a
a
a
a
a
a
a
a
a
a
a
a
a
a
a
a
a
a
a
a
a
a
a
a
a
a
a
a
a
a
a
"}
(36,1,1) = {"
a
a
a
a
a
a
a
a
a
a
a
a
a
a
a
a
a
a
a
a
a
a
a
a
a
a
a
a
a
a
a
a
a
a
a
a
a
a
a
a
"}
(37,1,1) = {"
a
a
a
a
a
a
a
a
a
a
a
a
a
a
a
a
a
a
a
a
a
a
a
a
a
a
a
a
a
a
a
a
a
a
a
a
a
a
a
a
"}
(38,1,1) = {"
a
a
a
a
a
a
a
a
a
a
a
a
a
a
a
a
a
a
a
a
a
a
a
a
a
a
a
a
a
a
a
a
a
a
a
a
a
a
a
a
"}
(39,1,1) = {"
a
a
a
a
a
a
a
a
a
a
a
a
a
a
a
a
a
a
a
a
a
a
a
a
a
a
a
a
a
a
a
a
a
a
a
a
a
a
a
a
"}
(40,1,1) = {"
a
a
a
a
a
a
a
a
a
a
a
a
a
a
a
a
a
a
a
a
a
a
a
a
a
a
a
a
a
a
a
a
a
a
a
a
a
a
a
a
"}
