//MAP CONVERTED BY dmm2tgm.py THIS HEADER COMMENT PREVENTS RECONVERSION, DO NOT REMOVE
"a" = (
/turf/template_noop,
/area/template_noop)
"i" = (
/turf/template_gen/open,
/area/template_noop)
"r" = (
/turf/closed/mineral/random/low_chance,
/area/template_noop)
"I" = (
/turf/template_gen/closed,
/area/template_noop)
"K" = (
/turf/closed/mineral/random/high_chance,
/area/template_noop)
"W" = (
/obj/effect/landmark/dropship_entry,
/turf/template_noop,
/area/template_noop)

(1,1,1) = {"
a
a
a
a
a
a
a
a
a
a
a
a
a
a
a
a
a
a
a
a
a
a
a
a
a
a
a
a
a
a
a
a
a
a
a
a
a
a
a
a
"}
(2,1,1) = {"
a
a
a
a
a
a
a
a
a
a
a
a
a
a
a
a
a
a
a
a
a
a
a
a
a
a
a
a
a
a
a
a
a
a
a
a
a
a
a
a
"}
(3,1,1) = {"
a
a
a
a
a
a
a
a
a
a
a
a
a
a
a
a
a
a
a
a
a
a
a
a
a
a
a
a
a
a
a
a
a
a
a
a
a
a
a
a
"}
(4,1,1) = {"
a
a
a
a
a
a
a
a
a
a
a
a
a
a
a
a
a
a
a
a
a
a
a
a
a
a
a
a
a
a
a
a
a
a
a
a
a
a
a
a
"}
(5,1,1) = {"
a
a
a
a
a
a
a
a
a
a
a
a
a
a
a
a
a
a
a
a
a
a
a
a
a
I
I
a
a
a
a
a
a
a
a
a
a
a
a
a
"}
(6,1,1) = {"
a
a
a
a
a
a
a
a
a
a
a
a
a
a
a
r
r
r
I
a
a
a
a
a
a
a
I
I
a
a
a
a
a
a
a
a
a
a
a
a
"}
(7,1,1) = {"
a
a
a
a
a
a
a
a
a
a
a
a
a
r
r
r
I
I
I
I
I
a
a
a
a
a
a
a
a
a
a
a
a
a
a
a
a
a
a
a
"}
(8,1,1) = {"
a
a
a
a
a
a
a
a
a
a
a
a
r
r
I
I
I
I
I
I
I
a
a
a
a
a
a
a
a
a
a
a
a
a
a
a
a
a
a
a
"}
(9,1,1) = {"
a
a
a
a
a
a
a
a
a
a
a
r
I
I
I
I
I
i
i
a
a
a
a
a
a
a
a
a
a
a
a
a
a
a
a
a
a
a
a
a
"}
(10,1,1) = {"
a
a
a
a
a
a
a
a
a
a
a
a
a
a
i
i
i
i
a
a
a
a
a
a
a
a
a
r
r
I
I
a
a
a
a
a
a
a
a
a
"}
(11,1,1) = {"
a
a
a
a
a
a
a
a
a
a
a
a
a
a
a
i
a
a
a
a
a
a
a
r
r
r
r
r
I
I
I
a
a
a
a
a
a
a
a
a
"}
(12,1,1) = {"
a
a
a
a
a
a
a
a
a
a
a
a
a
a
a
a
a
a
a
r
r
r
r
r
r
I
I
I
I
I
a
a
a
a
a
I
I
a
a
a
"}
(13,1,1) = {"
a
a
a
a
a
a
a
a
a
a
a
a
a
a
a
a
a
r
r
r
r
r
I
I
I
I
I
I
I
a
a
a
a
a
a
I
I
a
a
a
"}
(14,1,1) = {"
a
a
a
a
a
a
a
a
a
a
a
a
a
a
a
a
a
r
r
r
I
I
I
I
I
i
i
a
a
a
a
a
a
r
I
I
I
a
a
a
"}
(15,1,1) = {"
a
a
a
a
a
a
a
a
I
I
a
a
a
a
a
a
a
r
I
I
I
I
I
i
i
i
a
a
a
a
a
a
r
I
I
I
a
a
a
a
"}
(16,1,1) = {"
a
a
a
a
a
a
a
a
a
I
I
a
a
a
a
a
a
I
I
I
I
I
i
i
a
a
a
a
a
a
a
r
I
I
I
I
a
a
a
a
"}
(17,1,1) = {"
a
a
a
a
a
a
a
a
I
I
i
a
a
a
a
a
a
a
a
a
a
a
a
i
a
a
a
a
a
a
r
r
I
I
I
I
a
a
a
a
"}
(18,1,1) = {"
a
a
a
a
a
a
a
a
I
i
a
a
a
a
a
a
a
a
a
a
a
a
a
a
a
a
a
a
a
r
r
I
I
I
I
a
a
a
a
a
"}
(19,1,1) = {"
a
a
a
a
a
a
a
a
a
a
a
a
a
a
a
a
a
a
a
a
a
a
a
a
a
a
a
a
r
r
I
I
I
I
i
a
a
a
a
a
"}
(20,1,1) = {"
a
a
a
a
a
a
a
a
a
a
a
a
I
I
I
I
a
a
a
a
a
a
a
a
a
a
a
a
r
r
r
I
I
i
a
a
a
a
a
a
"}
(21,1,1) = {"
a
a
a
a
a
a
a
a
a
a
a
I
I
I
I
I
I
I
I
I
i
i
a
a
a
a
a
a
a
r
I
I
I
i
a
a
a
a
a
a
"}
(22,1,1) = {"
a
a
a
a
a
a
a
a
a
a
I
I
I
I
I
I
I
I
I
I
I
i
i
i
a
a
a
a
a
r
I
I
i
i
a
a
a
a
a
a
"}
(23,1,1) = {"
a
a
a
a
a
a
a
a
a
r
I
I
I
I
I
I
I
I
I
I
I
I
I
I
I
a
a
a
a
r
I
I
i
a
a
a
a
a
a
a
"}
(24,1,1) = {"
a
a
a
a
a
a
a
a
r
r
I
I
I
I
I
I
I
I
I
I
I
I
I
I
I
I
a
a
a
a
I
i
i
a
a
a
a
a
a
a
"}
(25,1,1) = {"
a
a
a
a
a
a
a
a
r
I
I
I
I
I
I
I
I
I
I
I
I
I
I
I
I
I
a
a
a
a
I
i
i
a
a
a
a
a
a
a
"}
(26,1,1) = {"
a
a
a
a
a
a
a
r
r
I
I
I
I
I
i
i
I
I
I
I
I
I
I
I
I
I
a
a
a
a
i
i
a
a
a
a
a
a
a
a
"}
(27,1,1) = {"
a
a
a
a
a
a
a
r
r
I
I
I
I
i
i
i
i
i
I
I
I
I
I
I
I
I
i
a
a
a
a
a
a
a
a
a
a
a
a
a
"}
(28,1,1) = {"
a
a
a
a
a
a
a
r
r
I
I
I
I
i
i
i
i
i
I
I
I
I
I
I
I
I
i
a
a
a
a
a
a
a
a
W
a
a
a
a
"}
(29,1,1) = {"
a
a
a
a
a
a
a
r
r
I
I
I
i
i
K
K
i
i
i
I
I
I
I
I
I
I
i
i
a
a
a
a
a
a
a
a
a
a
a
a
"}
(30,1,1) = {"
a
a
a
a
a
a
a
a
r
I
I
I
i
i
K
K
K
i
i
I
I
I
I
I
I
I
I
i
a
a
a
a
a
a
a
a
a
a
a
a
"}
(31,1,1) = {"
a
a
a
a
a
a
a
a
r
r
I
I
i
i
i
K
K
i
i
i
i
I
I
I
I
I
I
I
I
a
a
a
I
a
a
a
a
a
a
a
"}
(32,1,1) = {"
a
a
a
a
a
a
a
a
r
r
I
I
I
i
i
i
i
i
i
I
I
I
I
I
I
I
I
I
I
a
a
a
I
I
a
a
a
a
a
a
"}
(33,1,1) = {"
a
a
a
a
a
a
a
a
a
r
r
I
I
i
i
i
i
i
I
I
I
I
I
I
I
I
I
I
a
a
a
a
a
a
a
a
a
a
a
a
"}
(34,1,1) = {"
a
a
a
a
a
a
a
a
a
r
r
r
I
I
I
i
I
I
I
I
I
I
I
I
I
I
I
a
a
a
a
a
a
a
a
a
a
a
a
a
"}
(35,1,1) = {"
a
a
a
a
a
a
a
a
a
a
r
r
r
I
I
I
I
I
I
I
I
I
I
I
I
I
a
a
a
a
a
a
a
a
a
a
a
a
a
a
"}
(36,1,1) = {"
a
a
a
a
a
a
a
a
a
a
a
r
r
r
r
I
I
I
I
I
r
r
r
a
a
a
a
a
a
a
a
a
a
a
a
a
a
a
a
a
"}
(37,1,1) = {"
a
a
a
a
a
a
a
a
a
a
a
a
r
r
r
r
I
r
r
r
r
a
a
a
a
a
a
a
a
a
a
a
a
a
a
a
a
a
a
a
"}
(38,1,1) = {"
a
a
a
a
a
a
a
a
a
a
a
a
a
a
r
r
r
r
r
a
a
a
a
a
a
a
a
a
a
a
a
a
a
a
a
a
a
a
a
a
"}
(39,1,1) = {"
a
a
a
a
a
a
a
a
a
a
a
a
a
a
a
a
a
a
a
a
a
a
a
a
a
a
a
a
a
a
a
a
a
a
a
a
a
a
a
a
"}
(40,1,1) = {"
a
a
a
a
a
a
a
a
a
a
a
a
a
a
a
a
a
a
a
a
a
a
a
a
a
a
a
a
a
a
a
a
a
a
a
a
a
a
a
a
"}
