//MAP CONVERTED BY dmm2tgm.py THIS HEADER COMMENT PREVENTS RECONVERSION, DO NOT REMOVE
"a" = (
/turf/template_noop,
/area/template_noop)
"h" = (
/obj/effect/landmark/dropship_entry,
/turf/template_noop,
/area/template_noop)
"i" = (
/turf/closed/mineral/random/low_chance,
/area/template_noop)
"q" = (
/turf/closed/mineral/random/high_chance,
/area/template_noop)
"t" = (
/turf/closed/mineral,
/area/template_noop)
"Q" = (
/turf/open/floor/plating/asteroid/airless,
/area/template_noop)

(1,1,1) = {"
a
a
a
a
a
a
a
a
a
a
a
a
a
a
a
a
a
a
a
a
a
a
a
a
a
a
a
a
a
a
a
a
a
a
a
a
a
a
a
a
"}
(2,1,1) = {"
a
a
a
a
a
a
a
a
a
a
a
a
a
a
a
a
a
a
a
a
a
a
a
a
a
a
a
a
a
a
a
a
a
a
a
a
a
a
a
a
"}
(3,1,1) = {"
a
a
a
a
a
a
a
a
a
a
a
a
a
a
a
a
a
a
i
i
a
a
a
a
a
a
a
a
a
a
a
a
a
a
a
a
a
a
a
a
"}
(4,1,1) = {"
a
a
a
a
a
a
a
a
a
a
a
a
a
a
a
a
t
i
i
t
i
t
a
a
a
a
a
a
a
a
a
a
a
a
a
a
a
a
a
a
"}
(5,1,1) = {"
a
a
a
a
a
a
a
a
a
a
a
a
a
a
t
i
i
t
t
t
i
t
i
a
a
a
a
a
a
a
a
a
a
a
a
a
a
a
a
a
"}
(6,1,1) = {"
a
a
a
a
a
a
a
a
a
a
a
a
i
i
i
t
t
i
i
t
t
i
t
a
Q
Q
a
a
a
a
a
a
a
a
a
a
a
a
a
a
"}
(7,1,1) = {"
a
a
a
a
a
a
a
a
a
a
a
Q
t
t
t
i
t
i
t
t
t
t
Q
Q
Q
t
t
a
a
a
a
a
a
a
a
a
a
a
a
a
"}
(8,1,1) = {"
a
a
a
a
a
a
a
a
a
a
Q
Q
Q
Q
t
t
i
i
i
i
i
Q
Q
Q
t
i
t
a
a
a
a
a
a
a
a
a
a
a
a
a
"}
(9,1,1) = {"
a
a
a
a
a
a
a
a
a
Q
i
Q
Q
Q
Q
t
i
i
Q
Q
Q
Q
a
t
i
t
a
a
a
a
a
a
a
a
a
a
a
a
a
a
"}
(10,1,1) = {"
a
a
a
a
a
a
a
a
a
i
i
t
Q
Q
Q
i
i
i
i
i
i
i
t
i
t
t
Q
Q
a
a
a
a
a
a
a
a
a
a
a
a
"}
(11,1,1) = {"
a
a
a
a
a
a
a
i
i
i
t
Q
Q
i
i
t
t
t
t
t
t
t
t
t
i
i
i
Q
Q
a
a
a
a
a
a
a
a
a
a
a
"}
(12,1,1) = {"
a
a
a
a
a
a
a
i
i
i
t
t
i
i
t
t
t
t
t
t
t
t
t
i
i
i
i
Q
Q
a
a
a
a
a
a
a
a
a
a
a
"}
(13,1,1) = {"
a
a
a
a
a
a
a
i
t
i
i
i
i
t
t
t
t
t
t
t
t
t
t
t
t
i
Q
Q
Q
Q
a
a
a
a
a
a
a
a
a
a
"}
(14,1,1) = {"
a
a
a
a
a
a
a
i
Q
t
i
i
t
t
t
t
q
q
q
q
q
t
t
t
t
i
i
i
Q
Q
Q
a
a
a
a
a
a
a
a
a
"}
(15,1,1) = {"
a
a
a
a
a
a
a
t
Q
Q
i
t
t
t
t
q
q
Q
Q
Q
q
q
t
t
t
i
t
i
i
t
Q
a
a
a
a
a
a
a
a
a
"}
(16,1,1) = {"
a
a
a
a
a
a
t
t
t
Q
Q
t
t
t
q
q
Q
Q
Q
Q
Q
q
t
t
t
t
t
i
i
i
Q
Q
a
a
a
a
a
a
a
a
"}
(17,1,1) = {"
a
a
a
a
a
a
t
t
i
a
Q
t
t
t
q
Q
Q
Q
Q
Q
Q
q
t
t
i
i
t
t
t
i
i
a
a
a
a
a
a
a
a
a
"}
(18,1,1) = {"
a
a
a
a
a
t
i
t
i
a
Q
t
t
t
q
Q
Q
Q
Q
Q
Q
q
t
t
t
Q
Q
i
t
t
i
a
a
a
a
a
a
a
a
a
"}
(19,1,1) = {"
a
a
a
a
i
i
i
t
i
i
Q
t
t
t
q
q
Q
Q
Q
Q
q
q
t
t
t
a
Q
Q
t
t
i
a
a
a
a
a
a
a
a
a
"}
(20,1,1) = {"
a
a
a
a
t
t
t
t
t
i
Q
Q
t
t
t
q
Q
Q
q
q
q
t
t
t
t
a
a
t
t
i
i
i
a
a
a
a
a
a
a
a
"}
(21,1,1) = {"
a
a
a
a
t
i
t
i
t
t
t
Q
t
t
t
q
q
q
q
t
t
t
t
t
i
a
a
a
i
i
i
a
a
a
a
a
a
a
a
a
"}
(22,1,1) = {"
a
a
a
a
a
i
t
i
t
i
t
Q
Q
t
t
t
t
t
t
t
t
t
t
Q
a
a
t
i
i
a
a
a
a
a
a
a
a
a
a
a
"}
(23,1,1) = {"
a
a
a
a
a
i
t
i
i
t
t
t
Q
Q
t
t
t
t
t
t
t
i
Q
Q
a
a
a
a
i
a
a
a
a
a
a
a
a
a
a
a
"}
(24,1,1) = {"
a
a
a
a
a
a
i
i
t
t
i
t
t
i
Q
a
a
a
a
t
Q
Q
Q
a
a
a
a
a
a
a
a
a
a
a
h
a
a
a
a
a
"}
(25,1,1) = {"
a
a
a
a
a
a
t
t
i
i
t
t
t
t
a
a
a
a
a
Q
a
a
a
a
a
a
a
a
a
a
a
a
a
a
a
a
a
a
a
a
"}
(26,1,1) = {"
a
a
a
a
a
a
i
t
i
i
i
i
i
t
a
a
a
a
a
a
a
a
a
a
a
a
a
a
a
a
a
a
a
a
a
a
a
a
a
a
"}
(27,1,1) = {"
a
a
a
a
a
a
a
a
t
i
a
a
a
t
a
a
a
a
a
a
a
a
a
t
a
a
a
a
a
a
t
a
a
a
a
a
a
a
a
a
"}
(28,1,1) = {"
a
a
a
a
a
a
a
a
a
a
a
a
a
a
a
a
t
a
a
a
a
a
a
a
a
a
a
a
Q
i
t
a
a
a
a
a
a
a
a
a
"}
(29,1,1) = {"
a
a
a
a
a
a
a
a
a
a
a
a
a
a
a
a
a
a
a
a
a
a
a
a
a
a
a
i
i
t
i
a
a
a
a
a
a
a
a
a
"}
(30,1,1) = {"
a
a
a
a
a
a
a
a
a
a
a
a
a
a
a
a
a
a
a
a
a
a
a
a
a
a
t
t
t
i
a
a
a
a
a
a
a
a
a
a
"}
(31,1,1) = {"
a
a
a
a
a
a
a
a
a
a
a
a
a
t
a
a
a
i
a
a
a
a
a
a
a
a
t
i
i
t
a
a
a
a
a
a
a
a
a
a
"}
(32,1,1) = {"
a
a
a
a
a
a
a
a
a
t
t
a
a
a
a
a
a
a
a
a
a
i
t
a
a
a
a
i
i
t
a
a
a
a
a
a
a
a
a
a
"}
(33,1,1) = {"
a
a
a
a
a
i
a
a
a
a
i
a
a
a
a
a
t
i
i
i
i
i
t
i
a
a
a
t
t
a
a
a
a
a
a
a
a
a
a
a
"}
(34,1,1) = {"
a
a
a
a
a
i
a
a
a
a
a
a
a
a
i
i
i
t
t
t
t
t
t
i
a
a
a
a
i
a
a
a
a
a
a
a
a
a
a
a
"}
(35,1,1) = {"
a
a
a
a
a
a
a
a
a
a
a
a
a
a
Q
Q
Q
i
t
i
i
i
i
t
t
a
a
a
a
a
a
a
a
a
a
a
a
a
a
a
"}
(36,1,1) = {"
a
a
a
a
a
a
a
i
a
a
a
a
a
a
a
a
Q
Q
t
i
i
a
t
t
t
a
a
a
a
a
a
a
a
a
a
a
a
a
a
a
"}
(37,1,1) = {"
a
a
a
a
a
a
t
a
a
a
a
a
a
a
a
a
a
Q
Q
t
i
a
a
a
a
a
a
a
a
a
a
a
a
a
a
a
a
a
a
a
"}
(38,1,1) = {"
a
a
a
a
a
a
a
a
a
a
a
a
a
a
a
a
a
a
a
a
a
a
a
a
a
a
a
a
a
a
a
a
a
a
a
a
a
a
a
a
"}
(39,1,1) = {"
a
a
a
a
a
a
a
a
a
a
a
a
a
a
a
a
a
a
a
a
a
a
a
a
a
a
a
a
a
a
a
a
a
a
a
a
a
a
a
a
"}
(40,1,1) = {"
a
a
a
a
a
a
a
a
a
a
a
a
a
a
a
a
a
a
a
a
a
a
a
a
a
a
a
a
a
a
a
a
a
a
a
a
a
a
a
a
"}
