//MAP CONVERTED BY dmm2tgm.py THIS HEADER COMMENT PREVENTS RECONVERSION, DO NOT REMOVE
"b" = (
/turf/template_noop,
/area/template_noop)
"c" = (
/turf/template_gen/closed,
/area/template_noop)
"d" = (
/turf/template_gen/open,
/area/template_noop)

(1,1,1) = {"
b
b
b
b
b
b
b
b
b
b
b
b
b
b
b
b
b
b
b
b
b
b
b
b
b
b
b
b
b
b
b
b
b
b
b
b
b
b
b
b
"}
(2,1,1) = {"
b
b
b
b
b
b
b
b
b
b
b
b
b
b
b
b
b
b
b
b
b
b
b
b
b
b
b
b
b
b
b
b
c
c
c
c
b
b
b
b
"}
(3,1,1) = {"
b
b
b
b
b
b
b
b
b
b
b
b
b
b
b
b
b
b
b
b
b
b
b
b
b
b
b
b
b
b
b
b
c
c
c
c
c
c
b
b
"}
(4,1,1) = {"
b
b
b
b
b
b
b
c
c
c
c
b
b
b
b
b
b
b
b
b
b
b
b
b
b
b
b
b
b
b
d
d
d
c
c
c
c
c
c
c
"}
(5,1,1) = {"
b
b
b
b
b
b
c
c
c
c
c
c
b
b
b
b
b
b
b
b
b
b
b
b
b
b
b
b
d
d
d
d
d
c
c
c
c
c
c
c
"}
(6,1,1) = {"
b
b
b
b
b
c
c
c
c
c
c
c
c
c
c
b
b
b
b
b
b
b
b
b
b
b
b
b
d
d
d
d
d
c
c
c
c
c
c
c
"}
(7,1,1) = {"
b
b
b
b
b
c
c
c
c
c
c
c
c
c
c
c
c
c
b
b
b
b
b
b
b
b
c
c
d
d
d
d
c
c
c
c
c
c
c
c
"}
(8,1,1) = {"
b
b
b
b
b
c
c
c
c
c
c
c
c
c
c
c
c
c
b
b
b
b
b
b
b
c
d
d
d
d
c
c
c
c
c
c
c
c
c
c
"}
(9,1,1) = {"
b
b
b
b
c
c
c
c
c
c
c
d
d
d
d
c
c
c
b
b
b
b
b
b
b
d
d
d
c
c
c
c
c
c
c
c
c
c
c
b
"}
(10,1,1) = {"
b
b
b
b
c
c
c
c
c
d
d
d
d
d
d
d
d
c
b
b
b
b
b
b
c
d
d
c
c
c
c
c
c
c
c
c
c
c
c
b
"}
(11,1,1) = {"
b
b
b
c
c
c
c
c
c
d
d
d
b
b
d
d
d
c
b
b
b
b
b
b
d
d
d
c
c
c
c
c
c
c
c
c
c
c
c
b
"}
(12,1,1) = {"
b
b
b
c
c
c
c
c
d
d
b
b
b
b
d
d
d
c
b
b
b
b
b
b
d
d
c
c
c
c
c
c
d
d
d
c
c
c
b
b
"}
(13,1,1) = {"
b
b
b
c
c
c
c
d
d
b
b
b
b
b
b
b
c
b
c
c
c
b
b
b
d
d
c
c
c
d
d
d
d
d
d
c
c
c
c
b
"}
(14,1,1) = {"
b
b
b
c
c
c
c
d
d
b
b
b
b
b
c
b
c
c
c
c
c
b
c
c
d
d
c
c
c
d
d
c
d
d
d
c
c
c
c
b
"}
(15,1,1) = {"
b
b
b
c
c
c
c
d
b
b
b
b
b
b
b
c
c
c
c
c
c
c
b
d
d
c
c
c
c
d
d
c
d
d
d
c
c
c
c
b
"}
(16,1,1) = {"
b
b
c
c
c
d
d
d
b
b
b
b
b
c
c
c
c
c
c
c
c
c
c
d
d
c
c
c
c
c
c
c
d
d
d
c
c
c
c
b
"}
(17,1,1) = {"
b
b
c
c
c
d
d
d
b
b
b
b
b
b
c
c
c
c
c
c
c
c
b
d
d
c
c
c
c
c
d
d
d
d
d
c
c
c
c
c
"}
(18,1,1) = {"
b
b
c
c
c
d
d
d
b
b
b
b
c
c
c
c
c
c
c
c
c
c
c
d
d
c
c
c
c
c
d
d
d
d
c
c
c
c
c
c
"}
(19,1,1) = {"
b
b
c
c
d
d
d
b
b
c
c
b
c
c
c
c
c
c
c
c
c
c
c
d
d
c
c
c
c
d
d
d
c
c
c
c
c
c
c
c
"}
(20,1,1) = {"
b
b
c
c
d
d
d
b
b
c
c
c
c
c
c
c
c
c
c
c
c
c
c
c
d
c
c
c
c
d
d
d
c
c
c
c
c
c
c
c
"}
(21,1,1) = {"
b
b
c
c
d
d
d
b
b
c
c
c
c
c
c
c
c
c
c
c
c
c
b
c
d
d
d
c
c
d
d
d
d
c
c
c
c
c
c
c
"}
(22,1,1) = {"
b
b
c
c
c
d
d
b
b
b
b
b
b
c
c
c
c
c
c
c
c
c
b
c
d
d
d
c
c
c
c
d
d
c
c
c
c
c
c
c
"}
(23,1,1) = {"
b
b
c
c
c
d
d
b
b
b
b
b
b
b
c
c
c
c
c
c
c
c
b
b
d
d
d
c
c
c
c
d
d
c
c
c
c
c
c
c
"}
(24,1,1) = {"
b
b
b
c
c
d
d
d
b
b
b
b
b
b
b
b
c
c
c
c
c
c
b
b
b
b
d
d
d
d
d
d
d
c
c
c
c
c
c
b
"}
(25,1,1) = {"
b
b
b
c
c
c
d
d
d
d
b
b
b
b
b
b
b
b
b
b
b
b
b
b
b
b
c
c
d
d
d
d
d
c
c
c
c
c
c
b
"}
(26,1,1) = {"
b
b
b
c
c
c
c
d
d
d
b
b
b
b
b
b
b
b
b
b
b
b
b
b
b
b
b
b
d
d
d
d
d
c
c
c
b
b
b
b
"}
(27,1,1) = {"
b
b
b
c
c
c
c
d
d
d
b
b
b
b
b
b
b
b
b
b
b
b
b
b
b
b
b
b
b
b
b
b
b
b
b
b
b
b
b
b
"}
(28,1,1) = {"
b
b
b
c
c
c
c
c
c
c
d
d
d
c
c
b
b
b
b
b
b
b
b
c
b
b
b
b
b
b
b
b
b
b
b
b
b
b
b
b
"}
(29,1,1) = {"
b
b
b
b
c
c
c
c
c
c
c
c
c
c
c
b
b
b
b
d
d
d
c
c
c
b
b
b
b
b
b
b
b
b
b
b
b
b
b
b
"}
(30,1,1) = {"
b
b
b
b
b
b
b
b
c
c
c
c
c
b
b
b
b
b
b
d
d
d
c
c
c
b
b
b
b
b
b
b
b
b
b
b
b
b
b
b
"}
(31,1,1) = {"
b
b
b
b
b
b
b
b
b
b
b
b
b
b
b
b
b
b
d
d
d
d
c
c
c
c
c
c
b
b
b
b
b
b
b
b
b
b
b
b
"}
(32,1,1) = {"
b
b
b
b
b
b
b
b
b
b
b
b
b
b
b
b
b
d
d
d
d
d
c
c
c
c
c
c
c
b
b
b
b
b
b
b
b
b
b
b
"}
(33,1,1) = {"
b
b
b
b
b
b
b
b
b
b
b
b
b
b
b
b
b
d
d
d
c
c
c
c
c
c
c
c
c
b
b
b
b
b
b
b
d
d
b
b
"}
(34,1,1) = {"
b
b
b
b
b
b
b
b
b
b
b
b
b
b
b
b
d
d
d
d
d
d
d
c
c
c
c
c
c
c
b
b
b
b
b
d
d
c
c
b
"}
(35,1,1) = {"
b
b
b
b
b
b
b
b
b
b
b
b
b
b
b
b
d
d
d
d
d
d
d
d
d
d
c
c
c
c
b
b
b
b
b
d
c
c
c
b
"}
(36,1,1) = {"
b
b
b
b
b
b
b
b
b
b
b
b
b
c
c
c
d
d
d
c
c
c
d
d
d
d
c
c
c
c
b
b
b
b
d
c
c
c
c
b
"}
(37,1,1) = {"
b
b
b
b
b
b
b
b
b
b
b
b
c
c
c
c
c
c
c
c
c
c
c
d
d
c
c
c
b
b
b
b
b
b
d
c
c
c
b
b
"}
(38,1,1) = {"
b
b
b
b
b
b
b
b
b
b
b
c
c
c
c
c
c
c
c
c
c
c
c
c
c
c
c
c
b
b
b
b
b
b
b
b
b
b
b
b
"}
(39,1,1) = {"
b
b
b
b
b
b
b
b
b
b
b
b
b
c
c
c
c
b
b
b
c
c
c
c
c
b
b
b
b
b
b
b
b
b
b
b
b
b
b
b
"}
(40,1,1) = {"
b
b
b
b
b
b
b
b
b
b
b
b
b
b
b
b
b
b
b
b
b
b
b
b
b
b
b
b
b
b
b
b
b
b
b
b
b
b
b
b
"}
