//MAP CONVERTED BY dmm2tgm.py THIS HEADER COMMENT PREVENTS RECONVERSION, DO NOT REMOVE
"b" = (
/turf/template_noop,
/area/template_noop)
"d" = (
/turf/template_gen/open,
/area/template_noop)
"M" = (
/turf/template_gen/closed,
/area/template_noop)

(1,1,1) = {"
b
b
b
b
b
b
b
b
b
b
b
b
b
b
b
b
b
b
b
b
b
b
b
b
b
b
b
b
b
b
b
b
b
b
b
b
b
b
b
b
"}
(2,1,1) = {"
b
b
b
b
b
b
b
b
b
b
b
b
b
b
b
b
b
b
b
b
b
b
b
b
b
b
b
b
b
b
b
b
b
b
b
b
b
b
b
b
"}
(3,1,1) = {"
b
b
b
b
b
b
b
b
b
b
M
M
b
b
b
b
b
b
b
b
b
b
b
b
b
b
b
b
b
b
b
b
b
b
b
b
b
b
b
b
"}
(4,1,1) = {"
b
b
b
b
b
b
b
b
b
d
d
b
b
b
b
b
b
b
b
b
b
b
b
b
b
b
b
b
b
b
b
b
b
b
b
b
b
b
b
b
"}
(5,1,1) = {"
b
b
b
b
b
b
b
b
d
d
M
M
M
b
b
b
b
b
b
b
b
b
b
b
b
b
b
b
b
b
b
b
b
b
b
b
b
b
b
b
"}
(6,1,1) = {"
b
b
b
b
b
b
b
b
d
d
M
M
M
M
b
b
b
b
b
b
b
b
b
b
b
b
b
b
b
b
b
b
b
b
b
b
b
b
b
b
"}
(7,1,1) = {"
b
b
b
b
b
b
b
b
d
M
M
M
M
M
b
b
b
b
b
b
b
b
b
b
b
b
b
b
b
b
b
b
b
b
b
b
b
b
b
b
"}
(8,1,1) = {"
b
b
b
b
b
b
b
d
M
M
M
M
M
b
b
b
b
d
d
d
b
b
b
b
b
b
b
b
b
b
d
d
b
b
b
b
b
b
b
b
"}
(9,1,1) = {"
b
b
b
b
b
b
b
d
M
M
M
M
M
d
d
d
d
d
d
d
d
d
b
b
b
b
b
b
d
d
M
M
d
b
b
b
b
b
b
b
"}
(10,1,1) = {"
b
b
b
b
b
b
b
d
M
M
M
M
d
d
d
d
M
M
M
M
d
d
d
d
b
b
b
b
M
M
M
d
b
b
b
b
b
b
b
b
"}
(11,1,1) = {"
b
b
b
b
b
b
b
d
M
M
M
M
d
M
M
M
M
M
M
M
M
d
d
d
d
d
d
M
M
M
d
d
b
b
b
b
b
b
b
b
"}
(12,1,1) = {"
b
b
b
b
b
b
b
d
M
M
d
d
M
M
M
M
M
M
M
M
M
M
M
M
M
M
M
M
M
M
d
d
b
b
b
b
b
b
b
b
"}
(13,1,1) = {"
b
b
b
b
b
b
b
d
M
M
d
d
M
M
M
M
M
M
M
M
M
M
M
M
M
M
M
M
M
M
d
d
b
b
b
b
b
b
b
b
"}
(14,1,1) = {"
b
b
b
b
b
b
b
d
d
d
d
M
M
M
M
M
M
M
M
M
M
M
M
M
M
M
M
M
M
d
d
b
b
b
b
b
b
b
b
b
"}
(15,1,1) = {"
b
b
b
b
b
b
d
d
d
d
M
M
M
M
M
M
M
M
M
M
M
M
M
M
M
M
M
M
M
M
b
b
b
b
b
b
b
b
b
b
"}
(16,1,1) = {"
b
b
b
b
b
b
d
d
d
d
d
M
M
M
M
M
M
M
M
M
M
M
M
M
M
M
M
M
M
d
d
b
b
b
b
b
b
b
b
b
"}
(17,1,1) = {"
b
b
b
b
b
b
d
d
d
M
M
d
d
d
d
d
M
M
M
M
M
M
M
M
M
M
M
M
M
d
d
b
b
b
b
b
b
b
b
b
"}
(18,1,1) = {"
b
b
b
b
b
b
d
d
d
M
M
M
M
M
d
d
d
d
M
M
M
M
M
M
M
M
M
M
M
d
d
b
b
b
b
b
b
b
b
b
"}
(19,1,1) = {"
b
b
b
b
b
b
d
d
d
M
d
d
d
d
d
d
d
d
d
d
d
M
d
M
M
M
M
M
M
d
d
b
b
b
b
b
b
b
b
b
"}
(20,1,1) = {"
b
b
b
b
b
b
b
d
d
M
M
d
M
M
M
d
d
M
d
d
d
d
d
d
d
M
M
M
M
M
d
d
b
b
b
b
b
b
b
b
"}
(21,1,1) = {"
b
b
b
b
b
b
b
d
d
M
M
d
d
M
M
M
M
M
M
M
M
d
d
d
d
d
d
d
M
M
d
d
b
b
b
b
b
b
b
b
"}
(22,1,1) = {"
b
b
b
b
b
b
b
d
d
M
M
M
d
M
M
M
M
M
M
M
M
M
d
d
d
M
M
d
M
d
d
d
b
b
b
b
b
b
b
b
"}
(23,1,1) = {"
b
b
b
b
b
b
b
b
d
M
M
M
d
M
M
M
M
M
M
M
M
M
M
M
d
M
M
d
d
d
d
M
b
b
b
b
b
b
b
b
"}
(24,1,1) = {"
b
b
b
b
b
b
b
M
d
d
M
M
M
M
M
M
M
M
M
M
M
M
M
M
M
M
M
M
d
d
d
M
M
M
b
b
b
b
b
b
"}
(25,1,1) = {"
b
b
b
b
b
b
d
M
M
d
d
M
M
M
M
M
M
M
M
M
M
M
M
M
M
M
M
M
d
d
d
M
M
M
b
b
b
b
b
b
"}
(26,1,1) = {"
b
b
b
b
b
d
d
M
M
d
d
d
M
M
M
M
M
M
M
M
M
M
M
M
M
M
M
M
M
d
d
M
M
b
b
b
b
b
b
b
"}
(27,1,1) = {"
b
b
b
b
b
d
d
M
M
d
d
d
M
M
M
M
M
M
M
M
M
M
M
M
M
M
M
M
M
d
d
M
M
b
b
b
b
b
b
b
"}
(28,1,1) = {"
b
b
b
b
b
d
M
M
M
M
d
d
d
M
M
M
M
M
M
M
M
M
M
M
M
M
M
M
d
d
d
M
b
b
b
b
b
b
b
b
"}
(29,1,1) = {"
b
b
b
b
b
d
M
M
M
M
M
M
M
d
d
M
d
d
M
M
M
M
M
M
M
M
M
M
M
d
d
b
b
b
b
b
b
b
b
b
"}
(30,1,1) = {"
b
b
b
b
b
b
d
M
M
M
M
M
M
M
d
d
d
M
M
M
M
M
M
M
M
M
M
M
d
d
b
b
b
d
b
b
b
b
b
b
"}
(31,1,1) = {"
b
b
b
b
b
b
d
d
M
M
M
M
M
M
M
d
d
d
M
M
M
M
M
M
M
M
M
d
d
d
b
b
d
d
M
M
b
b
b
b
"}
(32,1,1) = {"
b
b
b
b
b
b
b
b
d
d
M
M
M
M
M
d
d
d
d
M
M
M
M
M
M
M
M
d
d
b
b
b
d
M
M
M
d
b
b
b
"}
(33,1,1) = {"
b
b
b
b
b
b
b
b
b
b
d
d
d
M
M
M
M
d
d
d
M
M
M
M
d
d
d
d
b
b
b
b
d
M
M
M
d
b
b
b
"}
(34,1,1) = {"
b
b
b
b
b
b
b
b
b
b
b
d
d
M
M
M
M
M
M
d
d
d
d
d
d
d
b
b
b
b
b
b
d
M
d
d
b
b
b
b
"}
(35,1,1) = {"
b
b
b
b
b
b
b
b
b
b
b
b
b
b
M
M
M
M
M
b
d
d
d
d
b
b
b
b
b
b
b
b
d
d
d
d
b
b
b
b
"}
(36,1,1) = {"
b
b
b
b
b
b
b
b
b
b
b
b
b
b
b
b
b
b
b
b
b
b
b
b
b
b
b
b
b
b
b
b
d
d
d
b
b
b
b
b
"}
(37,1,1) = {"
b
b
b
b
b
b
b
b
b
b
b
b
b
b
b
b
b
b
b
b
b
b
b
b
b
b
b
b
b
b
b
b
b
b
b
b
b
b
b
b
"}
(38,1,1) = {"
b
b
b
b
b
b
b
b
b
b
b
b
b
b
b
b
b
b
b
b
b
b
b
b
b
b
b
b
b
b
b
b
b
b
b
b
b
b
b
b
"}
(39,1,1) = {"
b
b
b
b
b
b
b
b
b
b
b
b
b
b
b
b
b
b
b
b
b
b
b
b
b
b
b
b
b
b
b
b
b
b
b
b
b
b
b
b
"}
(40,1,1) = {"
b
b
b
b
b
b
b
b
b
b
b
b
b
b
b
b
b
b
b
b
b
b
b
b
b
b
b
b
b
b
b
b
b
b
b
b
b
b
b
b
"}
