//MAP CONVERTED BY dmm2tgm.py THIS HEADER COMMENT PREVENTS RECONVERSION, DO NOT REMOVE
"a" = (
/turf/template_noop,
/area/template_noop)
"g" = (
/turf/closed/mineral/random/low_chance,
/area/template_noop)
"p" = (
/turf/open/floor/plating/asteroid/airless,
/area/template_noop)
"G" = (
/turf/closed/mineral/random/high_chance,
/area/template_noop)
"I" = (
/obj/effect/landmark/dropship_entry,
/turf/template_noop,
/area/template_noop)
"X" = (
/turf/closed/mineral,
/area/template_noop)

(1,1,1) = {"
a
a
a
a
a
a
a
a
a
a
a
a
a
a
a
a
a
a
a
a
a
a
a
a
a
a
a
a
a
a
a
a
a
a
a
a
a
a
a
a
"}
(2,1,1) = {"
a
a
a
a
a
a
a
a
a
a
a
a
a
a
a
a
a
a
a
a
a
a
a
a
a
a
a
a
a
a
a
a
a
a
a
a
a
a
a
a
"}
(3,1,1) = {"
a
a
a
a
a
a
a
a
a
a
a
a
a
a
a
a
a
a
a
a
a
a
a
a
a
a
a
a
a
a
a
a
a
a
a
a
a
a
a
a
"}
(4,1,1) = {"
a
a
a
a
a
a
a
a
a
a
a
a
a
a
a
a
a
a
a
a
a
a
a
a
a
a
a
a
a
a
a
a
a
a
a
a
a
a
a
a
"}
(5,1,1) = {"
a
a
a
a
a
a
a
a
a
a
a
a
a
a
a
a
a
a
a
a
a
a
a
a
a
a
a
a
a
a
a
a
a
a
a
a
a
a
a
a
"}
(6,1,1) = {"
a
a
a
a
a
a
a
a
a
a
a
a
a
a
a
a
p
p
p
a
a
a
a
X
X
X
a
a
a
a
a
a
a
a
I
a
a
a
a
a
"}
(7,1,1) = {"
a
a
a
a
a
a
a
a
a
a
a
a
a
a
p
p
p
p
p
p
X
X
X
X
X
X
a
a
a
a
a
a
a
a
a
a
a
a
a
a
"}
(8,1,1) = {"
a
a
a
a
a
a
a
a
a
a
a
a
a
a
p
p
p
p
p
X
X
X
X
X
X
X
X
X
a
a
a
a
a
a
a
a
a
a
a
a
"}
(9,1,1) = {"
a
a
a
a
a
a
a
a
a
a
a
a
a
p
p
p
p
p
X
X
X
X
X
X
X
X
X
X
a
a
a
a
a
a
a
a
a
a
a
a
"}
(10,1,1) = {"
a
a
a
a
a
a
a
a
a
a
a
p
p
p
p
p
X
X
X
X
X
X
X
X
X
X
X
X
X
a
a
a
a
a
a
a
a
a
a
a
"}
(11,1,1) = {"
a
a
a
a
a
a
a
a
a
X
p
p
p
p
X
p
X
X
X
X
X
X
X
X
X
X
X
X
X
X
a
a
a
a
a
a
a
a
a
a
"}
(12,1,1) = {"
a
a
a
a
a
a
a
a
a
X
X
X
X
X
X
X
X
X
X
X
X
X
X
X
X
X
X
X
X
X
X
X
a
a
a
a
a
a
a
a
"}
(13,1,1) = {"
a
a
a
a
a
a
a
a
a
X
X
X
X
X
X
X
X
X
X
X
X
X
X
X
X
X
X
X
X
X
X
X
a
a
a
a
a
a
a
a
"}
(14,1,1) = {"
a
a
a
a
a
a
a
a
a
X
X
X
X
X
X
X
X
X
X
X
X
X
X
X
X
X
X
X
X
X
X
X
a
a
a
a
a
a
a
a
"}
(15,1,1) = {"
a
a
a
a
a
a
a
a
X
X
X
X
X
X
X
X
X
X
X
X
X
X
X
g
g
g
g
X
a
X
X
X
a
a
a
a
a
a
a
a
"}
(16,1,1) = {"
a
a
a
a
a
a
a
a
X
X
X
X
X
X
X
X
X
X
X
X
X
g
g
g
a
a
a
a
a
a
a
a
a
a
a
a
a
a
a
a
"}
(17,1,1) = {"
a
a
a
a
a
a
a
a
g
g
g
X
X
X
X
X
X
X
X
X
g
g
a
a
a
a
a
a
a
a
a
a
a
a
a
a
a
a
a
a
"}
(18,1,1) = {"
a
a
a
a
a
a
a
a
a
a
g
g
X
X
X
X
X
X
g
g
g
g
g
g
a
a
a
a
a
X
X
X
a
a
a
a
a
a
a
a
"}
(19,1,1) = {"
a
a
a
a
a
a
a
a
a
a
g
g
g
g
X
X
X
g
g
g
g
g
g
g
g
g
g
g
X
X
X
X
X
a
a
a
a
a
a
a
"}
(20,1,1) = {"
a
a
a
a
a
a
a
a
a
a
a
a
a
g
g
g
g
g
G
G
g
g
X
X
X
X
X
X
X
X
X
X
X
a
a
a
a
a
a
a
"}
(21,1,1) = {"
a
a
a
a
a
a
a
a
a
a
a
a
a
g
g
g
g
g
G
G
G
g
X
X
X
X
X
X
X
X
X
X
X
a
a
a
a
a
a
a
"}
(22,1,1) = {"
a
a
a
a
a
a
a
a
a
a
a
a
a
g
g
g
g
g
g
G
g
g
X
X
X
X
X
X
X
X
X
X
X
a
a
a
a
a
a
a
"}
(23,1,1) = {"
a
a
a
a
a
a
a
a
p
p
p
g
g
g
X
X
X
g
g
g
g
g
g
X
X
X
X
X
X
X
X
p
p
a
a
a
a
a
a
a
"}
(24,1,1) = {"
a
a
a
a
a
a
a
a
p
X
X
g
X
X
X
X
X
X
g
g
g
g
g
X
X
X
X
X
X
X
p
p
X
a
a
a
a
a
a
a
"}
(25,1,1) = {"
a
a
a
a
a
a
a
p
p
X
X
X
X
X
X
X
X
X
X
g
g
a
g
g
X
X
X
X
X
X
X
X
X
a
a
a
a
a
a
a
"}
(26,1,1) = {"
a
a
a
a
a
a
a
p
X
X
X
X
X
X
X
X
X
X
X
g
g
a
g
g
g
X
X
X
p
X
X
X
X
a
a
a
a
a
a
a
"}
(27,1,1) = {"
a
a
a
a
a
a
a
p
p
X
X
X
X
X
X
X
X
X
X
g
g
a
a
a
g
X
X
X
p
p
X
X
X
a
a
a
a
a
a
a
"}
(28,1,1) = {"
a
a
a
a
a
a
a
p
p
X
X
X
X
X
X
X
X
X
X
X
g
a
a
a
g
X
X
X
p
p
p
p
a
a
a
a
a
a
a
a
"}
(29,1,1) = {"
a
a
a
a
a
a
a
a
p
X
X
X
X
X
X
X
X
X
X
X
g
a
a
a
g
X
X
X
p
p
p
a
a
a
a
a
a
a
a
a
"}
(30,1,1) = {"
a
a
a
a
a
a
a
a
a
X
X
X
X
X
X
X
X
X
X
X
X
a
a
a
X
X
X
X
X
p
p
a
a
a
a
a
a
a
a
a
"}
(31,1,1) = {"
a
a
a
a
a
a
a
a
a
a
X
X
X
X
X
X
X
X
X
p
X
X
a
a
X
X
X
X
X
X
p
a
a
a
a
a
a
a
a
a
"}
(32,1,1) = {"
a
a
a
a
a
a
a
a
a
a
a
a
X
X
X
X
X
X
p
p
X
X
a
X
X
X
X
a
X
p
p
a
a
a
a
a
a
a
a
a
"}
(33,1,1) = {"
a
a
a
a
a
a
a
a
a
a
a
a
X
X
X
X
p
p
p
p
X
X
a
X
X
a
a
a
a
a
a
a
a
a
a
a
a
a
a
a
"}
(34,1,1) = {"
a
a
a
a
a
a
a
a
a
a
a
a
X
X
p
p
p
p
p
X
X
a
a
a
a
a
a
a
a
a
a
a
a
a
a
a
a
a
a
a
"}
(35,1,1) = {"
a
a
a
a
a
a
a
a
a
a
a
a
a
a
a
a
a
a
a
a
a
a
a
a
a
a
a
a
a
a
a
a
a
a
a
a
a
a
a
a
"}
(36,1,1) = {"
a
a
a
a
a
a
a
a
a
a
a
a
a
a
a
a
a
a
a
a
a
a
a
a
a
a
a
a
a
a
a
a
a
a
a
a
a
a
a
a
"}
(37,1,1) = {"
a
a
a
a
a
a
a
a
a
a
a
a
a
a
a
a
a
a
a
a
a
a
a
a
a
a
a
a
a
a
a
a
a
a
a
a
a
a
a
a
"}
(38,1,1) = {"
a
a
a
a
a
a
a
a
a
a
a
a
a
a
a
a
a
a
a
a
a
a
a
a
a
a
a
a
a
a
a
a
a
a
a
a
a
a
a
a
"}
(39,1,1) = {"
a
a
a
a
a
a
a
a
a
a
a
a
a
a
a
a
a
a
a
a
a
a
a
a
a
a
a
a
a
a
a
a
a
a
a
a
a
a
a
a
"}
(40,1,1) = {"
a
a
a
a
a
a
a
a
a
a
a
a
a
a
a
a
a
a
a
a
a
a
a
a
a
a
a
a
a
a
a
a
a
a
a
a
a
a
a
a
"}
