//MAP CONVERTED BY dmm2tgm.py THIS HEADER COMMENT PREVENTS RECONVERSION, DO NOT REMOVE
"a" = (
/turf/template_noop,
/area/template_noop)
"n" = (
/turf/open/floor/plating/ashplanet/rocky,
/area/template_noop)
"q" = (
/turf/closed/mineral/random/high_chance,
/area/template_noop)
"t" = (
/turf/template_gen/closed,
/area/template_noop)
"B" = (
/turf/closed/mineral/ash_rock,
/area/template_noop)
"Q" = (
/turf/template_gen/open,
/area/template_noop)

(1,1,1) = {"
a
a
a
a
a
a
a
a
a
a
a
a
a
a
a
a
a
a
a
a
a
a
a
a
a
a
a
a
a
a
a
a
a
a
a
a
a
a
a
a
"}
(2,1,1) = {"
a
a
a
a
a
a
a
a
a
a
a
a
a
a
a
a
a
a
a
a
a
a
a
a
a
a
a
a
a
a
a
a
a
a
a
a
a
a
a
a
"}
(3,1,1) = {"
a
a
a
a
a
a
a
a
a
a
a
a
a
a
a
a
a
a
t
t
a
a
a
a
a
a
a
a
a
a
a
a
a
a
a
a
a
a
a
a
"}
(4,1,1) = {"
a
a
a
a
a
a
a
a
a
a
a
a
a
a
a
a
t
t
t
t
t
t
a
a
a
a
a
a
a
a
a
a
a
a
a
a
a
a
a
a
"}
(5,1,1) = {"
a
a
a
a
a
a
a
a
a
a
a
a
a
a
t
t
t
t
t
t
t
t
t
a
a
a
a
a
a
a
a
a
a
a
a
a
a
a
a
a
"}
(6,1,1) = {"
a
a
a
a
a
a
a
a
a
a
a
a
t
t
t
t
t
t
t
t
t
t
t
a
Q
Q
a
a
a
a
a
a
a
a
a
a
a
a
a
a
"}
(7,1,1) = {"
a
a
a
a
a
a
a
a
a
a
a
Q
t
t
t
t
t
t
t
t
t
t
Q
Q
Q
t
t
a
a
a
a
a
a
a
a
a
a
a
a
a
"}
(8,1,1) = {"
a
a
a
a
a
a
a
a
a
a
Q
Q
Q
Q
t
t
t
t
t
t
t
Q
Q
Q
t
t
t
a
a
a
a
a
a
a
a
a
a
a
a
a
"}
(9,1,1) = {"
a
a
a
a
a
a
a
a
a
Q
t
Q
Q
Q
Q
t
t
t
Q
Q
Q
Q
a
t
t
t
a
a
a
a
a
a
a
a
a
a
a
a
a
a
"}
(10,1,1) = {"
a
a
a
a
a
a
a
a
a
t
t
t
Q
Q
Q
t
t
t
t
t
t
t
t
t
t
t
Q
Q
a
a
a
a
a
a
a
a
a
a
a
a
"}
(11,1,1) = {"
a
a
a
a
a
a
a
t
t
t
t
Q
Q
t
t
t
t
t
t
t
t
t
t
t
t
t
t
Q
Q
a
a
a
a
a
a
a
a
a
a
a
"}
(12,1,1) = {"
a
a
a
a
a
a
a
t
t
t
t
t
t
t
t
t
t
t
t
t
t
t
t
t
t
t
t
Q
Q
a
a
a
a
a
a
a
a
a
a
a
"}
(13,1,1) = {"
a
a
a
a
a
a
a
t
t
t
t
t
t
t
t
B
B
B
B
B
B
B
t
t
t
t
Q
Q
Q
Q
a
a
a
a
a
a
a
a
a
a
"}
(14,1,1) = {"
a
a
a
a
a
a
a
t
Q
t
t
t
t
t
B
B
q
q
q
q
q
B
B
t
t
t
t
t
Q
Q
Q
a
a
a
a
a
a
a
a
a
"}
(15,1,1) = {"
a
a
a
a
a
a
a
t
Q
Q
t
t
t
B
B
q
q
n
n
n
q
q
B
t
t
t
t
t
Q
t
Q
a
a
a
a
a
a
a
a
a
"}
(16,1,1) = {"
a
a
a
a
a
a
t
t
t
Q
Q
t
t
B
q
q
n
n
n
n
n
q
B
t
t
t
t
t
t
t
Q
Q
a
a
a
a
a
a
a
a
"}
(17,1,1) = {"
a
a
a
a
a
a
t
t
t
a
Q
t
t
B
q
n
n
n
n
n
n
q
B
t
t
t
t
t
t
t
t
a
a
a
a
a
a
a
a
a
"}
(18,1,1) = {"
a
a
a
a
a
t
t
t
t
a
Q
t
t
B
q
n
n
n
n
n
n
q
B
t
t
Q
Q
t
t
t
t
a
a
a
a
a
a
a
a
a
"}
(19,1,1) = {"
a
a
a
a
t
t
t
t
t
t
Q
t
t
B
q
q
n
n
n
n
q
q
B
t
t
a
Q
Q
t
t
t
a
a
a
a
a
a
a
a
a
"}
(20,1,1) = {"
a
a
a
a
t
t
t
t
t
t
Q
Q
t
B
B
q
n
n
q
q
q
B
B
t
t
a
a
t
t
t
t
t
a
a
a
a
a
a
a
a
"}
(21,1,1) = {"
a
a
a
a
t
t
t
t
t
t
t
Q
t
t
B
q
q
q
q
B
B
B
t
t
t
a
a
a
t
t
t
a
a
a
a
a
a
a
a
a
"}
(22,1,1) = {"
a
a
a
a
a
t
t
t
t
t
t
Q
Q
t
B
B
B
B
B
B
t
t
t
Q
a
a
t
t
t
a
a
a
a
a
a
a
a
a
a
a
"}
(23,1,1) = {"
a
a
a
a
a
t
t
t
t
t
t
t
Q
Q
t
t
t
t
t
t
t
t
Q
Q
a
a
a
a
t
a
a
a
a
a
a
a
a
a
a
a
"}
(24,1,1) = {"
a
a
a
a
a
a
t
t
t
t
t
t
t
t
Q
a
a
a
a
t
Q
Q
Q
a
a
a
a
a
a
a
a
a
a
a
a
a
a
a
a
a
"}
(25,1,1) = {"
a
a
a
a
a
a
t
t
t
t
t
t
t
t
a
a
a
a
a
Q
a
a
a
a
a
a
a
a
a
a
a
a
a
a
a
a
a
a
a
a
"}
(26,1,1) = {"
a
a
a
a
a
a
t
t
t
t
t
t
t
t
a
a
a
a
a
a
a
a
a
a
a
a
a
a
a
a
a
a
a
a
a
a
a
a
a
a
"}
(27,1,1) = {"
a
a
a
a
a
a
a
a
t
t
a
a
a
t
a
a
a
a
a
a
a
a
a
t
a
a
a
a
a
a
t
a
a
a
a
a
a
a
a
a
"}
(28,1,1) = {"
a
a
a
a
a
a
a
a
a
a
a
a
a
a
a
a
t
a
a
a
a
a
a
a
a
a
a
a
Q
t
t
a
a
a
a
a
a
a
a
a
"}
(29,1,1) = {"
a
a
a
a
a
a
a
a
a
a
a
a
a
a
a
a
a
a
a
a
a
a
a
a
a
a
a
t
t
t
t
a
a
a
a
a
a
a
a
a
"}
(30,1,1) = {"
a
a
a
a
a
a
a
a
a
a
a
a
a
a
a
a
a
a
a
a
a
a
a
a
a
a
t
t
t
t
a
a
a
a
a
a
a
a
a
a
"}
(31,1,1) = {"
a
a
a
a
a
a
a
a
a
a
a
a
a
t
a
a
a
t
a
a
a
a
a
a
a
a
t
t
t
t
a
a
a
a
a
a
a
a
a
a
"}
(32,1,1) = {"
a
a
a
a
a
a
a
a
a
t
t
a
a
a
a
a
a
a
a
a
a
t
t
a
a
a
a
t
t
t
a
a
a
a
a
a
a
a
a
a
"}
(33,1,1) = {"
a
a
a
a
a
t
a
a
a
a
t
a
a
a
a
a
t
t
t
t
t
t
t
t
a
a
a
t
t
a
a
a
a
a
a
a
a
a
a
a
"}
(34,1,1) = {"
a
a
a
a
a
t
a
a
a
a
a
a
a
a
t
t
t
t
t
t
t
t
t
t
a
a
a
a
t
a
a
a
a
a
a
a
a
a
a
a
"}
(35,1,1) = {"
a
a
a
a
a
a
a
a
a
a
a
a
a
a
Q
Q
Q
t
t
t
t
t
t
t
t
a
a
a
a
a
a
a
a
a
a
a
a
a
a
a
"}
(36,1,1) = {"
a
a
a
a
a
a
a
t
a
a
a
a
a
a
a
a
Q
Q
t
t
t
a
t
t
t
a
a
a
a
a
a
a
a
a
a
a
a
a
a
a
"}
(37,1,1) = {"
a
a
a
a
a
a
t
a
a
a
a
a
a
a
a
a
a
Q
Q
t
t
a
a
a
a
a
a
a
a
a
a
a
a
a
a
a
a
a
a
a
"}
(38,1,1) = {"
a
a
a
a
a
a
a
a
a
a
a
a
a
a
a
a
a
a
a
a
a
a
a
a
a
a
a
a
a
a
a
a
a
a
a
a
a
a
a
a
"}
(39,1,1) = {"
a
a
a
a
a
a
a
a
a
a
a
a
a
a
a
a
a
a
a
a
a
a
a
a
a
a
a
a
a
a
a
a
a
a
a
a
a
a
a
a
"}
(40,1,1) = {"
a
a
a
a
a
a
a
a
a
a
a
a
a
a
a
a
a
a
a
a
a
a
a
a
a
a
a
a
a
a
a
a
a
a
a
a
a
a
a
a
"}
