//MAP CONVERTED BY dmm2tgm.py THIS HEADER COMMENT PREVENTS RECONVERSION, DO NOT REMOVE
"a" = (
/turf/template_noop,
/area/template_noop)
"w" = (
/turf/closed/mineral/random/low_chance,
/area/template_noop)
"G" = (
/turf/closed/mineral,
/area/template_noop)
"N" = (
/turf/open/floor/plating/asteroid/airless,
/area/template_noop)
"O" = (
/obj/effect/landmark/dropship_entry,
/turf/template_noop,
/area/template_noop)
"U" = (
/turf/closed/mineral/random/high_chance,
/area/template_noop)

(1,1,1) = {"
a
a
a
a
a
a
a
a
a
a
a
a
a
a
a
a
a
a
a
a
a
a
a
a
a
a
a
a
a
a
a
a
a
a
a
a
a
a
a
a
"}
(2,1,1) = {"
a
a
a
a
a
a
a
a
a
a
a
a
a
a
a
a
a
a
a
a
a
a
a
a
a
a
a
a
a
a
a
a
a
a
a
a
a
a
a
a
"}
(3,1,1) = {"
a
a
a
a
a
a
a
a
a
a
a
a
a
a
a
a
a
a
a
a
a
a
a
a
a
a
a
a
a
a
a
a
a
a
a
a
a
a
a
a
"}
(4,1,1) = {"
a
a
a
a
a
a
a
a
a
a
a
a
a
a
a
a
a
a
a
a
a
a
a
a
a
a
a
a
a
a
a
a
a
a
a
a
a
a
a
a
"}
(5,1,1) = {"
a
a
a
a
a
a
a
a
a
a
a
a
a
G
G
G
G
G
a
a
a
a
a
a
a
a
a
a
a
a
a
a
a
a
a
a
a
a
a
a
"}
(6,1,1) = {"
a
a
a
a
a
a
a
a
a
a
a
G
G
G
G
w
G
G
G
a
a
a
a
a
a
a
a
a
a
a
a
a
a
a
a
a
a
a
a
a
"}
(7,1,1) = {"
a
a
a
a
a
a
a
a
a
G
G
G
G
G
G
G
G
G
G
a
a
a
a
a
a
a
a
a
a
a
a
a
a
O
a
a
a
a
a
a
"}
(8,1,1) = {"
a
a
a
a
a
a
w
G
G
G
G
G
G
G
G
G
w
G
G
G
a
a
a
a
a
a
a
a
a
a
a
a
a
a
a
a
a
a
a
a
"}
(9,1,1) = {"
a
a
a
a
a
w
G
G
G
G
G
G
G
G
G
G
G
G
G
G
a
a
a
a
a
a
a
a
a
a
a
a
a
a
a
a
a
a
a
a
"}
(10,1,1) = {"
a
a
a
G
G
G
G
G
G
G
G
G
G
G
G
G
G
G
G
G
N
a
a
a
a
a
a
a
a
a
a
a
a
a
a
a
a
a
a
a
"}
(11,1,1) = {"
a
a
a
G
G
G
G
G
G
G
G
G
G
G
G
G
G
G
G
G
N
a
a
a
a
a
a
a
a
a
a
a
a
a
a
a
a
a
a
a
"}
(12,1,1) = {"
a
a
a
G
G
G
G
G
G
G
G
G
G
G
G
G
G
G
G
N
N
a
a
a
a
a
a
a
a
a
a
a
a
a
a
a
a
a
a
a
"}
(13,1,1) = {"
a
a
a
G
G
G
G
G
G
G
G
G
G
G
G
G
G
G
N
N
N
a
a
a
a
a
a
a
a
a
a
a
a
a
a
a
a
a
a
a
"}
(14,1,1) = {"
a
a
a
a
G
G
G
G
G
G
G
G
G
G
G
G
G
N
N
N
N
a
a
a
a
a
a
a
a
a
a
a
a
a
a
a
a
a
a
a
"}
(15,1,1) = {"
a
a
a
a
G
G
G
w
w
w
w
G
G
G
G
G
G
G
N
N
N
a
a
a
a
a
a
a
a
a
a
a
a
a
a
a
a
a
a
a
"}
(16,1,1) = {"
a
a
a
a
G
G
w
w
w
w
w
w
G
G
G
G
G
G
G
N
N
N
a
a
a
a
a
a
a
a
a
G
G
a
a
a
a
a
a
a
"}
(17,1,1) = {"
a
a
a
a
a
a
w
w
U
U
w
w
G
G
G
G
G
G
G
N
N
N
N
a
a
a
a
a
a
G
G
G
w
a
a
a
a
a
a
a
"}
(18,1,1) = {"
a
a
a
a
a
a
a
U
U
U
w
w
G
G
G
G
G
G
G
G
N
N
N
N
a
a
a
a
G
G
w
w
w
w
a
a
a
a
a
a
"}
(19,1,1) = {"
a
a
a
a
a
a
a
a
a
a
w
w
G
G
G
G
G
G
G
G
G
N
G
G
G
G
G
G
G
w
w
w
w
U
a
a
a
a
a
a
"}
(20,1,1) = {"
a
a
a
a
a
a
a
a
a
a
a
a
G
G
G
G
G
G
G
G
G
G
G
G
G
G
G
G
G
w
w
w
U
U
a
a
a
a
a
a
"}
(21,1,1) = {"
a
a
a
a
a
a
a
a
a
a
a
a
a
a
a
G
G
G
G
G
G
G
G
G
G
G
G
G
G
w
w
U
U
U
a
a
a
a
a
a
"}
(22,1,1) = {"
a
a
a
a
a
a
a
a
a
a
a
a
a
a
a
a
G
G
G
G
G
G
G
G
G
G
G
G
G
w
w
U
U
w
a
a
a
a
a
a
"}
(23,1,1) = {"
a
a
a
a
a
a
a
a
a
a
a
a
a
a
a
a
a
G
G
G
G
G
G
G
G
G
G
G
G
w
w
w
w
w
w
a
a
a
a
a
"}
(24,1,1) = {"
a
a
a
a
a
a
a
a
a
a
a
a
a
a
a
a
a
a
G
G
G
G
G
G
G
G
G
G
G
G
w
w
w
w
w
a
a
a
a
a
"}
(25,1,1) = {"
a
a
a
a
a
a
a
a
a
a
a
a
a
a
a
a
a
a
a
a
G
G
G
G
G
G
G
G
G
G
G
G
G
G
G
a
a
a
a
a
"}
(26,1,1) = {"
a
a
a
a
a
a
a
a
a
a
a
a
a
a
a
a
a
a
a
a
G
G
G
G
G
G
G
G
G
G
G
G
G
G
G
a
a
a
a
a
"}
(27,1,1) = {"
a
a
a
a
a
a
a
a
a
a
a
a
a
a
a
a
a
a
a
a
a
a
G
G
G
G
G
G
G
G
G
G
G
G
G
a
a
a
a
a
"}
(28,1,1) = {"
a
a
a
a
a
a
a
a
a
a
a
a
a
a
a
a
a
a
a
a
a
a
G
G
G
G
G
G
G
G
G
G
G
G
G
a
a
a
a
a
"}
(29,1,1) = {"
a
a
a
a
a
a
a
a
a
a
a
a
a
a
a
a
a
a
a
a
a
a
N
G
G
G
G
G
G
G
G
G
G
G
G
a
a
a
a
a
"}
(30,1,1) = {"
a
a
a
a
a
a
a
a
a
a
a
a
a
a
a
a
a
a
a
a
a
a
N
G
G
G
G
G
G
G
G
G
G
G
G
a
a
a
a
a
"}
(31,1,1) = {"
a
a
a
a
a
a
a
a
a
a
a
a
a
a
a
a
a
a
a
a
a
a
N
N
G
w
G
G
G
G
G
G
G
G
G
a
a
a
a
a
"}
(32,1,1) = {"
a
a
a
a
a
a
a
a
a
a
a
a
a
a
a
a
a
a
a
a
a
a
N
N
w
w
w
G
G
G
G
G
G
G
a
a
a
a
a
a
"}
(33,1,1) = {"
a
a
a
a
a
a
a
a
a
a
a
a
a
a
a
a
a
a
a
a
a
a
a
N
w
U
w
w
G
G
G
G
G
a
a
a
a
a
a
a
"}
(34,1,1) = {"
a
a
a
a
a
a
a
a
a
a
a
a
a
a
a
a
a
a
a
a
a
a
a
w
w
U
U
w
w
G
G
a
a
a
a
a
a
a
a
a
"}
(35,1,1) = {"
a
a
a
a
a
a
a
a
a
a
a
a
a
a
a
a
a
a
a
a
a
a
a
a
w
U
w
w
w
a
a
a
a
a
a
a
a
a
a
a
"}
(36,1,1) = {"
a
a
a
a
a
a
a
a
a
a
a
a
a
a
a
a
a
a
a
a
a
a
a
a
a
U
w
a
a
a
a
a
a
a
a
a
a
a
a
a
"}
(37,1,1) = {"
a
a
a
a
a
a
a
a
a
a
a
a
a
a
a
a
a
a
a
a
a
a
a
a
a
a
a
a
a
a
a
a
a
a
a
a
a
a
a
a
"}
(38,1,1) = {"
a
a
a
a
a
a
a
a
a
a
a
a
a
a
a
a
a
a
a
a
a
a
a
a
a
a
a
a
a
a
a
a
a
a
a
a
a
a
a
a
"}
(39,1,1) = {"
a
a
a
a
a
a
a
a
a
a
a
a
a
a
a
a
a
a
a
a
a
a
a
a
a
a
a
a
a
a
a
a
a
a
a
a
a
a
a
a
"}
(40,1,1) = {"
a
a
a
a
a
a
a
a
a
a
a
a
a
a
a
a
a
a
a
a
a
a
a
a
a
a
a
a
a
a
a
a
a
a
a
a
a
a
a
a
"}
