//MAP CONVERTED BY dmm2tgm.py THIS HEADER COMMENT PREVENTS RECONVERSION, DO NOT REMOVE
"a" = (
/turf/template_noop,
/area/template_noop)
"d" = (
/turf/open/floor/plating/asteroid/airless,
/area/template_noop)
"p" = (
/obj/effect/landmark/dropship_entry,
/turf/template_noop,
/area/template_noop)
"B" = (
/turf/closed/mineral/random/low_chance,
/area/template_noop)
"I" = (
/turf/closed/mineral,
/area/template_noop)
"L" = (
/turf/closed/mineral/random/high_chance,
/area/template_noop)

(1,1,1) = {"
a
a
a
a
a
a
a
a
a
a
a
a
a
a
a
a
a
a
a
a
a
a
a
a
a
a
a
a
a
a
a
a
a
a
a
a
a
a
a
a
"}
(2,1,1) = {"
a
a
a
a
a
a
a
a
a
a
a
a
a
a
a
a
a
a
a
a
a
a
a
a
a
a
a
a
a
a
a
a
a
a
a
a
a
a
a
a
"}
(3,1,1) = {"
a
a
a
a
a
a
a
a
a
a
a
a
a
a
a
a
a
a
a
a
a
a
a
a
a
a
a
a
a
a
a
a
a
a
a
a
a
a
a
a
"}
(4,1,1) = {"
a
a
a
a
a
a
a
a
a
a
a
a
a
a
a
a
a
a
a
a
a
a
a
a
a
a
a
a
a
a
a
a
a
a
a
a
a
a
a
a
"}
(5,1,1) = {"
a
a
a
a
a
a
a
a
a
a
a
a
a
a
a
a
a
a
a
a
a
a
a
a
a
a
a
a
a
a
a
a
a
a
a
a
a
a
a
a
"}
(6,1,1) = {"
a
a
a
a
a
a
a
a
a
a
a
a
a
a
a
I
I
I
a
a
a
a
a
a
a
a
a
a
a
a
a
a
a
a
p
a
a
a
a
a
"}
(7,1,1) = {"
a
a
a
a
a
a
a
a
a
a
a
a
a
a
a
I
I
I
I
a
a
a
a
a
a
a
a
a
a
a
a
a
a
a
a
a
a
a
a
a
"}
(8,1,1) = {"
a
a
a
a
a
a
a
a
a
a
a
a
a
a
I
I
I
I
I
I
a
a
a
a
a
a
a
a
a
a
a
a
a
a
a
a
a
a
a
a
"}
(9,1,1) = {"
a
a
a
a
a
a
a
a
a
a
a
a
a
a
B
B
I
I
I
I
I
a
a
a
a
a
a
a
a
a
a
a
a
a
a
a
a
a
a
a
"}
(10,1,1) = {"
a
a
a
a
a
a
a
a
a
a
a
a
a
a
B
L
I
I
I
I
I
a
B
I
I
a
a
a
a
a
a
a
a
a
a
a
a
a
a
a
"}
(11,1,1) = {"
a
a
a
a
a
a
a
a
a
a
a
a
a
I
I
B
I
I
I
I
d
d
d
I
I
I
I
a
a
a
a
a
a
a
a
a
a
a
a
a
"}
(12,1,1) = {"
a
a
a
a
a
a
a
a
a
a
a
a
a
I
I
L
B
B
B
I
I
d
d
d
d
I
I
I
a
a
a
a
a
a
a
a
a
a
a
a
"}
(13,1,1) = {"
a
a
a
a
a
a
a
a
a
a
a
a
I
I
I
B
I
L
B
I
I
B
d
B
d
d
I
I
d
a
a
a
a
a
a
a
a
a
a
a
"}
(14,1,1) = {"
a
a
a
a
a
a
a
a
a
a
a
a
I
B
B
L
I
I
L
I
I
I
B
I
I
d
d
d
I
d
a
a
a
a
a
a
a
a
a
a
"}
(15,1,1) = {"
a
a
a
a
a
a
a
a
a
a
a
I
I
B
L
B
I
I
I
I
I
I
I
I
I
I
d
d
d
d
d
a
a
a
a
a
a
a
a
a
"}
(16,1,1) = {"
a
a
a
a
a
a
a
a
a
a
d
d
I
I
B
I
I
I
I
I
I
I
I
I
I
I
I
I
d
B
d
d
a
a
a
a
a
a
a
a
"}
(17,1,1) = {"
a
a
a
a
a
a
a
a
a
a
d
d
I
B
B
I
I
I
I
I
I
I
I
I
I
I
I
I
I
B
I
L
a
a
a
a
a
a
a
a
"}
(18,1,1) = {"
a
a
a
a
a
a
a
a
a
a
d
I
L
B
I
B
B
I
I
I
I
I
I
I
I
I
I
I
I
B
L
B
I
a
a
a
a
a
a
a
"}
(19,1,1) = {"
a
a
a
a
a
a
a
a
a
d
d
I
B
L
B
L
B
B
B
I
I
I
I
I
I
I
I
B
B
B
L
B
B
B
a
a
a
a
a
a
"}
(20,1,1) = {"
a
a
a
a
a
a
a
a
a
d
I
L
B
I
B
B
L
L
I
B
I
B
B
I
I
I
B
L
B
L
B
I
I
I
a
a
a
a
a
a
"}
(21,1,1) = {"
a
a
a
a
a
a
a
a
a
I
L
B
I
I
I
I
B
B
L
B
L
L
B
B
I
B
L
B
I
I
L
B
I
I
I
a
a
a
a
a
"}
(22,1,1) = {"
a
a
a
a
a
a
a
a
L
B
B
I
I
I
I
I
I
I
B
B
I
I
L
I
L
L
B
B
I
I
B
B
B
I
I
d
a
a
a
a
"}
(23,1,1) = {"
a
a
a
a
a
a
a
a
B
B
I
I
I
I
I
I
I
I
I
I
B
B
B
B
B
B
I
I
I
I
I
B
L
L
B
d
a
a
a
a
"}
(24,1,1) = {"
a
a
a
a
a
a
a
a
I
I
I
I
I
I
I
I
I
I
I
I
I
B
L
I
I
I
I
I
I
I
I
I
I
B
L
B
a
a
a
a
"}
(25,1,1) = {"
a
a
a
a
a
a
a
a
I
I
I
I
d
I
I
I
I
I
I
I
I
L
I
I
I
I
I
I
I
I
I
I
I
I
I
B
a
a
a
a
"}
(26,1,1) = {"
a
a
a
a
a
a
a
a
a
a
I
d
d
d
I
I
I
I
I
B
B
B
B
I
B
I
I
I
I
I
I
I
I
I
I
I
a
a
a
a
"}
(27,1,1) = {"
a
a
a
a
a
a
a
a
a
a
a
a
d
d
I
I
I
I
I
I
L
B
L
B
B
I
I
I
I
I
I
I
I
I
I
I
a
a
a
a
"}
(28,1,1) = {"
a
a
a
a
a
a
a
a
a
a
a
a
a
d
d
I
I
I
I
B
L
I
I
I
B
B
B
I
I
I
I
I
I
d
d
d
a
a
a
a
"}
(29,1,1) = {"
a
a
a
a
a
a
a
a
a
a
a
a
a
I
d
I
I
I
B
L
B
I
I
B
B
L
B
B
I
I
I
I
d
d
d
a
a
a
a
a
"}
(30,1,1) = {"
a
a
a
a
a
a
a
a
a
a
a
a
a
a
d
d
I
B
B
B
I
I
I
I
I
B
I
L
B
B
B
I
d
a
a
a
a
a
a
a
"}
(31,1,1) = {"
a
a
a
a
a
a
a
a
a
a
a
a
a
a
a
d
I
I
L
L
I
I
I
I
I
I
B
I
L
I
B
I
a
a
a
a
a
a
a
a
"}
(32,1,1) = {"
a
a
a
a
a
a
a
a
a
a
a
a
a
a
a
a
B
B
L
I
I
I
I
I
I
I
I
B
I
B
I
B
a
a
a
a
a
a
a
a
"}
(33,1,1) = {"
a
a
a
a
a
a
a
a
a
a
a
a
a
a
a
a
a
a
I
I
I
I
I
I
I
I
I
I
L
L
L
a
a
a
a
a
a
a
a
a
"}
(34,1,1) = {"
a
a
a
a
a
a
a
a
a
a
a
a
a
a
a
a
a
a
a
I
I
d
d
I
I
I
I
I
I
B
B
a
a
a
a
a
a
a
a
a
"}
(35,1,1) = {"
a
a
a
a
a
a
a
a
a
a
a
a
a
a
a
a
a
a
a
a
a
a
d
d
d
d
I
B
L
I
a
a
a
a
a
a
a
a
a
a
"}
(36,1,1) = {"
a
a
a
a
a
a
a
a
a
a
a
a
a
a
a
a
a
a
a
a
a
a
a
d
d
d
d
I
B
I
a
a
a
a
a
a
a
a
a
a
"}
(37,1,1) = {"
a
a
a
a
a
a
a
a
a
a
a
a
a
a
a
a
a
a
a
a
a
a
a
I
I
I
d
L
B
a
a
a
a
a
a
a
a
a
a
a
"}
(38,1,1) = {"
a
a
a
a
a
a
a
a
a
a
a
a
a
a
a
a
a
a
a
a
a
a
a
a
I
I
a
a
a
a
a
a
a
a
a
a
a
a
a
a
"}
(39,1,1) = {"
a
a
a
a
a
a
a
a
a
a
a
a
a
a
a
a
a
a
a
a
a
a
a
a
a
a
a
a
a
a
a
a
a
a
a
a
a
a
a
a
"}
(40,1,1) = {"
a
a
a
a
a
a
a
a
a
a
a
a
a
a
a
a
a
a
a
a
a
a
a
a
a
a
a
a
a
a
a
a
a
a
a
a
a
a
a
a
"}
