//MAP CONVERTED BY dmm2tgm.py THIS HEADER COMMENT PREVENTS RECONVERSION, DO NOT REMOVE
"a" = (
/turf/template_noop,
/area/template_noop)
"o" = (
/turf/open/floor/plating/asteroid/airless,
/area/template_noop)
"v" = (
/obj/effect/landmark/dropship_entry,
/turf/template_noop,
/area/template_noop)
"C" = (
/turf/closed/mineral/random/low_chance,
/area/template_noop)
"M" = (
/turf/closed/mineral,
/area/template_noop)
"N" = (
/turf/closed/mineral/random/high_chance,
/area/template_noop)

(1,1,1) = {"
a
a
a
a
a
a
a
a
a
a
a
a
a
a
a
a
a
a
a
a
a
a
a
a
a
a
a
a
a
a
a
a
a
a
a
a
a
a
a
a
"}
(2,1,1) = {"
a
a
a
a
a
a
a
a
a
a
a
a
a
a
a
a
a
a
a
a
a
a
a
a
a
a
a
a
a
a
a
a
a
a
a
a
a
a
a
a
"}
(3,1,1) = {"
a
a
a
a
a
a
a
a
a
a
a
a
a
a
a
a
a
a
a
a
a
a
a
a
a
a
a
a
a
a
a
a
a
a
a
a
a
a
a
a
"}
(4,1,1) = {"
a
a
a
a
a
a
a
a
a
a
a
a
a
a
a
a
a
a
a
a
a
a
a
a
a
a
a
a
a
a
a
a
a
a
a
a
a
a
a
a
"}
(5,1,1) = {"
a
a
a
a
a
a
a
a
a
a
a
a
a
a
a
a
a
a
a
a
a
a
a
a
a
a
a
a
a
a
a
a
a
a
a
a
a
a
a
a
"}
(6,1,1) = {"
a
a
a
a
a
a
a
a
a
a
a
a
a
a
a
a
a
a
a
a
a
a
v
a
a
a
a
a
a
a
a
a
a
a
a
a
a
a
a
a
"}
(7,1,1) = {"
a
a
a
a
a
a
a
a
a
M
a
a
a
a
a
a
a
a
a
a
a
a
a
a
a
a
a
a
a
a
a
a
a
a
a
a
a
a
a
a
"}
(8,1,1) = {"
a
a
a
a
a
a
a
a
a
M
M
C
C
a
a
a
a
a
a
a
a
a
a
a
a
a
a
a
a
a
a
a
a
a
a
a
a
a
a
a
"}
(9,1,1) = {"
a
a
a
a
a
a
a
a
a
M
M
M
C
C
a
a
a
a
a
a
a
a
a
a
a
a
a
a
a
a
a
a
a
a
a
a
a
a
a
a
"}
(10,1,1) = {"
a
a
a
a
a
a
a
a
a
a
M
M
C
C
C
a
a
a
a
a
a
a
a
a
a
a
a
a
a
a
a
o
o
C
a
a
a
a
a
a
"}
(11,1,1) = {"
a
a
a
a
a
a
a
a
a
a
M
M
M
M
M
C
M
M
a
a
a
a
a
a
a
a
a
a
a
a
C
C
C
o
a
a
a
a
a
a
"}
(12,1,1) = {"
a
a
a
a
a
a
a
a
a
a
a
M
M
M
M
C
C
M
M
a
a
a
a
a
a
a
a
a
a
C
C
M
C
C
C
a
a
a
a
a
"}
(13,1,1) = {"
a
a
a
a
a
a
a
a
a
a
M
N
M
M
M
M
M
C
C
a
a
a
a
a
a
a
a
a
C
C
C
M
M
C
M
C
a
a
a
a
"}
(14,1,1) = {"
a
a
a
a
a
a
a
a
a
a
M
N
N
M
M
M
M
o
o
a
o
a
C
o
o
o
C
C
M
C
M
M
C
M
M
M
a
a
a
a
"}
(15,1,1) = {"
a
a
a
a
a
a
a
a
a
a
C
M
M
M
M
M
M
o
o
a
o
C
C
o
o
o
C
M
C
M
M
N
N
N
M
M
a
a
a
a
"}
(16,1,1) = {"
a
a
a
a
a
a
a
a
a
a
a
C
M
M
M
M
o
o
a
a
o
o
o
o
o
M
M
M
M
N
N
N
M
M
M
M
a
a
a
a
"}
(17,1,1) = {"
a
a
a
a
a
a
a
a
a
a
a
a
a
M
o
o
o
a
a
a
o
o
o
M
M
M
M
M
M
N
M
M
M
M
M
o
a
a
a
a
"}
(18,1,1) = {"
a
a
a
a
a
a
a
a
a
a
a
a
a
a
a
a
a
a
a
a
o
o
o
M
M
M
N
N
M
M
M
M
M
o
o
o
a
a
a
a
"}
(19,1,1) = {"
a
a
a
a
a
a
a
a
a
a
a
a
a
a
a
a
a
a
a
a
o
o
M
M
N
N
N
M
M
M
M
C
o
o
o
a
a
a
a
a
"}
(20,1,1) = {"
a
a
a
a
a
a
a
a
a
a
a
a
a
a
o
o
a
o
o
N
M
M
M
M
N
M
M
M
M
C
C
C
o
o
a
a
a
a
a
a
"}
(21,1,1) = {"
a
a
a
a
a
a
a
a
a
a
a
a
a
M
M
a
a
o
M
M
M
M
M
M
M
M
M
M
C
C
o
o
o
M
M
a
a
a
a
a
"}
(22,1,1) = {"
a
a
a
a
a
a
a
a
a
a
a
a
a
a
a
a
o
o
M
M
M
N
N
M
M
M
M
C
C
o
o
o
M
M
M
a
a
a
a
a
"}
(23,1,1) = {"
a
a
a
a
C
M
o
a
a
a
a
a
a
a
a
a
o
o
M
N
M
M
M
M
M
M
M
C
C
o
o
M
M
M
M
M
a
a
a
a
"}
(24,1,1) = {"
a
a
a
a
M
M
N
o
a
a
a
a
a
a
a
a
a
o
M
N
M
M
M
M
M
M
C
C
o
o
M
M
M
C
a
a
a
a
a
a
"}
(25,1,1) = {"
a
a
a
a
a
M
M
M
M
a
a
a
a
a
a
a
a
o
N
M
M
M
M
M
C
C
M
M
M
M
M
M
C
C
a
a
a
a
a
a
"}
(26,1,1) = {"
a
a
a
a
a
M
a
M
a
a
a
a
a
M
a
a
a
o
M
M
M
C
C
C
C
M
M
M
M
M
M
C
a
a
a
a
a
a
a
a
"}
(27,1,1) = {"
a
a
a
a
a
a
a
a
a
a
a
M
M
M
o
o
a
a
a
C
C
C
a
a
a
a
a
a
M
M
a
a
a
a
a
a
a
a
a
a
"}
(28,1,1) = {"
a
a
a
a
a
a
a
o
o
M
M
M
M
M
N
o
o
a
a
a
a
a
a
a
a
a
a
a
a
a
a
a
a
a
a
a
a
a
a
a
"}
(29,1,1) = {"
a
a
a
a
a
a
o
o
o
M
M
M
N
M
M
M
M
o
a
a
a
a
a
a
a
a
a
a
a
a
a
a
a
a
a
a
a
a
a
a
"}
(30,1,1) = {"
a
a
a
a
a
o
o
o
M
M
N
N
N
M
M
M
M
M
a
a
a
a
a
a
a
a
a
a
a
a
a
a
a
a
a
a
a
a
a
a
"}
(31,1,1) = {"
a
a
a
a
a
o
M
M
M
M
N
M
M
M
M
M
M
M
M
C
C
a
a
a
a
a
a
a
a
a
a
a
a
a
a
a
a
a
a
a
"}
(32,1,1) = {"
a
a
a
a
a
a
M
M
N
N
M
M
M
M
M
M
M
M
C
C
a
a
a
a
a
a
a
a
a
a
a
a
a
a
a
a
a
a
a
a
"}
(33,1,1) = {"
a
a
a
a
a
a
M
M
N
M
M
M
M
M
M
M
M
C
M
C
a
a
a
a
a
a
a
a
a
a
a
a
a
a
a
a
a
a
a
a
"}
(34,1,1) = {"
a
a
a
a
a
a
M
M
M
M
M
C
C
C
C
M
C
C
C
C
a
a
a
a
a
a
a
a
a
a
a
a
a
a
a
a
a
a
a
a
"}
(35,1,1) = {"
a
a
a
a
a
a
a
a
a
M
M
C
C
a
C
C
C
C
C
a
a
a
a
a
a
a
a
a
a
a
a
a
a
a
a
a
a
a
a
a
"}
(36,1,1) = {"
a
a
a
a
a
a
a
a
a
a
a
a
a
a
a
a
C
a
a
a
a
a
a
a
a
a
a
a
a
a
a
a
a
a
a
a
a
a
a
a
"}
(37,1,1) = {"
a
a
a
a
a
a
a
a
a
a
a
a
a
a
a
a
a
a
a
a
a
a
a
a
a
a
a
a
a
a
a
a
a
a
a
a
a
a
a
a
"}
(38,1,1) = {"
a
a
a
a
a
a
a
a
a
a
a
a
a
a
a
a
a
a
a
a
a
a
a
a
a
a
a
a
a
a
a
a
a
a
a
a
a
a
a
a
"}
(39,1,1) = {"
a
a
a
a
a
a
a
a
a
a
a
a
a
a
a
a
a
a
a
a
a
a
a
a
a
a
a
a
a
a
a
a
a
a
a
a
a
a
a
a
"}
(40,1,1) = {"
a
a
a
a
a
a
a
a
a
a
a
a
a
a
a
a
a
a
a
a
a
a
a
a
a
a
a
a
a
a
a
a
a
a
a
a
a
a
a
a
"}
