//MAP CONVERTED BY dmm2tgm.py THIS HEADER COMMENT PREVENTS RECONVERSION, DO NOT REMOVE
"al" = (
/turf/closed/wall/indestructible/dropship{
	icon_state = "94"
	},
/area/dropship/generic)
"aE" = (
/turf/closed/wall/indestructible/dropship{
	icon_state = "75"
	},
/area/dropship/generic)
"bs" = (
/obj/machinery/computer/ship/helm/console/dropship,
/turf/open/indestructible/dropship{
	icon_state = "rasputin14"
	},
/area/dropship/generic)
"bG" = (
/turf/closed/wall/indestructible/dropship{
	icon_state = "blue_rearwing_rrb"
	},
/area/dropship/generic)
"bK" = (
/turf/closed/wall/indestructible/dropship{
	icon_state = "13"
	},
/area/dropship/generic)
"cf" = (
/turf/closed/wall/indestructible/dropship{
	icon_state = "blue_rearwing_lb"
	},
/area/dropship/generic)
"cp" = (
/turf/closed/wall/indestructible/dropship{
	icon_state = "34"
	},
/area/dropship/generic)
"cs" = (
/obj/machinery/computer/ship/viewscreen{
	pixel_y = 29
	},
/turf/open/indestructible/dropship{
	icon_state = "rasputin7"
	},
/area/dropship/generic)
"em" = (
/turf/closed/wall/indestructible/dropship{
	icon_state = "64"
	},
/area/dropship/generic)
"eo" = (
/obj/structure/sign/ship/smoking{
	dir = 4
	},
/turf/closed/wall/indestructible/dropship{
	icon_state = "67"
	},
/area/dropship/generic)
"eu" = (
/turf/closed/wall/indestructible/dropship{
	icon_state = "72"
	},
/area/dropship/generic)
"eH" = (
/obj/structure/sign/ship/fire{
	dir = 8;
	name = "FLAMMABLE"
	},
/turf/closed/wall/indestructible/dropship{
	icon_state = "22"
	},
/area/dropship/generic)
"gb" = (
/obj/structure/sign/ship/securearea{
	name = "CAUTION: FASTEN YOUR SEATBELT";
	pixel_y = -6
	},
/turf/closed/wall/indestructible/dropship{
	icon_state = "53"
	},
/area/dropship/generic)
"gw" = (
/obj/effect/turf_decal/stripes/line,
/obj/effect/landmark/dropship_entry,
/turf/open/indestructible/dropship{
	icon_state = "rasputin9"
	},
/area/dropship/generic)
"hN" = (
/obj/structure/lattice/catwalk/over/ship/dark,
/obj/structure/table/reinforced,
/obj/item/paper_bin,
/turf/open/indestructible/dropship{
	icon_state = "rasputin15"
	},
/area/dropship/generic)
"ix" = (
/turf/open/indestructible/dropship{
	icon_state = "rasputin4"
	},
/area/dropship/generic)
"iy" = (
/obj/structure/closet/emcloset,
/obj/structure/lattice/catwalk/over/ship/dark,
/turf/open/indestructible/dropship{
	icon_state = "rasputin15"
	},
/area/dropship/generic)
"iE" = (
/turf/closed/wall/indestructible/dropship{
	icon_state = "blue_rearwing_rrrb"
	},
/area/dropship/generic)
"iK" = (
/turf/closed/wall/indestructible/dropship{
	icon_state = "80"
	},
/area/dropship/generic)
"iX" = (
/turf/closed/wall/indestructible/dropship{
	icon_state = "47"
	},
/area/dropship/generic)
"ja" = (
/turf/open/indestructible/dropship{
	icon_state = "rasputin8"
	},
/area/dropship/generic)
"jb" = (
/turf/closed/wall/indestructible/dropship{
	icon_state = "96"
	},
/area/dropship/generic)
"jK" = (
/turf/closed/wall/indestructible/dropship{
	icon_state = "81"
	},
/area/dropship/generic)
"kY" = (
/turf/open/indestructible/dropship{
	icon_state = "rasputin9"
	},
/area/dropship/generic)
"kZ" = (
/turf/closed/wall/indestructible/dropship{
	icon_state = "blue_fl"
	},
/area/dropship/generic)
"mC" = (
/turf/closed/wall/indestructible/dropship{
	icon_state = "blue_fr"
	},
/area/dropship/generic)
"mV" = (
/turf/closed/wall/indestructible/dropship{
	icon_state = "32"
	},
/area/dropship/generic)
"nB" = (
/turf/closed/wall/indestructible/dropship{
	icon_state = "blue_wing_rt"
	},
/area/dropship/generic)
"nV" = (
/obj/structure/chair/fancy/dropship{
	dir = 1
	},
/obj/structure/lattice/catwalk/over/ship/dark,
/turf/open/indestructible/dropship{
	icon_state = "rasputin14"
	},
/area/dropship/generic)
"on" = (
/turf/closed/wall/indestructible/dropship{
	icon_state = "blue_weapon_lr"
	},
/area/dropship/generic)
"ou" = (
/obj/structure/chair/fancy/dropship{
	dir = 1;
	name = "overwatch command centre"
	},
/obj/structure/lattice/catwalk/over/ship/dark,
/obj/machinery/computer/security/telescreen/squadcam{
	pixel_y = -24
	},
/obj/machinery/requests_console{
	announcementConsole = 1;
	department = "Head of Security's Desk";
	departmentType = 5;
	name = "NSV Hammerbird Overwatch RC";
	pixel_x = 32;
	pixel_y = 26
	},
/turf/open/indestructible/dropship{
	icon_state = "rasputin14"
	},
/area/dropship/generic)
"pe" = (
/turf/closed/wall/indestructible/dropship{
	icon_state = "blue_rearwing_llb"
	},
/area/dropship/generic)
"px" = (
/obj/structure/lattice/catwalk/over/ship/dark,
/obj/structure/guncase,
/turf/open/indestructible/dropship{
	icon_state = "rasputin15"
	},
/area/dropship/generic)
"pR" = (
/obj/structure/chair/fancy/dropship{
	dir = 4
	},
/obj/machinery/light{
	dir = 8
	},
/turf/open/indestructible/dropship{
	icon_state = "rasputin15"
	},
/area/dropship/generic)
"rx" = (
/turf/closed/wall/indestructible/dropship{
	icon_state = "blue_weapon_ll"
	},
/area/dropship/generic)
"sh" = (
/obj/structure/sign/ship/plaque/dark{
	name = "NSV Hammerbird Dedication Plaque";
	pixel_y = -4
	},
/turf/closed/wall/indestructible/dropship{
	icon_state = "81"
	},
/area/dropship/generic)
"sF" = (
/obj/structure/sign/ship/smoking{
	dir = 8
	},
/turf/closed/wall/indestructible/dropship{
	icon_state = "69"
	},
/area/dropship/generic)
"tg" = (
/turf/closed/wall/indestructible/dropship{
	icon_state = "blue_engine_rt"
	},
/area/dropship/generic)
"vC" = (
/turf/closed/wall/indestructible/dropship{
	icon_state = "10"
	},
/area/dropship/generic)
"wf" = (
/obj/structure/lattice/catwalk/over/ship/dark,
/obj/structure/table/reinforced,
/obj/item/storage/crayons,
/turf/open/indestructible/dropship{
	icon_state = "rasputin15"
	},
/area/dropship/generic)
"wn" = (
/turf/closed/wall/indestructible/dropship{
	icon_state = "blue_cockpit_fr"
	},
/area/dropship/generic)
"wp" = (
/turf/closed/wall/indestructible/dropship{
	icon_state = "11"
	},
/area/dropship/generic)
"wu" = (
/turf/closed/wall/indestructible/dropship{
	icon_state = "28"
	},
/area/dropship/generic)
"wJ" = (
/turf/closed/wall/indestructible/dropship{
	icon_state = "73"
	},
/area/dropship/generic)
"xK" = (
/obj/structure/lattice/catwalk/over/ship/dark,
/obj/machinery/vending/cigarette,
/turf/open/indestructible/dropship{
	icon_state = "rasputin15"
	},
/area/dropship/generic)
"xR" = (
/obj/effect/turf_decal/stripes/line,
/obj/effect/landmark/dropship_entry,
/turf/open/indestructible/dropship{
	icon_state = "rasputin8"
	},
/area/dropship/generic)
"yh" = (
/turf/closed/wall/indestructible/dropship{
	icon_state = "blue_wing_lt"
	},
/area/dropship/generic)
"yo" = (
/obj/structure/sign/ship/nosmoking{
	dir = 8
	},
/turf/closed/wall/indestructible/dropship{
	icon_state = "19"
	},
/area/dropship/generic)
"yA" = (
/turf/closed/wall/indestructible/dropship{
	icon_state = "39"
	},
/area/dropship/generic)
"zj" = (
/turf/closed/wall/indestructible/dropship{
	icon_state = "98"
	},
/area/dropship/generic)
"zq" = (
/obj/machinery/vending/wallmed{
	pixel_y = 26
	},
/turf/open/indestructible/dropship{
	icon_state = "rasputin5"
	},
/area/dropship/generic)
"zB" = (
/turf/closed/wall/indestructible/dropship{
	icon_state = "12"
	},
/area/dropship/generic)
"zX" = (
/turf/closed/wall/indestructible/dropship{
	icon_state = "blue_engine_lb"
	},
/area/dropship/generic)
"Ae" = (
/obj/machinery/light,
/turf/open/indestructible/dropship,
/area/dropship/generic)
"Ap" = (
/turf/closed/wall/indestructible/dropship{
	icon_state = "23"
	},
/area/dropship/generic)
"Ax" = (
/obj/machinery/computer/squad_manager{
	icon = 'nsv13/goonstation/icons/obj/computer.dmi'
	},
/turf/open/indestructible/dropship{
	icon_state = "rasputin14"
	},
/area/dropship/generic)
"AV" = (
/turf/open/indestructible/dropship{
	icon_state = "rasputin5"
	},
/area/dropship/generic)
"AY" = (
/obj/structure/lattice/catwalk/over/ship/dark,
/obj/structure/chair/fancy/dropship{
	dir = 8
	},
/turf/open/indestructible/dropship{
	icon_state = "rasputin15"
	},
/area/dropship/generic)
"Bl" = (
/turf/closed/wall/indestructible/dropship{
	icon_state = "59"
	},
/area/dropship/generic)
"BU" = (
/obj/structure/sign/ship/nosmoking{
	dir = 4
	},
/turf/closed/wall/indestructible/dropship{
	icon_state = "18"
	},
/area/dropship/generic)
"CL" = (
/turf/closed/wall/indestructible/dropship{
	icon_state = "86"
	},
/area/dropship/generic)
"CY" = (
/obj/structure/lattice/catwalk/over/ship/dark,
/obj/structure/chair/fancy/dropship{
	dir = 4
	},
/turf/open/indestructible/dropship{
	icon_state = "rasputin15"
	},
/area/dropship/generic)
"DV" = (
/turf/closed/wall/indestructible/dropship{
	icon_state = "blue_rearwing_lllb"
	},
/area/dropship/generic)
"Er" = (
/turf/closed/wall/indestructible/dropship{
	icon_state = "blue_wing_lb"
	},
/area/dropship/generic)
"EJ" = (
/turf/closed/wall/indestructible/dropship{
	icon_state = "97"
	},
/area/dropship/generic)
"Fc" = (
/obj/structure/lattice/catwalk/over/ship/dark,
/obj/structure/table/reinforced,
/obj/item/stack/spacecash/c10,
/obj/item/stack/spacecash/c10,
/turf/open/indestructible/dropship{
	icon_state = "rasputin15"
	},
/area/dropship/generic)
"Fj" = (
/turf/closed/wall/indestructible/dropship{
	icon_state = "blue_rearwing_rt"
	},
/area/dropship/generic)
"FF" = (
/turf/closed/wall/indestructible/dropship{
	icon_state = "blue_front"
	},
/area/dropship/generic)
"Gu" = (
/turf/closed/wall/indestructible/dropship{
	icon_state = "blue_middle_lc"
	},
/area/dropship/generic)
"GN" = (
/turf/closed/wall/indestructible/dropship{
	icon_state = "35"
	},
/area/dropship/generic)
"Hz" = (
/turf/closed/wall/indestructible/dropship{
	icon_state = "66"
	},
/area/dropship/generic)
"HC" = (
/turf/closed/wall/indestructible/dropship{
	icon_state = "83"
	},
/area/dropship/generic)
"In" = (
/turf/closed/wall/indestructible/dropship{
	icon_state = "62"
	},
/area/dropship/generic)
"Io" = (
/obj/machinery/light{
	dir = 1
	},
/turf/open/indestructible/dropship{
	icon_state = "rasputin5"
	},
/area/dropship/generic)
"Ip" = (
/turf/closed/wall/indestructible/dropship{
	icon_state = "18"
	},
/area/dropship/generic)
"IH" = (
/obj/structure/lattice/catwalk/over/ship/dark,
/obj/structure/chair/fancy/dropship,
/turf/open/indestructible/dropship{
	icon_state = "rasputin15"
	},
/area/dropship/generic)
"IV" = (
/obj/structure/chair/fancy/dropship{
	dir = 4
	},
/turf/open/indestructible/dropship{
	icon_state = "rasputin15"
	},
/area/dropship/generic)
"Jf" = (
/turf/closed/wall/indestructible/dropship{
	icon_state = "78"
	},
/area/dropship/generic)
"Jx" = (
/turf/closed/wall/indestructible/dropship{
	icon_state = "blue_engine_rb"
	},
/area/dropship/generic)
"Jy" = (
/obj/structure/chair/fancy/dropship{
	dir = 8
	},
/obj/machinery/light{
	dir = 4
	},
/turf/open/indestructible/dropship{
	icon_state = "rasputin15"
	},
/area/dropship/generic)
"Jz" = (
/turf/closed/wall/indestructible/dropship{
	icon_state = "blue_middle_rc"
	},
/area/dropship/generic)
"LK" = (
/obj/structure/sign/ship/securearea/alt{
	pixel_y = -3
	},
/turf/closed/wall/indestructible/dropship{
	icon_state = "82"
	},
/area/dropship/generic)
"LM" = (
/obj/structure/sign/ship/smoking{
	dir = 4;
	pixel_x = -2
	},
/turf/closed/wall/indestructible/dropship{
	icon_state = "92"
	},
/area/dropship/generic)
"LQ" = (
/turf/closed/wall/indestructible/dropship{
	icon_state = "56"
	},
/area/dropship/generic)
"Ni" = (
/obj/machinery/door/airlock/ship/hatch{
	name = "cockpit";
	req_one_access_txt = "69;72"
	},
/turf/open/indestructible/dropship{
	icon_state = "rasputin3"
	},
/area/dropship/generic)
"Nn" = (
/turf/closed/wall/indestructible/dropship{
	icon_state = "70"
	},
/area/dropship/generic)
"NW" = (
/obj/structure/sign/ship/fire{
	dir = 8;
	name = "FLAMMABLE"
	},
/turf/closed/wall/indestructible/dropship{
	icon_state = "31"
	},
/area/dropship/generic)
"Ok" = (
/turf/open/indestructible/dropship{
	icon_state = "rasputin2"
	},
/area/dropship/generic)
"Ol" = (
/obj/structure/rack,
/obj/item/storage/firstaid/regular,
/obj/item/storage/firstaid/brute{
	pixel_y = 4
	},
/obj/structure/lattice/catwalk/over/ship/dark,
/turf/open/indestructible/dropship{
	icon_state = "rasputin15"
	},
/area/dropship/generic)
"Os" = (
/obj/structure/sign/ship/fire{
	dir = 4;
	name = "FLAMMABLE"
	},
/turf/closed/wall/indestructible/dropship{
	icon_state = "27"
	},
/area/dropship/generic)
"ON" = (
/turf/closed/wall/indestructible/dropship{
	icon_state = "68"
	},
/area/dropship/generic)
"OT" = (
/turf/closed/wall/indestructible/dropship/entry,
/area/dropship/generic)
"Pd" = (
/turf/closed/wall/indestructible/dropship{
	icon_state = "29"
	},
/area/dropship/generic)
"Pm" = (
/turf/closed/wall/indestructible/dropship{
	icon_state = "33"
	},
/area/dropship/generic)
"QI" = (
/turf/closed/wall/indestructible/dropship{
	icon_state = "25"
	},
/area/dropship/generic)
"QY" = (
/turf/closed/wall/indestructible/dropship{
	icon_state = "48"
	},
/area/dropship/generic)
"RC" = (
/turf/closed/wall/indestructible/dropship{
	icon_state = "38"
	},
/area/dropship/generic)
"RK" = (
/obj/structure/lattice/catwalk/over/ship/dark,
/obj/structure/rack,
/turf/open/indestructible/dropship{
	icon_state = "rasputin15"
	},
/area/dropship/generic)
"RU" = (
/obj/structure/chair/fancy/dropship{
	dir = 8
	},
/turf/open/indestructible/dropship{
	icon_state = "rasputin15"
	},
/area/dropship/generic)
"Sa" = (
/obj/machinery/squad_vendor,
/turf/closed/wall/indestructible/dropship{
	icon_state = "76"
	},
/area/dropship/generic)
"SP" = (
/turf/closed/wall/indestructible/dropship{
	icon_state = "blue_cockpit_fl"
	},
/area/dropship/generic)
"SY" = (
/turf/closed/wall/indestructible/dropship{
	icon_state = "blue_rearwing_rb"
	},
/area/dropship/generic)
"TT" = (
/turf/closed/wall/indestructible/dropship{
	icon_state = "19"
	},
/area/dropship/generic)
"Ue" = (
/obj/machinery/stasis,
/obj/structure/lattice/catwalk/over/ship/dark,
/turf/open/indestructible/dropship{
	icon_state = "rasputin15"
	},
/area/dropship/generic)
"Ul" = (
/turf/closed/wall/indestructible/dropship{
	icon_state = "24"
	},
/area/dropship/generic)
"Ve" = (
/turf/closed/wall/indestructible/dropship{
	icon_state = "69"
	},
/area/dropship/generic)
"Vk" = (
/turf/open/indestructible/dropship{
	icon_state = "rasputin3"
	},
/area/dropship/generic)
"Vv" = (
/obj/machinery/computer/ship/viewscreen{
	pixel_y = 29
	},
/turf/open/indestructible/dropship{
	icon_state = "rasputin6"
	},
/area/dropship/generic)
"Wc" = (
/turf/closed/indestructible/cordon{
	alpha = 0
	},
/area/dropship/generic)
"Wd" = (
/turf/closed/wall/indestructible/dropship{
	icon_state = "blue_engine_lt"
	},
/area/dropship/generic)
"We" = (
/turf/closed/wall/indestructible/dropship{
	icon_state = "67"
	},
/area/dropship/generic)
"Wy" = (
/turf/closed/wall/indestructible/dropship{
	icon_state = "blue_wing_rb"
	},
/area/dropship/generic)
"WD" = (
/obj/machinery/light/small{
	dir = 1
	},
/obj/machinery/computer/ship/navigation/console,
/turf/open/indestructible/dropship{
	icon_state = "rasputin14"
	},
/area/dropship/generic)
"Xh" = (
/obj/structure/sign/ship/fire{
	dir = 4;
	name = "FLAMMABLE"
	},
/turf/closed/wall/indestructible/dropship{
	icon_state = "30"
	},
/area/dropship/generic)
"XE" = (
/obj/effect/turf_decal/stripes/line,
/obj/effect/landmark/dropship_entry,
/turf/open/indestructible/dropship{
	icon_state = "rasputin4"
	},
/area/dropship/generic)
"XT" = (
/turf/closed/wall/indestructible/dropship{
	icon_state = "blue_rearwing_lt"
	},
/area/dropship/generic)
"Ya" = (
/turf/closed/wall/indestructible/dropship{
	icon_state = "26"
	},
/area/dropship/generic)
"Zh" = (
/turf/closed/wall/indestructible/dropship{
	icon_state = "blue_weapon_rr"
	},
/area/dropship/generic)
"Zq" = (
/turf/closed/wall/indestructible/dropship{
	icon_state = "89"
	},
/area/dropship/generic)
"Zy" = (
/obj/structure/lattice/catwalk/over/ship/dark,
/obj/structure/chair/fancy/dropship{
	dir = 1
	},
/turf/open/indestructible/dropship{
	icon_state = "rasputin15"
	},
/area/dropship/generic)
"ZZ" = (
/turf/open/space/transit/north,
/area/dropship/generic)

(1,1,1) = {"
Wc
Wc
Wc
Wc
Wc
Wc
Wc
Wc
Wc
Wc
Wc
Wc
Wc
Wc
Wc
Wc
Wc
Wc
Wc
Wc
Wc
Wc
Wc
Wc
"}
(2,1,1) = {"
Wc
ZZ
ZZ
ZZ
ZZ
ZZ
ZZ
ZZ
ZZ
ZZ
ZZ
ZZ
ZZ
ZZ
ZZ
ZZ
ZZ
ZZ
ZZ
ZZ
ZZ
ZZ
ZZ
Wc
"}
(3,1,1) = {"
Wc
ZZ
ZZ
ZZ
ZZ
ZZ
yh
Hz
Hz
Hz
Er
ZZ
ZZ
ZZ
Wd
cp
wu
eH
zX
ZZ
ZZ
ZZ
ZZ
Wc
"}
(4,1,1) = {"
Wc
ZZ
ZZ
ZZ
rx
aE
eu
We
eo
We
In
Ip
Ip
Gu
tg
GN
Pd
Ap
Jx
ZZ
ZZ
DV
ZZ
Wc
"}
(5,1,1) = {"
Wc
ZZ
ZZ
ZZ
on
Sa
IV
IV
IV
pR
IV
IV
IV
iX
Ip
BU
Xh
Ul
Ip
Gu
ZZ
pe
ZZ
Wc
"}
(6,1,1) = {"
Wc
kZ
SP
LM
CL
Jf
Vv
Vk
Vk
Vk
Vk
Vk
ix
IV
IV
IV
pR
IV
IV
vC
XT
cf
ZZ
Wc
"}
(7,1,1) = {"
Wc
FF
jb
bs
nV
jK
zq
Ol
AY
Ue
Ue
iy
kY
Vk
Vk
Vk
Vk
Vk
XE
OT
wp
ZZ
ZZ
Wc
"}
(8,1,1) = {"
Wc
FF
EJ
WD
Ok
Ni
Ae
ON
LQ
LQ
Bl
gb
Io
IH
hN
wf
Fc
Zy
gw
OT
zB
ZZ
ZZ
Wc
"}
(9,1,1) = {"
Wc
FF
zj
Ax
ou
LK
AV
RK
CY
px
px
xK
kY
Vk
Vk
Vk
Vk
Vk
xR
OT
bK
ZZ
ZZ
Wc
"}
(10,1,1) = {"
Wc
mC
wn
al
Zq
iK
cs
Vk
Vk
Vk
Vk
Vk
ja
RU
RU
RU
Jy
RU
RU
vC
Fj
SY
ZZ
Wc
"}
(11,1,1) = {"
Wc
ZZ
ZZ
ZZ
on
sh
RU
RU
RU
Jy
RU
RU
RU
QY
TT
yo
NW
QI
TT
Jz
ZZ
bG
ZZ
Wc
"}
(12,1,1) = {"
Wc
ZZ
ZZ
ZZ
Zh
HC
wJ
Ve
sF
Ve
em
TT
TT
Jz
Wd
RC
mV
Ya
zX
ZZ
ZZ
iE
ZZ
Wc
"}
(13,1,1) = {"
Wc
ZZ
ZZ
ZZ
ZZ
ZZ
nB
Nn
Nn
Nn
Wy
ZZ
ZZ
ZZ
tg
yA
Pm
Os
Jx
ZZ
ZZ
ZZ
ZZ
Wc
"}
(14,1,1) = {"
Wc
ZZ
ZZ
ZZ
ZZ
ZZ
ZZ
ZZ
ZZ
ZZ
ZZ
ZZ
ZZ
ZZ
ZZ
ZZ
ZZ
ZZ
ZZ
ZZ
ZZ
ZZ
ZZ
Wc
"}
(15,1,1) = {"
Wc
Wc
Wc
Wc
Wc
Wc
Wc
Wc
Wc
Wc
Wc
Wc
Wc
Wc
Wc
Wc
Wc
Wc
Wc
Wc
Wc
Wc
Wc
Wc
"}
