//MAP CONVERTED BY dmm2tgm.py THIS HEADER COMMENT PREVENTS RECONVERSION, DO NOT REMOVE
"al" = (
/turf/closed/wall/indestructible/dropship{
	icon_state = "94"
	},
/area/dropship/generic/syndicate)
"aE" = (
/turf/closed/wall/indestructible/dropship{
	icon_state = "75"
	},
/area/dropship/generic/syndicate)
"bs" = (
/obj/machinery/computer/ship/helm/console/dropship{
	req_one_access_txt = "150"
	},
/turf/open/indestructible/dropship{
	icon_state = "rasputin14"
	},
/area/dropship/generic/syndicate)
"bG" = (
/turf/closed/wall/indestructible/dropship{
	icon_state = "blue_rearwing_rrb"
	},
/area/dropship/generic/syndicate)
"bK" = (
/turf/closed/wall/indestructible/dropship{
	icon_state = "13"
	},
/area/dropship/generic/syndicate)
"cf" = (
/turf/closed/wall/indestructible/dropship{
	icon_state = "blue_rearwing_lb"
	},
/area/dropship/generic/syndicate)
"cp" = (
/turf/closed/wall/indestructible/dropship{
	icon_state = "34"
	},
/area/dropship/generic/syndicate)
"cs" = (
/obj/machinery/computer/ship/viewscreen{
	pixel_y = 29
	},
/turf/open/indestructible/dropship{
	icon_state = "rasputin7"
	},
/area/dropship/generic/syndicate)
"em" = (
/turf/closed/wall/indestructible/dropship{
	icon_state = "64"
	},
/area/dropship/generic/syndicate)
"eo" = (
/obj/structure/sign/ship/smoking{
	dir = 4
	},
/turf/closed/wall/indestructible/dropship{
	icon_state = "67"
	},
/area/dropship/generic/syndicate)
"eu" = (
/turf/closed/wall/indestructible/dropship{
	icon_state = "72"
	},
/area/dropship/generic/syndicate)
"eH" = (
/obj/structure/sign/ship/fire{
	dir = 8;
	name = "FLAMMABLE"
	},
/turf/closed/wall/indestructible/dropship{
	icon_state = "22"
	},
/area/dropship/generic/syndicate)
"eT" = (
/obj/structure/chair/fancy/dropship{
	dir = 4
	},
/turf/open/indestructible/dropship{
	icon_state = "rasputin15"
	},
/area/dropship/generic/syndicate)
"gb" = (
/obj/structure/sign/ship/securearea{
	name = "CAUTION: FASTEN YOUR SEATBELT";
	pixel_y = -6
	},
/turf/closed/wall/indestructible/dropship{
	icon_state = "53"
	},
/area/dropship/generic/syndicate)
"gw" = (
/obj/effect/landmark/dropship_entry,
/obj/effect/turf_decal/stripes/red/line,
/turf/open/indestructible/dropship{
	icon_state = "rasputin9"
	},
/area/dropship/generic/syndicate)
"hN" = (
/obj/structure/lattice/catwalk/over/ship/dark,
/obj/structure/rack,
/obj/item/gun/ballistic/automatic/pistol/glock/makarov,
/obj/item/gun/ballistic/automatic/pistol/glock/makarov,
/obj/item/gun/ballistic/automatic/pistol/glock/makarov,
/obj/item/gun/ballistic/automatic/pistol/glock/makarov,
/obj/item/gun/ballistic/automatic/pistol/glock/makarov,
/turf/open/indestructible/dropship{
	icon_state = "rasputin15"
	},
/area/dropship/generic/syndicate)
"ix" = (
/turf/open/indestructible/dropship{
	icon_state = "rasputin4"
	},
/area/dropship/generic/syndicate)
"iy" = (
/obj/structure/lattice/catwalk/over/ship/dark,
/obj/structure/tank_dispenser/oxygen,
/turf/open/indestructible/dropship{
	icon_state = "rasputin15"
	},
/area/dropship/generic/syndicate)
"iE" = (
/turf/closed/wall/indestructible/dropship{
	icon_state = "blue_rearwing_rrrb"
	},
/area/dropship/generic/syndicate)
"iK" = (
/turf/closed/wall/indestructible/dropship{
	icon_state = "80"
	},
/area/dropship/generic/syndicate)
"iX" = (
/turf/closed/wall/indestructible/dropship{
	icon_state = "47"
	},
/area/dropship/generic/syndicate)
"ja" = (
/turf/open/indestructible/dropship{
	icon_state = "rasputin8"
	},
/area/dropship/generic/syndicate)
"jb" = (
/turf/closed/wall/indestructible/dropship{
	icon_state = "96"
	},
/area/dropship/generic/syndicate)
"jK" = (
/turf/closed/wall/indestructible/dropship{
	icon_state = "81"
	},
/area/dropship/generic/syndicate)
"kY" = (
/turf/open/indestructible/dropship{
	icon_state = "rasputin9"
	},
/area/dropship/generic/syndicate)
"kZ" = (
/turf/closed/wall/indestructible/dropship{
	icon_state = "blue_fl"
	},
/area/dropship/generic/syndicate)
"mC" = (
/turf/closed/wall/indestructible/dropship{
	icon_state = "blue_fr"
	},
/area/dropship/generic/syndicate)
"mV" = (
/turf/closed/wall/indestructible/dropship{
	icon_state = "32"
	},
/area/dropship/generic/syndicate)
"nB" = (
/turf/closed/wall/indestructible/dropship{
	icon_state = "blue_wing_rt"
	},
/area/dropship/generic/syndicate)
"nV" = (
/obj/structure/chair/fancy/dropship{
	dir = 1
	},
/obj/structure/lattice/catwalk/over/ship/dark,
/turf/open/indestructible/dropship{
	icon_state = "rasputin14"
	},
/area/dropship/generic/syndicate)
"on" = (
/turf/closed/wall/indestructible/dropship{
	icon_state = "blue_weapon_lr"
	},
/area/dropship/generic/syndicate)
"ou" = (
/obj/structure/chair/fancy/dropship{
	dir = 1;
	name = "overwatch command centre"
	},
/obj/structure/lattice/catwalk/over/ship/dark,
/turf/open/indestructible/dropship{
	icon_state = "rasputin14"
	},
/area/dropship/generic/syndicate)
"pe" = (
/turf/closed/wall/indestructible/dropship{
	icon_state = "blue_rearwing_llb"
	},
/area/dropship/generic/syndicate)
"pR" = (
/obj/structure/chair/fancy/dropship{
	dir = 4
	},
/obj/machinery/light{
	dir = 8
	},
/turf/open/indestructible/dropship{
	icon_state = "rasputin15"
	},
/area/dropship/generic/syndicate)
"rx" = (
/turf/closed/wall/indestructible/dropship{
	icon_state = "blue_weapon_ll"
	},
/area/dropship/generic/syndicate)
"sh" = (
/obj/structure/sign/ship/plaque/dark,
/turf/closed/wall/indestructible/dropship{
	icon_state = "81"
	},
/area/dropship/generic/syndicate)
"sF" = (
/obj/structure/sign/ship/smoking{
	dir = 8
	},
/turf/closed/wall/indestructible/dropship{
	icon_state = "69"
	},
/area/dropship/generic/syndicate)
"tg" = (
/turf/closed/wall/indestructible/dropship{
	icon_state = "blue_engine_rt"
	},
/area/dropship/generic/syndicate)
"vC" = (
/turf/closed/wall/indestructible/dropship{
	icon_state = "10"
	},
/area/dropship/generic/syndicate)
"wf" = (
/obj/structure/lattice/catwalk/over/ship/dark,
/obj/structure/rack,
/obj/item/ammo_box/magazine/glock/lethal,
/obj/item/ammo_box/magazine/glock/lethal,
/obj/item/ammo_box/magazine/glock/lethal,
/obj/item/ammo_box/magazine/glock/lethal,
/obj/item/ammo_box/magazine/glock/lethal,
/turf/open/indestructible/dropship{
	icon_state = "rasputin15"
	},
/area/dropship/generic/syndicate)
"wn" = (
/turf/closed/wall/indestructible/dropship{
	icon_state = "blue_cockpit_fr"
	},
/area/dropship/generic/syndicate)
"wp" = (
/turf/closed/wall/indestructible/dropship{
	icon_state = "11"
	},
/area/dropship/generic/syndicate)
"wu" = (
/turf/closed/wall/indestructible/dropship{
	icon_state = "28"
	},
/area/dropship/generic/syndicate)
"wJ" = (
/turf/closed/wall/indestructible/dropship{
	icon_state = "73"
	},
/area/dropship/generic/syndicate)
"xK" = (
/obj/structure/lattice/catwalk/over/ship/dark,
/obj/machinery/vending/cigarette,
/turf/open/indestructible/dropship{
	icon_state = "rasputin15"
	},
/area/dropship/generic/syndicate)
"xR" = (
/obj/effect/landmark/dropship_entry,
/obj/effect/turf_decal/stripes/red/line,
/turf/open/indestructible/dropship{
	icon_state = "rasputin8"
	},
/area/dropship/generic/syndicate)
"yh" = (
/turf/closed/wall/indestructible/dropship{
	icon_state = "blue_wing_lt"
	},
/area/dropship/generic/syndicate)
"yo" = (
/obj/structure/sign/ship/nosmoking{
	dir = 8
	},
/turf/closed/wall/indestructible/dropship{
	icon_state = "19"
	},
/area/dropship/generic/syndicate)
"yA" = (
/turf/closed/wall/indestructible/dropship{
	icon_state = "39"
	},
/area/dropship/generic/syndicate)
"zj" = (
/turf/closed/wall/indestructible/dropship{
	icon_state = "98"
	},
/area/dropship/generic/syndicate)
"zq" = (
/obj/machinery/vending/wallmed{
	pixel_y = 26
	},
/turf/open/indestructible/dropship{
	icon_state = "rasputin5"
	},
/area/dropship/generic/syndicate)
"zB" = (
/turf/closed/wall/indestructible/dropship{
	icon_state = "12"
	},
/area/dropship/generic/syndicate)
"zX" = (
/turf/closed/wall/indestructible/dropship{
	icon_state = "blue_engine_lb"
	},
/area/dropship/generic/syndicate)
"Ae" = (
/obj/machinery/light,
/turf/open/indestructible/dropship,
/area/dropship/generic/syndicate)
"Ap" = (
/turf/closed/wall/indestructible/dropship{
	icon_state = "23"
	},
/area/dropship/generic/syndicate)
"Ax" = (
/obj/machinery/computer/squad_manager{
	icon = 'nsv13/goonstation/icons/obj/computer.dmi'
	},
/turf/open/indestructible/dropship{
	icon_state = "rasputin14"
	},
/area/dropship/generic/syndicate)
"AV" = (
/turf/open/indestructible/dropship{
	icon_state = "rasputin5"
	},
/area/dropship/generic/syndicate)
"AY" = (
/obj/structure/lattice/catwalk/over/ship/dark,
/obj/structure/chair/fancy/dropship{
	dir = 8
	},
/turf/open/indestructible/dropship{
	icon_state = "rasputin15"
	},
/area/dropship/generic/syndicate)
"Bl" = (
/turf/closed/wall/indestructible/dropship{
	icon_state = "59"
	},
/area/dropship/generic/syndicate)
"BU" = (
/obj/structure/sign/ship/nosmoking{
	dir = 4
	},
/turf/closed/wall/indestructible/dropship{
	icon_state = "18"
	},
/area/dropship/generic/syndicate)
"CL" = (
/turf/closed/wall/indestructible/dropship{
	icon_state = "86"
	},
/area/dropship/generic/syndicate)
"CY" = (
/obj/structure/lattice/catwalk/over/ship/dark,
/obj/machinery/suit_storage_unit/syndicate/odst,
/turf/open/indestructible/dropship{
	icon_state = "rasputin15"
	},
/area/dropship/generic/syndicate)
"DV" = (
/turf/closed/wall/indestructible/dropship{
	icon_state = "blue_rearwing_lllb"
	},
/area/dropship/generic/syndicate)
"Er" = (
/turf/closed/wall/indestructible/dropship{
	icon_state = "blue_wing_lb"
	},
/area/dropship/generic/syndicate)
"EJ" = (
/turf/closed/wall/indestructible/dropship{
	icon_state = "97"
	},
/area/dropship/generic/syndicate)
"Fc" = (
/obj/structure/lattice/catwalk/over/ship/dark,
/obj/structure/rack,
/obj/item/ammo_box/c9mm,
/obj/item/ammo_box/c9mm,
/turf/open/indestructible/dropship{
	icon_state = "rasputin15"
	},
/area/dropship/generic/syndicate)
"Fj" = (
/turf/closed/wall/indestructible/dropship{
	icon_state = "blue_rearwing_rt"
	},
/area/dropship/generic/syndicate)
"FF" = (
/turf/closed/wall/indestructible/dropship{
	icon_state = "blue_front"
	},
/area/dropship/generic/syndicate)
"Gu" = (
/turf/closed/wall/indestructible/dropship{
	icon_state = "blue_middle_lc"
	},
/area/dropship/generic/syndicate)
"GN" = (
/turf/closed/wall/indestructible/dropship{
	icon_state = "35"
	},
/area/dropship/generic/syndicate)
"Hz" = (
/turf/closed/wall/indestructible/dropship{
	icon_state = "66"
	},
/area/dropship/generic/syndicate)
"HC" = (
/turf/closed/wall/indestructible/dropship{
	icon_state = "83"
	},
/area/dropship/generic/syndicate)
"In" = (
/turf/closed/wall/indestructible/dropship{
	icon_state = "62"
	},
/area/dropship/generic/syndicate)
"Io" = (
/obj/machinery/light{
	dir = 1
	},
/turf/open/indestructible/dropship{
	icon_state = "rasputin5"
	},
/area/dropship/generic/syndicate)
"Ip" = (
/turf/closed/wall/indestructible/dropship{
	icon_state = "18"
	},
/area/dropship/generic/syndicate)
"IV" = (
/obj/structure/chair/fancy/dropship{
	dir = 4
	},
/obj/machinery/computer/ship/viewscreen{
	pixel_y = 29
	},
/turf/open/indestructible/dropship{
	icon_state = "rasputin15"
	},
/area/dropship/generic/syndicate)
"Jf" = (
/obj/structure/sign/poster/contraband/c20r{
	pixel_y = -4
	},
/turf/closed/wall/indestructible/dropship{
	icon_state = "78"
	},
/area/dropship/generic/syndicate)
"Jx" = (
/turf/closed/wall/indestructible/dropship{
	icon_state = "blue_engine_rb"
	},
/area/dropship/generic/syndicate)
"Jy" = (
/obj/structure/chair/fancy/dropship{
	dir = 8
	},
/obj/machinery/light{
	dir = 4
	},
/turf/open/indestructible/dropship{
	icon_state = "rasputin15"
	},
/area/dropship/generic/syndicate)
"Jz" = (
/turf/closed/wall/indestructible/dropship{
	icon_state = "blue_middle_rc"
	},
/area/dropship/generic/syndicate)
"LK" = (
/obj/structure/sign/ship/securearea/alt{
	pixel_y = -3
	},
/turf/closed/wall/indestructible/dropship{
	icon_state = "82"
	},
/area/dropship/generic/syndicate)
"LM" = (
/obj/structure/sign/ship/smoking{
	dir = 4;
	pixel_x = -2
	},
/turf/closed/wall/indestructible/dropship{
	icon_state = "92"
	},
/area/dropship/generic/syndicate)
"LQ" = (
/turf/closed/wall/indestructible/dropship{
	icon_state = "56"
	},
/area/dropship/generic/syndicate)
"Ni" = (
/obj/machinery/door/airlock/ship/hatch{
	name = "cockpit";
	req_one_access_txt = "150"
	},
/turf/open/indestructible/dropship{
	icon_state = "rasputin3"
	},
/area/dropship/generic/syndicate)
"Nn" = (
/turf/closed/wall/indestructible/dropship{
	icon_state = "70"
	},
/area/dropship/generic/syndicate)
"NW" = (
/obj/structure/sign/ship/fire{
	dir = 8;
	name = "FLAMMABLE"
	},
/turf/closed/wall/indestructible/dropship{
	icon_state = "31"
	},
/area/dropship/generic/syndicate)
"Ok" = (
/turf/open/indestructible/dropship{
	icon_state = "rasputin2"
	},
/area/dropship/generic/syndicate)
"Ol" = (
/obj/structure/rack,
/obj/structure/lattice/catwalk/over/ship/dark,
/obj/item/storage/firstaid/tactical,
/obj/item/storage/firstaid/tactical{
	pixel_y = 4
	},
/turf/open/indestructible/dropship{
	icon_state = "rasputin15"
	},
/area/dropship/generic/syndicate)
"Os" = (
/obj/structure/sign/ship/fire{
	dir = 4;
	name = "FLAMMABLE"
	},
/turf/closed/wall/indestructible/dropship{
	icon_state = "27"
	},
/area/dropship/generic/syndicate)
"ON" = (
/turf/closed/wall/indestructible/dropship{
	icon_state = "68"
	},
/area/dropship/generic/syndicate)
"OT" = (
/turf/closed/wall/indestructible/dropship/entry,
/area/dropship/generic/syndicate)
"Pd" = (
/turf/closed/wall/indestructible/dropship{
	icon_state = "29"
	},
/area/dropship/generic/syndicate)
"Pm" = (
/turf/closed/wall/indestructible/dropship{
	icon_state = "33"
	},
/area/dropship/generic/syndicate)
"PN" = (
/obj/effect/turf_decal/ship/delivery{
	color = "#8B0000"
	},
/obj/machinery/stasis,
/obj/item/storage/backpack/duffelbag/syndie/surgery,
/turf/open/indestructible/dropship{
	icon_state = "rasputin15"
	},
/area/dropship/generic/syndicate)
"QI" = (
/turf/closed/wall/indestructible/dropship{
	icon_state = "25"
	},
/area/dropship/generic/syndicate)
"QY" = (
/turf/closed/wall/indestructible/dropship{
	icon_state = "48"
	},
/area/dropship/generic/syndicate)
"RC" = (
/turf/closed/wall/indestructible/dropship{
	icon_state = "38"
	},
/area/dropship/generic/syndicate)
"RK" = (
/obj/structure/lattice/catwalk/over/ship/dark,
/obj/structure/rack,
/turf/open/indestructible/dropship{
	icon_state = "rasputin15"
	},
/area/dropship/generic/syndicate)
"RU" = (
/obj/structure/chair/fancy/dropship{
	dir = 8
	},
/turf/open/indestructible/dropship{
	icon_state = "rasputin15"
	},
/area/dropship/generic/syndicate)
"Sa" = (
/turf/closed/wall/indestructible/dropship{
	icon_state = "76"
	},
/area/dropship/generic/syndicate)
"SP" = (
/turf/closed/wall/indestructible/dropship{
	icon_state = "blue_cockpit_fl"
	},
/area/dropship/generic/syndicate)
"SY" = (
/turf/closed/wall/indestructible/dropship{
	icon_state = "blue_rearwing_rb"
	},
/area/dropship/generic/syndicate)
"TT" = (
/turf/closed/wall/indestructible/dropship{
	icon_state = "19"
	},
/area/dropship/generic/syndicate)
"Ue" = (
/obj/effect/turf_decal/ship/delivery{
	color = "#8B0000"
	},
/obj/machinery/sleeper/syndie{
	dir = 8
	},
/turf/open/indestructible/dropship{
	icon_state = "rasputin15"
	},
/area/dropship/generic/syndicate)
"Ul" = (
/turf/closed/wall/indestructible/dropship{
	icon_state = "24"
	},
/area/dropship/generic/syndicate)
"Ve" = (
/turf/closed/wall/indestructible/dropship{
	icon_state = "69"
	},
/area/dropship/generic/syndicate)
"Vk" = (
/turf/open/indestructible/dropship{
	icon_state = "rasputin3"
	},
/area/dropship/generic/syndicate)
"Vv" = (
/turf/open/indestructible/dropship{
	icon_state = "rasputin6"
	},
/area/dropship/generic/syndicate)
"Wc" = (
/turf/closed/indestructible/cordon{
	alpha = 0
	},
/area/dropship/generic/syndicate)
"Wd" = (
/turf/closed/wall/indestructible/dropship{
	icon_state = "blue_engine_lt"
	},
/area/dropship/generic/syndicate)
"We" = (
/turf/closed/wall/indestructible/dropship{
	icon_state = "67"
	},
/area/dropship/generic/syndicate)
"Wy" = (
/turf/closed/wall/indestructible/dropship{
	icon_state = "blue_wing_rb"
	},
/area/dropship/generic/syndicate)
"WD" = (
/obj/machinery/light/small{
	dir = 1
	},
/obj/machinery/computer/ship/navigation/console,
/turf/open/indestructible/dropship{
	icon_state = "rasputin14"
	},
/area/dropship/generic/syndicate)
"Xh" = (
/obj/structure/sign/ship/fire{
	dir = 4;
	name = "FLAMMABLE"
	},
/turf/closed/wall/indestructible/dropship{
	icon_state = "30"
	},
/area/dropship/generic/syndicate)
"XE" = (
/obj/effect/landmark/dropship_entry,
/obj/effect/turf_decal/stripes/red/line,
/turf/open/indestructible/dropship{
	icon_state = "rasputin4"
	},
/area/dropship/generic/syndicate)
"XT" = (
/turf/closed/wall/indestructible/dropship{
	icon_state = "blue_rearwing_lt"
	},
/area/dropship/generic/syndicate)
"Ya" = (
/turf/closed/wall/indestructible/dropship{
	icon_state = "26"
	},
/area/dropship/generic/syndicate)
"Zh" = (
/turf/closed/wall/indestructible/dropship{
	icon_state = "blue_weapon_rr"
	},
/area/dropship/generic/syndicate)
"Zq" = (
/turf/closed/wall/indestructible/dropship{
	icon_state = "89"
	},
/area/dropship/generic/syndicate)
"Zy" = (
/obj/structure/lattice/catwalk/over/ship/dark,
/turf/open/indestructible/dropship{
	icon_state = "rasputin15"
	},
/area/dropship/generic/syndicate)
"ZZ" = (
/turf/open/space/transit/north,
/area/dropship/generic/syndicate)

(1,1,1) = {"
Wc
Wc
Wc
Wc
Wc
Wc
Wc
Wc
Wc
Wc
Wc
Wc
Wc
Wc
Wc
Wc
Wc
Wc
Wc
Wc
Wc
Wc
Wc
Wc
"}
(2,1,1) = {"
Wc
ZZ
ZZ
ZZ
ZZ
ZZ
ZZ
ZZ
ZZ
ZZ
ZZ
ZZ
ZZ
ZZ
ZZ
ZZ
ZZ
ZZ
ZZ
ZZ
ZZ
ZZ
ZZ
Wc
"}
(3,1,1) = {"
Wc
ZZ
ZZ
ZZ
ZZ
ZZ
yh
Hz
Hz
Hz
Er
ZZ
ZZ
ZZ
Wd
cp
wu
eH
zX
ZZ
ZZ
ZZ
ZZ
Wc
"}
(4,1,1) = {"
Wc
ZZ
ZZ
ZZ
rx
aE
eu
We
eo
We
In
Ip
Ip
Gu
tg
GN
Pd
Ap
Jx
ZZ
ZZ
DV
ZZ
Wc
"}
(5,1,1) = {"
Wc
ZZ
ZZ
ZZ
on
Sa
IV
eT
eT
pR
eT
eT
eT
iX
Ip
BU
Xh
Ul
Ip
Gu
ZZ
pe
ZZ
Wc
"}
(6,1,1) = {"
Wc
kZ
SP
LM
CL
Jf
Vv
Vk
Vk
Vk
Vk
Vk
ix
eT
eT
eT
pR
eT
eT
vC
XT
cf
ZZ
Wc
"}
(7,1,1) = {"
Wc
FF
jb
bs
nV
jK
zq
Ol
AY
Ue
PN
iy
kY
Vk
Vk
Vk
Vk
Vk
XE
OT
wp
ZZ
ZZ
Wc
"}
(8,1,1) = {"
Wc
FF
EJ
WD
Ok
Ni
Ae
ON
LQ
LQ
Bl
gb
Io
Zy
hN
wf
Fc
Zy
gw
OT
zB
ZZ
ZZ
Wc
"}
(9,1,1) = {"
Wc
FF
zj
Ax
ou
LK
AV
RK
CY
CY
CY
xK
kY
Vk
Vk
Vk
Vk
Vk
xR
OT
bK
ZZ
ZZ
Wc
"}
(10,1,1) = {"
Wc
mC
wn
al
Zq
iK
cs
Vk
Vk
Vk
Vk
Vk
ja
RU
RU
RU
Jy
RU
RU
vC
Fj
SY
ZZ
Wc
"}
(11,1,1) = {"
Wc
ZZ
ZZ
ZZ
on
sh
RU
RU
RU
Jy
RU
RU
RU
QY
TT
yo
NW
QI
TT
Jz
ZZ
bG
ZZ
Wc
"}
(12,1,1) = {"
Wc
ZZ
ZZ
ZZ
Zh
HC
wJ
Ve
sF
Ve
em
TT
TT
Jz
Wd
RC
mV
Ya
zX
ZZ
ZZ
iE
ZZ
Wc
"}
(13,1,1) = {"
Wc
ZZ
ZZ
ZZ
ZZ
ZZ
nB
Nn
Nn
Nn
Wy
ZZ
ZZ
ZZ
tg
yA
Pm
Os
Jx
ZZ
ZZ
ZZ
ZZ
Wc
"}
(14,1,1) = {"
Wc
ZZ
ZZ
ZZ
ZZ
ZZ
ZZ
ZZ
ZZ
ZZ
ZZ
ZZ
ZZ
ZZ
ZZ
ZZ
ZZ
ZZ
ZZ
ZZ
ZZ
ZZ
ZZ
Wc
"}
(15,1,1) = {"
Wc
Wc
Wc
Wc
Wc
Wc
Wc
Wc
Wc
Wc
Wc
Wc
Wc
Wc
Wc
Wc
Wc
Wc
Wc
Wc
Wc
Wc
Wc
Wc
"}
