//MAP CONVERTED BY dmm2tgm.py THIS HEADER COMMENT PREVENTS RECONVERSION, DO NOT REMOVE
"al" = (
/turf/closed/wall/indestructible/dropship{
	icon_state = "94"
	},
/area/dropship)
"aE" = (
/turf/closed/wall/indestructible/dropship{
	icon_state = "75"
	},
/area/dropship)
"bG" = (
/turf/closed/wall/indestructible/dropship{
	icon_state = "blue_rearwing_rrb"
	},
/area/dropship)
"bK" = (
/turf/closed/wall/indestructible/dropship{
	icon_state = "13"
	},
/area/dropship)
"cf" = (
/turf/closed/wall/indestructible/dropship{
	icon_state = "blue_rearwing_lb"
	},
/area/dropship)
"cp" = (
/turf/closed/wall/indestructible/dropship{
	icon_state = "34"
	},
/area/dropship)
"cs" = (
/obj/machinery/computer/ship/viewscreen{
	pixel_y = 29
	},
/turf/open/indestructible/dropship{
	icon_state = "rasputin7"
	},
/area/dropship)
"ej" = (
/obj/machinery/computer/ship/helm/console/dropship,
/obj/machinery/camera{
	c_tag = "NSV Sephora - Cockpit";
	network = list("ss13","squad_headcam")
	},
/turf/open/indestructible/dropship{
	icon_state = "rasputin14"
	},
/area/dropship)
"em" = (
/turf/closed/wall/indestructible/dropship{
	icon_state = "64"
	},
/area/dropship)
"eo" = (
/obj/structure/sign/ship/smoking{
	dir = 4
	},
/turf/closed/wall/indestructible/dropship{
	icon_state = "67"
	},
/area/dropship)
"eu" = (
/turf/closed/wall/indestructible/dropship{
	icon_state = "72"
	},
/area/dropship)
"eH" = (
/obj/structure/sign/ship/fire{
	dir = 8;
	name = "FLAMMABLE"
	},
/turf/closed/wall/indestructible/dropship{
	icon_state = "22"
	},
/area/dropship)
"gb" = (
/turf/closed/wall/indestructible/dropship{
	icon_state = "53"
	},
/area/dropship)
"gw" = (
/obj/effect/turf_decal/stripes/line,
/obj/effect/landmark/dropship_entry,
/turf/open/indestructible/dropship{
	icon_state = "rasputin9"
	},
/area/dropship)
"if" = (
/obj/structure/reagent_dispensers/fueltank,
/obj/machinery/door/window{
	dir = 4;
	name = "volatile supplies"
	},
/obj/structure/window/reinforced{
	dir = 1;
	pixel_y = 1
	},
/obj/effect/turf_decal/box,
/turf/open/indestructible/dropship{
	icon_state = "rasputin15"
	},
/area/dropship)
"ix" = (
/turf/open/indestructible/dropship{
	icon_state = "rasputin4"
	},
/area/dropship)
"iy" = (
/obj/structure/lattice/catwalk/over/ship/dark,
/obj/machinery/vending/sustenance,
/turf/open/indestructible/dropship{
	icon_state = "rasputin15"
	},
/area/dropship)
"iE" = (
/turf/closed/wall/indestructible/dropship{
	icon_state = "blue_rearwing_rrrb"
	},
/area/dropship)
"iK" = (
/turf/closed/wall/indestructible/dropship{
	icon_state = "80"
	},
/area/dropship)
"iX" = (
/turf/closed/wall/indestructible/dropship{
	icon_state = "47"
	},
/area/dropship)
"ja" = (
/turf/open/indestructible/dropship{
	icon_state = "rasputin8"
	},
/area/dropship)
"jb" = (
/turf/closed/wall/indestructible/dropship{
	icon_state = "96"
	},
/area/dropship)
"jK" = (
/turf/closed/wall/indestructible/dropship{
	icon_state = "81"
	},
/area/dropship)
"kY" = (
/obj/structure/chair/fancy/dropship{
	dir = 4
	},
/obj/item/radio/intercom/directional/north,
/turf/open/indestructible/dropship{
	icon_state = "rasputin15"
	},
/area/dropship)
"kZ" = (
/turf/closed/wall/indestructible/dropship{
	icon_state = "blue_fl"
	},
/area/dropship)
"mC" = (
/turf/closed/wall/indestructible/dropship{
	icon_state = "blue_fr"
	},
/area/dropship)
"mV" = (
/turf/closed/wall/indestructible/dropship{
	icon_state = "32"
	},
/area/dropship)
"nB" = (
/turf/closed/wall/indestructible/dropship{
	icon_state = "blue_wing_rt"
	},
/area/dropship)
"nV" = (
/obj/structure/chair/fancy/dropship{
	dir = 1
	},
/obj/structure/lattice/catwalk/over/ship/dark,
/obj/machinery/computer/ship/navigation/console{
	density = 0;
	dir = 4;
	pixel_x = -32;
	pixel_y = 32
	},
/obj/machinery/requests_console{
	announcementConsole = 1;
	department = "NSV Sephora Overwatch";
	departmentType = 5;
	name = "NSV Sephora Overwatch RC";
	pixel_y = -32
	},
/turf/open/indestructible/dropship{
	icon_state = "rasputin14"
	},
/area/dropship)
"on" = (
/turf/closed/wall/indestructible/dropship{
	icon_state = "blue_weapon_lr"
	},
/area/dropship)
"ou" = (
/obj/structure/chair/fancy/dropship{
	dir = 1;
	name = "overwatch command centre"
	},
/obj/structure/lattice/catwalk/over/ship/dark,
/obj/machinery/computer/squad_manager{
	density = 0;
	dir = 8;
	icon = 'nsv13/goonstation/icons/obj/computer.dmi';
	pixel_x = 32;
	pixel_y = 32
	},
/obj/machinery/computer/security/telescreen/squadcam{
	pixel_y = -24
	},
/turf/open/indestructible/dropship{
	icon_state = "rasputin14"
	},
/area/dropship)
"pe" = (
/turf/closed/wall/indestructible/dropship{
	icon_state = "blue_rearwing_llb"
	},
/area/dropship)
"px" = (
/obj/structure/sign/ship/securearea{
	dir = 4;
	name = "CAUTION: FASTEN YOUR SEATBELT"
	},
/turf/closed/wall/indestructible/dropship{
	icon_state = "67"
	},
/area/dropship)
"pR" = (
/obj/structure/chair/fancy/dropship{
	dir = 4
	},
/obj/machinery/light{
	dir = 8
	},
/turf/open/indestructible/dropship{
	icon_state = "rasputin15"
	},
/area/dropship)
"rx" = (
/turf/closed/wall/indestructible/dropship{
	icon_state = "blue_weapon_ll"
	},
/area/dropship)
"rH" = (
/obj/machinery/light{
	dir = 8
	},
/obj/machinery/recharge_station,
/obj/effect/turf_decal/stripes/line{
	dir = 4
	},
/turf/open/indestructible/dropship{
	icon_state = "rasputin15"
	},
/area/dropship)
"sh" = (
/obj/structure/sign/ship/plaque/dark{
	name = "NSV Sephora Dedication Plaque";
	pixel_y = -4
	},
/turf/closed/wall/indestructible/dropship{
	icon_state = "81"
	},
/area/dropship)
"sF" = (
/obj/structure/sign/ship/smoking{
	dir = 8
	},
/turf/closed/wall/indestructible/dropship{
	icon_state = "69"
	},
/area/dropship)
"tg" = (
/turf/closed/wall/indestructible/dropship{
	icon_state = "blue_engine_rt"
	},
/area/dropship)
"tD" = (
/obj/machinery/light{
	dir = 4
	},
/obj/machinery/computer/ammo_sorter{
	dir = 8;
	id = "spite_comedy_dropship"
	},
/obj/effect/turf_decal/stripes/line{
	dir = 8
	},
/turf/open/indestructible/dropship{
	icon_state = "rasputin15"
	},
/area/dropship)
"ub" = (
/obj/effect/turf_decal/ship/delivery/yellow,
/obj/structure/chair/fancy/dropship,
/turf/open/indestructible/dropship{
	icon_state = "rasputin15"
	},
/area/dropship)
"vC" = (
/turf/closed/wall/indestructible/dropship{
	icon_state = "10"
	},
/area/dropship)
"wn" = (
/turf/closed/wall/indestructible/dropship{
	icon_state = "blue_cockpit_fr"
	},
/area/dropship)
"wp" = (
/turf/closed/wall/indestructible/dropship{
	icon_state = "11"
	},
/area/dropship)
"wu" = (
/turf/closed/wall/indestructible/dropship{
	icon_state = "28"
	},
/area/dropship)
"wJ" = (
/turf/closed/wall/indestructible/dropship{
	icon_state = "73"
	},
/area/dropship)
"xg" = (
/obj/structure/sign/ship/securearea{
	dir = 4;
	name = "CAUTION: FASTEN YOUR SEATBELT"
	},
/turf/closed/wall/indestructible/dropship{
	icon_state = "18"
	},
/area/dropship)
"xK" = (
/obj/structure/sign/ship/securearea{
	dir = 8;
	name = "CAUTION: FASTEN YOUR SEATBELT"
	},
/turf/closed/wall/indestructible/dropship{
	icon_state = "69"
	},
/area/dropship)
"xR" = (
/obj/effect/turf_decal/stripes/line,
/obj/effect/landmark/dropship_entry,
/turf/open/indestructible/dropship{
	icon_state = "rasputin8"
	},
/area/dropship)
"yh" = (
/turf/closed/wall/indestructible/dropship{
	icon_state = "blue_wing_lt"
	},
/area/dropship)
"yo" = (
/obj/structure/sign/ship/nosmoking{
	dir = 8
	},
/turf/closed/wall/indestructible/dropship{
	icon_state = "19"
	},
/area/dropship)
"yA" = (
/turf/closed/wall/indestructible/dropship{
	icon_state = "39"
	},
/area/dropship)
"yE" = (
/obj/effect/turf_decal/ship/delivery/yellow,
/obj/structure/peacekeeper_barricade/metal/plasteel/deployable,
/obj/structure/peacekeeper_barricade/metal/plasteel/deployable,
/obj/structure/peacekeeper_barricade/metal/plasteel/deployable,
/obj/structure/peacekeeper_barricade/metal/plasteel/deployable,
/obj/structure/peacekeeper_barricade/metal/plasteel/deployable,
/obj/structure/peacekeeper_barricade/metal/plasteel/deployable,
/turf/open/indestructible/dropship{
	icon_state = "rasputin15"
	},
/area/dropship)
"zj" = (
/turf/closed/wall/indestructible/dropship{
	icon_state = "98"
	},
/area/dropship)
"zq" = (
/obj/machinery/vending/wallmed{
	pixel_y = 26
	},
/turf/open/indestructible/dropship{
	icon_state = "rasputin5"
	},
/area/dropship)
"zB" = (
/obj/machinery/telecomms/relay/preset/station{
	alpha = 0
	},
/turf/closed/wall/indestructible/dropship{
	icon_state = "12"
	},
/area/dropship)
"zX" = (
/turf/closed/wall/indestructible/dropship{
	icon_state = "blue_engine_lb"
	},
/area/dropship)
"Ae" = (
/obj/machinery/light,
/turf/open/indestructible/dropship,
/area/dropship)
"Ap" = (
/turf/closed/wall/indestructible/dropship{
	icon_state = "23"
	},
/area/dropship)
"Ax" = (
/obj/machinery/computer/ship/tactical/console,
/turf/open/indestructible/dropship{
	icon_state = "rasputin14"
	},
/area/dropship)
"AV" = (
/turf/open/indestructible/dropship{
	icon_state = "rasputin5"
	},
/area/dropship)
"AY" = (
/obj/structure/lattice/catwalk/over/ship/dark,
/obj/machinery/stasis,
/turf/open/indestructible/dropship{
	icon_state = "rasputin15"
	},
/area/dropship)
"Bl" = (
/turf/closed/wall/indestructible/dropship{
	icon_state = "59"
	},
/area/dropship)
"BM" = (
/obj/machinery/ammo_sorter{
	dir = 8;
	id = "spite_comedy_dropship";
	name = "Dropship Stowage #1"
	},
/obj/effect/turf_decal/stripes/line{
	dir = 8
	},
/turf/open/indestructible/dropship{
	icon_state = "rasputin15"
	},
/area/dropship)
"BU" = (
/obj/structure/sign/ship/nosmoking{
	dir = 4
	},
/turf/closed/wall/indestructible/dropship{
	icon_state = "18"
	},
/area/dropship)
"CL" = (
/obj/machinery/computer/ship/dradis/console{
	dir = 4
	},
/turf/closed/wall/indestructible/dropship{
	icon_state = "86"
	},
/area/dropship)
"CM" = (
/obj/machinery/camera{
	c_tag = "NSV Sephora - Midsection #2";
	dir = 4;
	network = list("ss13","squad_headcam")
	},
/obj/structure/lattice/catwalk/over/ship/dark,
/obj/structure/chair/fancy/dropship{
	dir = 4
	},
/turf/open/indestructible/dropship{
	icon_state = "rasputin15"
	},
/area/dropship)
"CY" = (
/obj/structure/lattice/catwalk/over/ship/dark,
/obj/structure/chair/fancy/dropship{
	dir = 4
	},
/turf/open/indestructible/dropship{
	icon_state = "rasputin15"
	},
/area/dropship)
"Dw" = (
/obj/structure/sign/ship/securearea{
	dir = 8;
	name = "CAUTION: FASTEN YOUR SEATBELT"
	},
/turf/closed/wall/indestructible/dropship{
	icon_state = "19"
	},
/area/dropship)
"DV" = (
/turf/closed/wall/indestructible/dropship{
	icon_state = "blue_rearwing_lllb"
	},
/area/dropship)
"Er" = (
/turf/closed/wall/indestructible/dropship{
	icon_state = "blue_wing_lb"
	},
/area/dropship)
"EJ" = (
/turf/closed/wall/indestructible/dropship{
	icon_state = "97"
	},
/area/dropship)
"Fj" = (
/turf/closed/wall/indestructible/dropship{
	icon_state = "blue_rearwing_rt"
	},
/area/dropship)
"FF" = (
/turf/closed/wall/indestructible/dropship{
	icon_state = "blue_front"
	},
/area/dropship)
"Gu" = (
/turf/closed/wall/indestructible/dropship{
	icon_state = "blue_middle_lc"
	},
/area/dropship)
"GN" = (
/turf/closed/wall/indestructible/dropship{
	icon_state = "35"
	},
/area/dropship)
"Hq" = (
/obj/machinery/conveyor_switch/oneway{
	id = "ihatetheantichrist_dropship_comedy"
	},
/obj/effect/turf_decal/stripes/line{
	dir = 8
	},
/turf/open/indestructible/dropship{
	icon_state = "rasputin15"
	},
/area/dropship)
"Hz" = (
/turf/closed/wall/indestructible/dropship{
	icon_state = "66"
	},
/area/dropship)
"HC" = (
/turf/closed/wall/indestructible/dropship{
	icon_state = "83"
	},
/area/dropship)
"In" = (
/turf/closed/wall/indestructible/dropship{
	icon_state = "62"
	},
/area/dropship)
"Io" = (
/obj/machinery/light{
	dir = 1
	},
/obj/machinery/computer/ship/viewscreen{
	pixel_y = 29
	},
/obj/machinery/holopad,
/turf/open/indestructible/dropship{
	icon_state = "rasputin5"
	},
/area/dropship)
"Ip" = (
/turf/closed/wall/indestructible/dropship{
	icon_state = "18"
	},
/area/dropship)
"IV" = (
/obj/structure/chair/fancy/dropship{
	dir = 4
	},
/turf/open/indestructible/dropship{
	icon_state = "rasputin15"
	},
/area/dropship)
"Jf" = (
/turf/closed/wall/indestructible/dropship{
	icon_state = "78"
	},
/area/dropship)
"Jx" = (
/turf/closed/wall/indestructible/dropship{
	icon_state = "blue_engine_rb"
	},
/area/dropship)
"Jy" = (
/obj/structure/chair/fancy/dropship{
	dir = 8
	},
/obj/machinery/light{
	dir = 4
	},
/turf/open/indestructible/dropship{
	icon_state = "rasputin15"
	},
/area/dropship)
"Jz" = (
/turf/closed/wall/indestructible/dropship{
	icon_state = "blue_middle_rc"
	},
/area/dropship)
"LK" = (
/obj/structure/sign/ship/securearea/alt{
	pixel_y = -3
	},
/turf/closed/wall/indestructible/dropship{
	icon_state = "82"
	},
/area/dropship)
"LM" = (
/turf/closed/wall/indestructible/dropship{
	icon_state = "92"
	},
/area/dropship)
"LQ" = (
/turf/closed/wall/indestructible/dropship{
	icon_state = "56"
	},
/area/dropship)
"Mc" = (
/obj/effect/turf_decal/loading_area,
/turf/open/indestructible/dropship{
	icon_state = "rasputin3"
	},
/area/dropship)
"Ni" = (
/obj/machinery/door/airlock/ship/hatch{
	name = "cockpit";
	req_one_access_txt = "73;19"
	},
/obj/machinery/door/firedoor/border_only,
/obj/machinery/door/firedoor/border_only{
	dir = 1
	},
/turf/open/indestructible/dropship{
	icon_state = "rasputin3"
	},
/area/dropship)
"Nn" = (
/turf/closed/wall/indestructible/dropship{
	icon_state = "70"
	},
/area/dropship)
"No" = (
/obj/structure/lattice/catwalk/over/ship/dark,
/obj/machinery/camera{
	c_tag = "NSV Sephora - Midsection #1";
	dir = 8;
	network = list("ss13","squad_headcam")
	},
/obj/machinery/sleeper{
	dir = 8
	},
/turf/open/indestructible/dropship{
	icon_state = "rasputin15"
	},
/area/dropship)
"NW" = (
/obj/structure/sign/ship/fire{
	dir = 8;
	name = "FLAMMABLE"
	},
/turf/closed/wall/indestructible/dropship{
	icon_state = "31"
	},
/area/dropship)
"Ok" = (
/obj/machinery/holopad,
/turf/open/indestructible/dropship{
	icon_state = "rasputin2"
	},
/area/dropship)
"Ol" = (
/obj/structure/lattice/catwalk/over/ship/dark,
/obj/structure/rack,
/obj/item/storage/box/bodybags,
/obj/item/clothing/mask/surgical,
/obj/item/clothing/suit/apron/surgical,
/turf/open/indestructible/dropship{
	icon_state = "rasputin15"
	},
/area/dropship)
"Os" = (
/obj/structure/sign/ship/fire{
	dir = 4;
	name = "FLAMMABLE"
	},
/turf/closed/wall/indestructible/dropship{
	icon_state = "27"
	},
/area/dropship)
"OA" = (
/obj/structure/closet/firecloset/full,
/obj/effect/turf_decal/ship/delivery/yellow,
/turf/open/indestructible/dropship{
	icon_state = "rasputin15"
	},
/area/dropship)
"ON" = (
/turf/closed/wall/indestructible/dropship{
	icon_state = "68"
	},
/area/dropship)
"OT" = (
/turf/closed/wall/indestructible/dropship/entry,
/area/dropship)
"Pd" = (
/turf/closed/wall/indestructible/dropship{
	icon_state = "29"
	},
/area/dropship)
"Pm" = (
/turf/closed/wall/indestructible/dropship{
	icon_state = "33"
	},
/area/dropship)
"QI" = (
/turf/closed/wall/indestructible/dropship{
	icon_state = "25"
	},
/area/dropship)
"QY" = (
/turf/closed/wall/indestructible/dropship{
	icon_state = "48"
	},
/area/dropship)
"RC" = (
/turf/closed/wall/indestructible/dropship{
	icon_state = "38"
	},
/area/dropship)
"RK" = (
/obj/structure/window/reinforced{
	dir = 1;
	pixel_y = 1
	},
/obj/structure/closet/radiation,
/obj/effect/turf_decal/ship/delivery/yellow,
/turf/open/indestructible/dropship{
	icon_state = "rasputin15"
	},
/area/dropship)
"RU" = (
/obj/structure/chair/fancy/dropship{
	dir = 8
	},
/turf/open/indestructible/dropship{
	icon_state = "rasputin15"
	},
/area/dropship)
"Sa" = (
/turf/closed/wall/indestructible/dropship{
	icon_state = "76"
	},
/area/dropship)
"SP" = (
/turf/closed/wall/indestructible/dropship{
	icon_state = "blue_cockpit_fl"
	},
/area/dropship)
"SY" = (
/turf/closed/wall/indestructible/dropship{
	icon_state = "blue_rearwing_rb"
	},
/area/dropship)
"TT" = (
/turf/closed/wall/indestructible/dropship{
	icon_state = "19"
	},
/area/dropship)
"Ue" = (
/obj/structure/lattice/catwalk/over/ship/dark,
/obj/machinery/sleeper{
	dir = 8
	},
/turf/open/indestructible/dropship{
	icon_state = "rasputin15"
	},
/area/dropship)
"Ul" = (
/obj/structure/sign/ship/shock{
	dir = 4
	},
/turf/closed/wall/indestructible/dropship{
	icon_state = "24"
	},
/area/dropship)
"Uz" = (
/obj/machinery/conveyor{
	dir = 1;
	id = "ihatetheantichrist_dropship_comedy"
	},
/obj/structure/munitions_trolley,
/obj/effect/turf_decal/box,
/turf/open/indestructible/dropship{
	icon_state = "rasputin15"
	},
/area/dropship)
"Vd" = (
/obj/machinery/camera{
	c_tag = "NSV Sephora - Rear Compartment";
	dir = 4;
	network = list("ss13","squad_headcam")
	},
/obj/effect/turf_decal/ship/delivery/yellow,
/obj/structure/closet/emcloset{
	desc = "In the case of unexpected cabin depressurization, air masks will drop from the consoles above your head. Please proceed calmly to the marked exits and exit the plane, leaving bags stowed in the stowage area.";
	name = "in flight safety closet"
	},
/obj/item/tank/internals/emergency_oxygen,
/obj/item/tank/internals/emergency_oxygen,
/obj/item/tank/internals/emergency_oxygen,
/obj/item/tank/internals/emergency_oxygen,
/obj/item/clothing/mask/gas,
/obj/item/clothing/mask/gas,
/obj/item/clothing/mask/gas,
/turf/open/indestructible/dropship{
	icon_state = "rasputin15"
	},
/area/dropship)
"Ve" = (
/turf/closed/wall/indestructible/dropship{
	icon_state = "69"
	},
/area/dropship)
"Vk" = (
/turf/open/indestructible/dropship{
	icon_state = "rasputin3"
	},
/area/dropship)
"Vv" = (
/obj/machinery/computer/ship/viewscreen{
	pixel_y = 29
	},
/turf/open/indestructible/dropship{
	icon_state = "rasputin6"
	},
/area/dropship)
"Wc" = (
/turf/closed/indestructible/cordon{
	alpha = 0
	},
/area/dropship)
"Wd" = (
/turf/closed/wall/indestructible/dropship{
	icon_state = "blue_engine_lt"
	},
/area/dropship)
"We" = (
/turf/closed/wall/indestructible/dropship{
	icon_state = "67"
	},
/area/dropship)
"Wy" = (
/turf/closed/wall/indestructible/dropship{
	icon_state = "blue_wing_rb"
	},
/area/dropship)
"WD" = (
/obj/machinery/light/small{
	dir = 1
	},
/obj/machinery/computer/ship/viewscreen,
/obj/machinery/computer/ship/dradis/console,
/turf/open/indestructible/dropship{
	icon_state = "rasputin14"
	},
/area/dropship)
"WO" = (
/obj/machinery/power/port_gen/pacman,
/obj/item/stack/sheet/mineral/plasma/five,
/obj/effect/turf_decal/stripes/line{
	dir = 4
	},
/turf/open/indestructible/dropship{
	icon_state = "rasputin15"
	},
/area/dropship)
"Xh" = (
/obj/structure/sign/ship/fire{
	dir = 4;
	name = "FLAMMABLE"
	},
/turf/closed/wall/indestructible/dropship{
	icon_state = "30"
	},
/area/dropship)
"XE" = (
/obj/effect/turf_decal/stripes/line,
/obj/effect/landmark/dropship_entry,
/turf/open/indestructible/dropship{
	icon_state = "rasputin4"
	},
/area/dropship)
"XT" = (
/turf/closed/wall/indestructible/dropship{
	icon_state = "blue_rearwing_lt"
	},
/area/dropship)
"Ya" = (
/turf/closed/wall/indestructible/dropship{
	icon_state = "26"
	},
/area/dropship)
"Zh" = (
/turf/closed/wall/indestructible/dropship{
	icon_state = "blue_weapon_rr"
	},
/area/dropship)
"Zq" = (
/obj/machinery/computer/ship/salvage/console{
	dir = 8
	},
/turf/closed/wall/indestructible/dropship{
	icon_state = "89"
	},
/area/dropship)
"Zy" = (
/obj/effect/turf_decal/ship/delivery/yellow,
/obj/effect/landmark/trader_drop_point,
/turf/open/indestructible/dropship{
	icon_state = "rasputin15"
	},
/area/dropship)
"ZZ" = (
/turf/open/space/transit/north,
/area/dropship)

(1,1,1) = {"
Wc
Wc
Wc
Wc
Wc
Wc
Wc
Wc
Wc
Wc
Wc
Wc
Wc
Wc
Wc
Wc
Wc
Wc
Wc
Wc
Wc
Wc
Wc
Wc
"}
(2,1,1) = {"
Wc
ZZ
ZZ
ZZ
ZZ
ZZ
ZZ
ZZ
ZZ
ZZ
ZZ
ZZ
ZZ
ZZ
ZZ
ZZ
ZZ
ZZ
ZZ
ZZ
ZZ
ZZ
ZZ
Wc
"}
(3,1,1) = {"
Wc
ZZ
ZZ
ZZ
ZZ
ZZ
yh
Hz
Hz
Hz
Er
ZZ
ZZ
ZZ
Wd
cp
wu
eH
zX
ZZ
ZZ
ZZ
ZZ
Wc
"}
(4,1,1) = {"
Wc
ZZ
ZZ
ZZ
rx
aE
eu
We
eo
px
In
Ip
Ip
Gu
tg
GN
Pd
Ap
Jx
ZZ
ZZ
DV
ZZ
Wc
"}
(5,1,1) = {"
Wc
ZZ
ZZ
ZZ
on
Sa
kY
IV
IV
pR
IV
IV
IV
iX
xg
BU
Xh
Ul
Ip
Gu
ZZ
pe
ZZ
Wc
"}
(6,1,1) = {"
Wc
kZ
SP
LM
CL
Jf
Vv
Vk
Vk
Vk
Vk
Vk
ix
RK
OA
Vd
rH
WO
if
vC
XT
cf
ZZ
Wc
"}
(7,1,1) = {"
Wc
FF
jb
ej
nV
jK
zq
Ol
AY
No
Ue
iy
AV
Mc
Vk
Vk
Vk
Vk
XE
OT
wp
ZZ
ZZ
Wc
"}
(8,1,1) = {"
Wc
FF
EJ
WD
Ok
Ni
Ae
ON
LQ
LQ
Bl
gb
Io
Zy
Zy
Zy
Zy
Zy
gw
OT
zB
ZZ
ZZ
Wc
"}
(9,1,1) = {"
Wc
FF
zj
Ax
ou
LK
AV
CY
CY
CM
CY
CY
AV
Mc
Vk
Vk
Vk
Vk
xR
OT
bK
ZZ
ZZ
Wc
"}
(10,1,1) = {"
Wc
mC
wn
al
Zq
iK
cs
Vk
Vk
Vk
Vk
Vk
ja
yE
ub
Hq
tD
BM
Uz
vC
Fj
SY
ZZ
Wc
"}
(11,1,1) = {"
Wc
ZZ
ZZ
ZZ
on
sh
RU
RU
RU
Jy
RU
RU
RU
QY
Dw
yo
NW
QI
TT
Jz
ZZ
bG
ZZ
Wc
"}
(12,1,1) = {"
Wc
ZZ
ZZ
ZZ
Zh
HC
wJ
Ve
sF
xK
em
TT
TT
Jz
Wd
RC
mV
Ya
zX
ZZ
ZZ
iE
ZZ
Wc
"}
(13,1,1) = {"
Wc
ZZ
ZZ
ZZ
ZZ
ZZ
nB
Nn
Nn
Nn
Wy
ZZ
ZZ
ZZ
tg
yA
Pm
Os
Jx
ZZ
ZZ
ZZ
ZZ
Wc
"}
(14,1,1) = {"
Wc
ZZ
ZZ
ZZ
ZZ
ZZ
ZZ
ZZ
ZZ
ZZ
ZZ
ZZ
ZZ
ZZ
ZZ
ZZ
ZZ
ZZ
ZZ
ZZ
ZZ
ZZ
ZZ
Wc
"}
(15,1,1) = {"
Wc
Wc
Wc
Wc
Wc
Wc
Wc
Wc
Wc
Wc
Wc
Wc
Wc
Wc
Wc
Wc
Wc
Wc
Wc
Wc
Wc
Wc
Wc
Wc
"}
