//MAP CONVERTED BY dmm2tgm.py THIS HEADER COMMENT PREVENTS RECONVERSION, DO NOT REMOVE
"ap" = (
/obj/effect/turf_decal/stripes/line{
	dir = 4
	},
/obj/machinery/ship_weapon/super_gauss_rack,
/obj/effect/turf_decal/stripes/line{
	dir = 8
	},
/turf/open/indestructible/dropship{
	icon_state = "rasputin15"
	},
/area/dropship/generic{
	lighting_colour_bulb = "#FF3232";
	lighting_colour_night = "#FF3232";
	lighting_colour_tube = "#FF3232"
	})
"ax" = (
/turf/open/indestructible/dropship{
	icon_state = "rasputin15"
	},
/area/dropship/generic{
	lighting_colour_bulb = "#FF3232";
	lighting_colour_night = "#FF3232";
	lighting_colour_tube = "#FF3232"
	})
"aB" = (
/turf/closed/wall/indestructible/dropship{
	icon_state = "blue_rearwing_rrrb"
	},
/area/dropship/generic)
"aR" = (
/turf/closed/wall/indestructible/dropship{
	icon_state = "blue_rearwing_llb"
	},
/area/dropship/generic)
"bC" = (
/turf/closed/wall/indestructible/dropship{
	icon_state = "32"
	},
/area/dropship/generic)
"bG" = (
/obj/machinery/airalarm/all_access{
	pixel_y = 24
	},
/turf/open/indestructible/dropship{
	icon_state = "rasputin3"
	},
/area/dropship/generic{
	lighting_colour_bulb = "#FF3232";
	lighting_colour_night = "#FF3232";
	lighting_colour_tube = "#FF3232"
	})
"cD" = (
/turf/closed/wall/indestructible/dropship{
	icon_state = "blue_fl"
	},
/area/dropship/generic)
"dp" = (
/turf/closed/wall/indestructible/dropship{
	icon_state = "23"
	},
/area/dropship/generic)
"dX" = (
/turf/closed/indestructible/cordon{
	alpha = 0
	},
/area/dropship/generic)
"ej" = (
/turf/closed/wall/indestructible/dropship{
	icon_state = "29"
	},
/area/dropship/generic)
"eS" = (
/turf/closed/wall/indestructible/dropship{
	icon_state = "25"
	},
/area/dropship/generic)
"fH" = (
/obj/effect/turf_decal/stripes/line{
	dir = 8
	},
/obj/machinery/ship_weapon/super_gauss_rack,
/obj/effect/turf_decal/stripes/line{
	dir = 4
	},
/turf/open/indestructible/dropship{
	icon_state = "rasputin15"
	},
/area/dropship/generic{
	lighting_colour_bulb = "#FF3232";
	lighting_colour_night = "#FF3232";
	lighting_colour_tube = "#FF3232"
	})
"gq" = (
/turf/closed/wall/indestructible/dropship{
	icon_state = "81"
	},
/area/dropship/generic)
"gQ" = (
/turf/closed/wall/indestructible/dropship{
	icon_state = "80"
	},
/area/dropship/generic)
"hk" = (
/turf/closed/wall/indestructible/dropship{
	icon_state = "97"
	},
/area/dropship/generic)
"hH" = (
/turf/closed/wall/indestructible/dropship{
	icon_state = "35"
	},
/area/dropship/generic)
"iz" = (
/turf/closed/wall/indestructible/dropship{
	icon_state = "blue_middle_rc"
	},
/area/dropship/generic)
"iV" = (
/turf/closed/wall/indestructible/dropship{
	icon_state = "blue_cockpit_fr"
	},
/area/dropship/generic)
"jN" = (
/turf/closed/wall/indestructible/dropship{
	icon_state = "blue_rearwing_rt"
	},
/area/dropship/generic)
"kq" = (
/obj/item/radio/intercom/directional/south,
/turf/open/indestructible/dropship{
	icon_state = "rasputin15"
	},
/area/dropship/generic{
	lighting_colour_bulb = "#FF3232";
	lighting_colour_night = "#FF3232";
	lighting_colour_tube = "#FF3232"
	})
"la" = (
/obj/effect/turf_decal/stripes/line{
	dir = 4
	},
/obj/machinery/light{
	color = "#FF3232";
	dir = 8
	},
/obj/machinery/ship_weapon/super_gauss_rack,
/obj/effect/turf_decal/stripes/line{
	dir = 8
	},
/turf/open/indestructible/dropship{
	icon_state = "rasputin15"
	},
/area/dropship/generic{
	lighting_colour_bulb = "#FF3232";
	lighting_colour_night = "#FF3232";
	lighting_colour_tube = "#FF3232"
	})
"lb" = (
/obj/effect/landmark/trader_drop_point,
/turf/open/indestructible/dropship{
	icon_state = "rasputin15"
	},
/area/dropship/generic{
	lighting_colour_bulb = "#FF3232";
	lighting_colour_night = "#FF3232";
	lighting_colour_tube = "#FF3232"
	})
"nz" = (
/obj/machinery/door/airlock/ship/hatch{
	name = "cockpit";
	req_one_access_txt = "69;72;73"
	},
/obj/structure/lattice/catwalk/over/ship/dark,
/obj/structure/cable/yellow{
	icon_state = "1-2"
	},
/turf/open/indestructible/dropship{
	icon_state = "rasputin15"
	},
/area/dropship/generic)
"ov" = (
/turf/closed/wall/indestructible/dropship{
	icon_state = "47"
	},
/area/dropship/generic)
"qN" = (
/turf/closed/wall/indestructible/dropship{
	icon_state = "blue_rearwing_lb"
	},
/area/dropship/generic)
"rs" = (
/obj/machinery/computer/ship/dradis/console{
	dir = 4;
	pixel_y = 32
	},
/obj/machinery/computer/ship/tactical/read_only/console{
	dir = 4
	},
/turf/closed/wall/indestructible/dropship{
	icon_state = "18"
	},
/area/dropship/generic)
"rV" = (
/turf/closed/wall/indestructible/dropship{
	icon_state = "blue_engine_lb"
	},
/area/dropship/generic)
"st" = (
/turf/open/space/transit/north,
/area/dropship/generic)
"sT" = (
/obj/effect/landmark/dropship_entry,
/turf/open/indestructible/dropship{
	icon_state = "rasputin15"
	},
/area/dropship/generic{
	lighting_colour_bulb = "#FF3232";
	lighting_colour_night = "#FF3232";
	lighting_colour_tube = "#FF3232"
	})
"td" = (
/turf/closed/wall/indestructible/dropship{
	icon_state = "24"
	},
/area/dropship/generic)
"us" = (
/obj/structure/table/reinforced,
/turf/open/indestructible/dropship{
	icon_state = "rasputin15"
	},
/area/dropship/generic{
	lighting_colour_bulb = "#FF3232";
	lighting_colour_night = "#FF3232";
	lighting_colour_tube = "#FF3232"
	})
"uB" = (
/turf/closed/wall/indestructible/dropship{
	icon_state = "blue_engine_rb"
	},
/area/dropship/generic)
"vf" = (
/turf/closed/wall/indestructible/dropship{
	icon_state = "81"
	},
/area/dropship/generic{
	lighting_colour_bulb = "#FF3232";
	lighting_colour_night = "#FF3232";
	lighting_colour_tube = "#FF3232"
	})
"xe" = (
/turf/closed/wall/indestructible/dropship{
	icon_state = "30"
	},
/area/dropship/generic)
"xi" = (
/obj/machinery/computer/ship/viewscreen{
	pixel_y = 29
	},
/turf/open/indestructible/dropship{
	icon_state = "rasputin3"
	},
/area/dropship/generic{
	lighting_colour_bulb = "#FF3232";
	lighting_colour_night = "#FF3232";
	lighting_colour_tube = "#FF3232"
	})
"zk" = (
/turf/closed/wall/indestructible/dropship{
	icon_state = "blue_rearwing_rb"
	},
/area/dropship/generic)
"zC" = (
/turf/closed/wall/indestructible/dropship{
	icon_state = "blue_engine_lt"
	},
/area/dropship/generic)
"Ah" = (
/turf/closed/wall/indestructible/dropship{
	icon_state = "blue_rearwing_lt"
	},
/area/dropship/generic)
"Bv" = (
/turf/closed/wall/indestructible/dropship{
	icon_state = "19"
	},
/area/dropship/generic)
"CH" = (
/obj/structure/chair/fancy/dropship{
	dir = 1
	},
/obj/structure/lattice/catwalk/over/ship/dark,
/obj/structure/cable/yellow{
	icon_state = "2-4"
	},
/turf/open/indestructible/dropship{
	icon_state = "rasputin15"
	},
/area/dropship/generic)
"CN" = (
/turf/closed/wall/indestructible/dropship{
	icon_state = "blue_fr"
	},
/area/dropship/generic)
"Eh" = (
/obj/structure/lattice/catwalk/over/ship/dark,
/obj/machinery/computer/ship/helm/console/gunship,
/turf/open/indestructible/dropship{
	icon_state = "rasputin15"
	},
/area/dropship/generic)
"FD" = (
/obj/machinery/light{
	color = "#FF3232"
	},
/obj/structure/closet/crate,
/turf/open/indestructible/dropship{
	icon_state = "rasputin3"
	},
/area/dropship/generic{
	lighting_colour_bulb = "#FF3232";
	lighting_colour_night = "#FF3232";
	lighting_colour_tube = "#FF3232"
	})
"Hq" = (
/obj/effect/turf_decal/stripes/line{
	dir = 8
	},
/obj/machinery/light{
	color = "#FF3232";
	dir = 4
	},
/obj/machinery/ship_weapon/super_gauss_rack,
/obj/effect/turf_decal/stripes/line{
	dir = 4
	},
/turf/open/indestructible/dropship{
	icon_state = "rasputin15"
	},
/area/dropship/generic{
	lighting_colour_bulb = "#FF3232";
	lighting_colour_night = "#FF3232";
	lighting_colour_tube = "#FF3232"
	})
"Hs" = (
/turf/closed/wall/indestructible/dropship{
	icon_state = "31"
	},
/area/dropship/generic)
"HX" = (
/turf/closed/wall/indestructible/dropship{
	icon_state = "48"
	},
/area/dropship/generic)
"Ic" = (
/obj/structure/sign/ship/fire{
	dir = 4;
	name = "FLAMMABLE"
	},
/turf/closed/wall/indestructible/dropship{
	icon_state = "27"
	},
/area/dropship/generic)
"IM" = (
/turf/closed/wall/indestructible/dropship{
	icon_state = "28"
	},
/area/dropship/generic)
"JB" = (
/turf/closed/wall/indestructible/dropship{
	icon_state = "blue_rear_lc"
	},
/area/dropship/generic)
"JG" = (
/turf/closed/wall/indestructible/dropship{
	icon_state = "blue_engine_rt"
	},
/area/dropship/generic)
"Kx" = (
/turf/closed/wall/indestructible/dropship{
	icon_state = "33"
	},
/area/dropship/generic)
"KF" = (
/obj/structure/table/reinforced,
/obj/machinery/light{
	color = "#FF3232"
	},
/turf/open/indestructible/dropship{
	icon_state = "rasputin3"
	},
/area/dropship/generic{
	lighting_colour_bulb = "#FF3232";
	lighting_colour_night = "#FF3232";
	lighting_colour_tube = "#FF3232"
	})
"KI" = (
/turf/closed/wall/indestructible/dropship{
	icon_state = "blue_middle_lc"
	},
/area/dropship/generic)
"KJ" = (
/turf/closed/wall/indestructible/dropship{
	icon_state = "blue_rearwing_rrb"
	},
/area/dropship/generic)
"Lf" = (
/obj/machinery/computer/ship/navigation/console{
	dir = 8
	},
/obj/machinery/computer/monitor/console{
	dir = 8;
	pixel_y = 32
	},
/obj/structure/cable/yellow{
	icon_state = "0-8"
	},
/turf/closed/wall/indestructible/dropship{
	icon_state = "19"
	},
/area/dropship/generic)
"Mh" = (
/turf/closed/wall/indestructible/dropship{
	icon_state = "78"
	},
/area/dropship/generic)
"NI" = (
/turf/closed/wall/indestructible/dropship{
	icon_state = "18"
	},
/area/dropship/generic)
"OK" = (
/turf/closed/wall/indestructible/dropship{
	icon_state = "39"
	},
/area/dropship/generic)
"OQ" = (
/turf/closed/wall/indestructible/dropship{
	icon_state = "26"
	},
/area/dropship/generic)
"Pe" = (
/turf/closed/wall/indestructible/dropship{
	icon_state = "34"
	},
/area/dropship/generic)
"Tr" = (
/turf/closed/wall/indestructible/dropship{
	icon_state = "10"
	},
/area/dropship/generic)
"TN" = (
/obj/structure/sign/ship/fire{
	dir = 8;
	name = "FLAMMABLE"
	},
/turf/closed/wall/indestructible/dropship{
	icon_state = "22"
	},
/area/dropship/generic)
"Uw" = (
/turf/closed/wall/indestructible/dropship/entry{
	icon_state = "57"
	},
/area/dropship/generic)
"UZ" = (
/turf/closed/wall/indestructible/dropship{
	icon_state = "38"
	},
/area/dropship/generic)
"Vr" = (
/turf/closed/wall/indestructible/dropship{
	icon_state = "blue_front"
	},
/area/dropship/generic)
"Xq" = (
/turf/closed/wall/indestructible/dropship{
	icon_state = "blue_rearwing_lllb"
	},
/area/dropship/generic)
"XA" = (
/obj/effect/turf_decal/ship/delivery/yellow,
/obj/machinery/gauss_dispenser/super,
/turf/open/indestructible/dropship{
	icon_state = "rasputin15"
	},
/area/dropship/generic{
	lighting_colour_bulb = "#FF3232";
	lighting_colour_night = "#FF3232";
	lighting_colour_tube = "#FF3232"
	})
"XY" = (
/turf/open/indestructible/dropship{
	icon_state = "rasputin3"
	},
/area/dropship/generic{
	lighting_colour_bulb = "#FF3232";
	lighting_colour_night = "#FF3232";
	lighting_colour_tube = "#FF3232"
	})
"ZS" = (
/turf/closed/wall/indestructible/dropship{
	icon_state = "blue_cockpit_fl"
	},
/area/dropship/generic)

(1,1,1) = {"
dX
dX
dX
dX
dX
dX
dX
dX
dX
dX
dX
dX
dX
dX
dX
dX
dX
dX
dX
"}
(2,1,1) = {"
dX
st
st
st
st
st
st
st
st
st
st
st
st
st
st
st
st
st
dX
"}
(3,1,1) = {"
dX
st
st
st
st
st
st
st
st
Xq
st
st
st
st
st
st
st
st
dX
"}
(4,1,1) = {"
dX
st
st
st
st
st
st
st
st
aR
JB
st
st
st
st
st
st
st
dX
"}
(5,1,1) = {"
dX
st
st
st
st
st
st
zC
Pe
IM
TN
rV
st
st
st
st
st
st
dX
"}
(6,1,1) = {"
dX
st
st
st
st
st
st
JG
hH
ej
dp
uB
st
st
st
st
st
st
dX
"}
(7,1,1) = {"
dX
st
st
st
st
st
cD
ZS
NI
xe
td
NI
Uw
KI
st
st
Xq
st
dX
"}
(8,1,1) = {"
dX
st
st
st
st
cD
ZS
Mh
ap
la
ap
vf
sT
ov
KI
st
aR
st
dX
"}
(9,1,1) = {"
dX
st
st
cD
ZS
NI
rs
gq
bG
XY
XY
XY
XY
KF
Tr
Ah
qN
st
dX
"}
(10,1,1) = {"
dX
st
st
Vr
hk
Eh
CH
nz
kq
vf
XA
ax
lb
us
hk
st
st
st
dX
"}
(11,1,1) = {"
dX
st
st
CN
iV
Bv
Lf
gQ
xi
XY
XY
XY
XY
FD
Tr
jN
zk
st
dX
"}
(12,1,1) = {"
dX
st
st
st
st
CN
iV
gQ
fH
Hq
fH
vf
sT
HX
iz
st
KJ
st
dX
"}
(13,1,1) = {"
dX
st
st
st
st
st
CN
iV
Bv
Hs
eS
Bv
Uw
iz
st
st
aB
st
dX
"}
(14,1,1) = {"
dX
st
st
st
st
st
st
zC
UZ
bC
OQ
rV
st
st
st
st
st
st
dX
"}
(15,1,1) = {"
dX
st
st
st
st
st
st
JG
OK
Kx
Ic
uB
st
st
st
st
st
st
dX
"}
(16,1,1) = {"
dX
st
st
st
st
st
st
st
st
KJ
iz
st
st
st
st
st
st
st
dX
"}
(17,1,1) = {"
dX
st
st
st
st
st
st
st
st
aB
st
st
st
st
st
st
st
st
dX
"}
(18,1,1) = {"
dX
st
st
st
st
st
st
st
st
st
st
st
st
st
st
st
st
st
dX
"}
(19,1,1) = {"
dX
dX
dX
dX
dX
dX
dX
dX
dX
dX
dX
dX
dX
dX
dX
dX
dX
dX
dX
"}
