//MAP CONVERTED BY dmm2tgm.py THIS HEADER COMMENT PREVENTS RECONVERSION, DO NOT REMOVE
"aa" = (
/turf/closed/wall/indestructible/dropship{
	icon_state = "39"
	},
/area/dropship/generic)
"ba" = (
/turf/closed/wall/indestructible/dropship{
	icon_state = "81"
	},
/area/dropship/generic)
"bn" = (
/turf/closed/wall/indestructible/dropship{
	icon_state = "blue_engine_lt"
	},
/area/dropship/generic)
"dn" = (
/turf/closed/wall/indestructible/dropship{
	icon_state = "80"
	},
/area/dropship/generic)
"dO" = (
/turf/closed/wall/indestructible/dropship{
	icon_state = "blue_middle_lc"
	},
/area/dropship/generic)
"eZ" = (
/obj/structure/cable/yellow{
	icon_state = "0-8"
	},
/obj/machinery/computer/monitor{
	dir = 8
	},
/obj/machinery/airalarm/all_access{
	dir = 8;
	pixel_x = 20
	},
/obj/machinery/light{
	color = "#FF3232";
	dir = 1
	},
/turf/open/indestructible/dropship{
	icon_state = "rasputin15"
	},
/area/dropship/generic{
	lighting_colour_bulb = "#FF3232";
	lighting_colour_night = "#FF3232";
	lighting_colour_tube = "#FF3232"
	})
"fF" = (
/turf/closed/wall/indestructible/dropship{
	icon_state = "32"
	},
/area/dropship/generic)
"hs" = (
/turf/closed/wall/indestructible/dropship{
	icon_state = "blue_rearwing_llb"
	},
/area/dropship/generic)
"ht" = (
/obj/effect/turf_decal/stripes/line{
	dir = 8
	},
/turf/open/indestructible/dropship{
	icon_state = "rasputin15"
	},
/area/dropship/generic{
	lighting_colour_bulb = "#FF3232";
	lighting_colour_night = "#FF3232";
	lighting_colour_tube = "#FF3232"
	})
"hv" = (
/turf/closed/wall/indestructible/dropship{
	icon_state = "blue_rear_lc"
	},
/area/dropship/generic)
"hx" = (
/obj/structure/cable/yellow{
	icon_state = "0-9"
	},
/obj/structure/cable/yellow{
	icon_state = "4-9"
	},
/obj/machinery/power/smes,
/obj/effect/turf_decal/stripes/line{
	dir = 1
	},
/turf/open/indestructible/dropship{
	icon_state = "rasputin3"
	},
/area/dropship/generic{
	lighting_colour_bulb = "#FF3232";
	lighting_colour_night = "#FF3232";
	lighting_colour_tube = "#FF3232"
	})
"ij" = (
/obj/machinery/power/terminal,
/obj/structure/cable{
	icon_state = "0-4"
	},
/turf/open/indestructible/dropship{
	icon_state = "rasputin3"
	},
/area/dropship/generic{
	lighting_colour_bulb = "#FF3232";
	lighting_colour_night = "#FF3232";
	lighting_colour_tube = "#FF3232"
	})
"iq" = (
/turf/closed/wall/indestructible/dropship{
	icon_state = "24"
	},
/area/dropship/generic)
"iy" = (
/turf/closed/wall/indestructible/dropship{
	icon_state = "78"
	},
/area/dropship/generic)
"jI" = (
/obj/machinery/door/airlock/ship/hatch{
	name = "cockpit";
	req_one_access_txt = "69;72;73"
	},
/obj/structure/lattice/catwalk/over/ship/dark,
/obj/structure/cable/yellow{
	icon_state = "1-2"
	},
/turf/open/indestructible/dropship{
	icon_state = "rasputin15"
	},
/area/dropship/generic)
"lS" = (
/obj/item/radio/intercom/directional/east,
/obj/structure/rack,
/obj/structure/window/reinforced{
	dir = 1;
	pixel_y = 1
	},
/obj/item/ship_weapon/ammunition/railgun_ammo{
	pixel_y = 5
	},
/obj/item/ship_weapon/ammunition/railgun_ammo,
/obj/item/ship_weapon/ammunition/railgun_ammo{
	pixel_y = -5
	},
/obj/item/ship_weapon/ammunition/railgun_ammo{
	pixel_y = 5
	},
/obj/item/ship_weapon/ammunition/railgun_ammo,
/obj/item/ship_weapon/ammunition/railgun_ammo{
	pixel_y = -5
	},
/obj/item/ship_weapon/ammunition/railgun_ammo{
	pixel_y = 5
	},
/obj/item/ship_weapon/ammunition/railgun_ammo,
/obj/item/ship_weapon/ammunition/railgun_ammo{
	pixel_y = -5
	},
/turf/open/indestructible/dropship{
	icon_state = "rasputin15"
	},
/area/dropship/generic{
	lighting_colour_bulb = "#FF3232";
	lighting_colour_night = "#FF3232";
	lighting_colour_tube = "#FF3232"
	})
"mS" = (
/obj/machinery/power/port_gen/pacman{
	anchored = 1
	},
/obj/structure/cable,
/obj/effect/turf_decal/stripes/line{
	dir = 1
	},
/turf/open/indestructible/dropship{
	icon_state = "rasputin3"
	},
/area/dropship/generic{
	lighting_colour_bulb = "#FF3232";
	lighting_colour_night = "#FF3232";
	lighting_colour_tube = "#FF3232"
	})
"nJ" = (
/obj/machinery/computer/ship/navigation/console{
	dir = 8
	},
/obj/machinery/computer/monitor/console{
	dir = 8;
	pixel_y = 32
	},
/obj/structure/cable/yellow{
	icon_state = "0-8"
	},
/turf/closed/wall/indestructible/dropship{
	icon_state = "19"
	},
/area/dropship/generic)
"pv" = (
/turf/closed/wall/indestructible/dropship{
	icon_state = "blue_rearwing_rrrb"
	},
/area/dropship/generic)
"qf" = (
/turf/closed/wall/indestructible/dropship{
	icon_state = "blue_engine_lb"
	},
/area/dropship/generic)
"qj" = (
/obj/structure/cable{
	icon_state = "2-8"
	},
/turf/open/indestructible/dropship{
	icon_state = "rasputin3"
	},
/area/dropship/generic{
	lighting_colour_bulb = "#FF3232";
	lighting_colour_night = "#FF3232";
	lighting_colour_tube = "#FF3232"
	})
"qU" = (
/turf/closed/wall/indestructible/dropship{
	icon_state = "blue_fr"
	},
/area/dropship/generic)
"rJ" = (
/turf/closed/wall/indestructible/dropship{
	icon_state = "25"
	},
/area/dropship/generic)
"rW" = (
/turf/closed/wall/indestructible/dropship{
	icon_state = "38"
	},
/area/dropship/generic)
"um" = (
/turf/closed/wall/indestructible/dropship{
	icon_state = "97"
	},
/area/dropship/generic)
"uq" = (
/turf/closed/wall/indestructible/dropship{
	icon_state = "blue_middle_rc"
	},
/area/dropship/generic)
"vH" = (
/obj/structure/cable/yellow{
	icon_state = "1-6"
	},
/obj/effect/landmark/dropship_entry,
/turf/open/indestructible/dropship{
	icon_state = "rasputin15"
	},
/area/dropship/generic{
	lighting_colour_bulb = "#FF3232";
	lighting_colour_night = "#FF3232";
	lighting_colour_tube = "#FF3232"
	})
"wX" = (
/turf/closed/wall/indestructible/dropship{
	icon_state = "23"
	},
/area/dropship/generic)
"xg" = (
/obj/structure/cable/yellow{
	icon_state = "2-4"
	},
/turf/open/indestructible/dropship{
	icon_state = "rasputin15"
	},
/area/dropship/generic{
	lighting_colour_bulb = "#FF3232";
	lighting_colour_night = "#FF3232";
	lighting_colour_tube = "#FF3232"
	})
"yO" = (
/turf/closed/wall/indestructible/dropship{
	icon_state = "47"
	},
/area/dropship/generic)
"za" = (
/turf/closed/wall/indestructible/dropship{
	icon_state = "blue_rearwing_rb"
	},
/area/dropship/generic)
"zu" = (
/obj/effect/turf_decal/stripes/line{
	dir = 4
	},
/turf/open/indestructible/dropship{
	icon_state = "rasputin3"
	},
/area/dropship/generic{
	lighting_colour_bulb = "#FF3232";
	lighting_colour_night = "#FF3232";
	lighting_colour_tube = "#FF3232"
	})
"Ad" = (
/obj/structure/sign/ship/fire{
	dir = 8;
	name = "FLAMMABLE"
	},
/turf/closed/wall/indestructible/dropship{
	icon_state = "22"
	},
/area/dropship/generic)
"AJ" = (
/obj/effect/turf_decal/stripes/line,
/obj/structure/cable/yellow{
	icon_state = "1-2"
	},
/obj/structure/cable/yellow,
/obj/machinery/ship_weapon/hybrid_rail{
	bound_height = 128;
	bound_width = 64;
	dir = 1;
	pixel_x = -8;
	pixel_y = 6
	},
/turf/open/indestructible/dropship{
	icon_state = "rasputin15"
	},
/area/dropship/generic{
	lighting_colour_bulb = "#FF3232";
	lighting_colour_night = "#FF3232";
	lighting_colour_tube = "#FF3232"
	})
"Ba" = (
/turf/closed/wall/indestructible/dropship{
	icon_state = "blue_engine_rb"
	},
/area/dropship/generic)
"Bt" = (
/obj/structure/cable/yellow{
	icon_state = "4-8"
	},
/obj/effect/turf_decal/stripes/line{
	dir = 4
	},
/obj/machinery/computer/ship/viewscreen{
	pixel_y = 29
	},
/turf/open/indestructible/dropship{
	icon_state = "rasputin3"
	},
/area/dropship/generic{
	lighting_colour_bulb = "#FF3232";
	lighting_colour_night = "#FF3232";
	lighting_colour_tube = "#FF3232"
	})
"DQ" = (
/obj/machinery/power/terminal,
/obj/structure/cable{
	icon_state = "0-4"
	},
/obj/structure/cable{
	icon_state = "4-8"
	},
/obj/effect/landmark/trader_drop_point,
/turf/open/indestructible/dropship{
	icon_state = "rasputin15"
	},
/area/dropship/generic{
	lighting_colour_bulb = "#FF3232";
	lighting_colour_night = "#FF3232";
	lighting_colour_tube = "#FF3232"
	})
"El" = (
/turf/closed/wall/indestructible/dropship{
	icon_state = "blue_cockpit_fl"
	},
/area/dropship/generic)
"EK" = (
/turf/closed/wall/indestructible/dropship{
	icon_state = "10"
	},
/area/dropship/generic)
"FD" = (
/obj/machinery/computer/ship/dradis/console{
	dir = 4;
	pixel_y = 32
	},
/obj/machinery/computer/ship/tactical/read_only/console{
	dir = 4
	},
/turf/closed/wall/indestructible/dropship{
	icon_state = "18"
	},
/area/dropship/generic)
"Gd" = (
/turf/closed/wall/indestructible/dropship{
	icon_state = "31"
	},
/area/dropship/generic)
"Ge" = (
/turf/closed/wall/indestructible/dropship{
	icon_state = "29"
	},
/area/dropship/generic)
"Gj" = (
/turf/closed/wall/indestructible/dropship{
	icon_state = "blue_rearwing_lb"
	},
/area/dropship/generic)
"Gp" = (
/turf/closed/wall/indestructible/dropship{
	icon_state = "blue_rearwing_lllb"
	},
/area/dropship/generic)
"Gz" = (
/turf/closed/wall/indestructible/dropship{
	icon_state = "blue_rearwing_rrb"
	},
/area/dropship/generic)
"GA" = (
/turf/closed/indestructible/cordon{
	alpha = 0
	},
/area/dropship/generic)
"Iu" = (
/obj/structure/cable/yellow{
	icon_state = "4-8"
	},
/turf/open/indestructible/dropship{
	icon_state = "rasputin3"
	},
/area/dropship/generic{
	lighting_colour_bulb = "#FF3232";
	lighting_colour_night = "#FF3232";
	lighting_colour_tube = "#FF3232"
	})
"Iz" = (
/turf/closed/wall/indestructible/dropship{
	icon_state = "blue_rearwing_rt"
	},
/area/dropship/generic)
"IJ" = (
/turf/closed/wall/indestructible/dropship{
	icon_state = "28"
	},
/area/dropship/generic)
"IU" = (
/obj/effect/turf_decal/stripes/line{
	dir = 8
	},
/obj/effect/turf_decal/ship/delivery/yellow,
/turf/open/indestructible/dropship{
	icon_state = "rasputin15"
	},
/area/dropship/generic{
	lighting_colour_bulb = "#FF3232";
	lighting_colour_night = "#FF3232";
	lighting_colour_tube = "#FF3232"
	})
"Jc" = (
/turf/open/space/transit/north,
/area/dropship/generic)
"Jv" = (
/obj/effect/turf_decal/stripes/line,
/turf/open/indestructible/dropship{
	icon_state = "rasputin3"
	},
/area/dropship/generic{
	lighting_colour_bulb = "#FF3232";
	lighting_colour_night = "#FF3232";
	lighting_colour_tube = "#FF3232"
	})
"JB" = (
/obj/structure/lattice/catwalk/over/ship/dark,
/obj/machinery/computer/ship/helm/console/gunship,
/turf/open/indestructible/dropship{
	icon_state = "rasputin15"
	},
/area/dropship/generic)
"JO" = (
/obj/structure/sign/ship/fire{
	dir = 4;
	name = "FLAMMABLE"
	},
/turf/closed/wall/indestructible/dropship{
	icon_state = "27"
	},
/area/dropship/generic)
"JQ" = (
/turf/closed/wall/indestructible/dropship{
	icon_state = "blue_fl"
	},
/area/dropship/generic)
"KN" = (
/obj/machinery/power/smes,
/obj/structure/cable/yellow{
	icon_state = "0-8"
	},
/obj/effect/turf_decal/stripes/line{
	dir = 1
	},
/turf/open/indestructible/dropship{
	icon_state = "rasputin15"
	},
/area/dropship/generic{
	lighting_colour_bulb = "#FF3232";
	lighting_colour_night = "#FF3232";
	lighting_colour_tube = "#FF3232"
	})
"KV" = (
/obj/structure/sign/ship/securearea{
	dir = 4;
	name = "CAUTION: EAR PROTECTION MANDATORY"
	},
/turf/closed/wall/indestructible/dropship{
	icon_state = "18"
	},
/area/dropship/generic)
"Lq" = (
/obj/structure/rack,
/obj/structure/window/reinforced,
/obj/item/ship_weapon/ammunition/railgun_ammo,
/obj/item/ship_weapon/ammunition/railgun_ammo{
	pixel_y = 5
	},
/obj/item/ship_weapon/ammunition/railgun_ammo{
	pixel_y = -5
	},
/obj/item/ship_weapon/ammunition/railgun_ammo{
	pixel_y = 5
	},
/obj/item/ship_weapon/ammunition/railgun_ammo{
	pixel_y = 5
	},
/obj/item/ship_weapon/ammunition/railgun_ammo,
/obj/item/ship_weapon/ammunition/railgun_ammo,
/obj/item/ship_weapon/ammunition/railgun_ammo{
	pixel_y = -5
	},
/obj/item/ship_weapon/ammunition/railgun_ammo{
	pixel_y = -5
	},
/turf/open/indestructible/dropship{
	icon_state = "rasputin15"
	},
/area/dropship/generic{
	lighting_colour_bulb = "#FF3232";
	lighting_colour_night = "#FF3232";
	lighting_colour_tube = "#FF3232"
	})
"LA" = (
/turf/closed/wall/indestructible/dropship{
	icon_state = "18"
	},
/area/dropship/generic)
"LM" = (
/obj/machinery/light{
	color = "#FF3232"
	},
/obj/effect/landmark/dropship_entry,
/turf/open/indestructible/dropship{
	icon_state = "rasputin15"
	},
/area/dropship/generic{
	lighting_colour_bulb = "#FF3232";
	lighting_colour_night = "#FF3232";
	lighting_colour_tube = "#FF3232"
	})
"MY" = (
/obj/structure/cable/yellow{
	icon_state = "1-2"
	},
/turf/open/indestructible/dropship{
	icon_state = "rasputin15"
	},
/area/dropship/generic{
	lighting_colour_bulb = "#FF3232";
	lighting_colour_night = "#FF3232";
	lighting_colour_tube = "#FF3232"
	})
"Os" = (
/obj/effect/turf_decal/stripes/line{
	dir = 8
	},
/obj/machinery/holopad,
/turf/open/indestructible/dropship{
	icon_state = "rasputin15"
	},
/area/dropship/generic{
	lighting_colour_bulb = "#FF3232";
	lighting_colour_night = "#FF3232";
	lighting_colour_tube = "#FF3232"
	})
"OB" = (
/turf/closed/wall/indestructible/dropship{
	icon_state = "30"
	},
/area/dropship/generic)
"OK" = (
/turf/closed/wall/indestructible/dropship{
	icon_state = "blue_front"
	},
/area/dropship/generic)
"PM" = (
/turf/closed/wall/indestructible/dropship{
	icon_state = "blue_cockpit_fr"
	},
/area/dropship/generic)
"QJ" = (
/turf/closed/wall/indestructible/dropship{
	icon_state = "33"
	},
/area/dropship/generic)
"Rd" = (
/turf/closed/wall/indestructible/dropship{
	icon_state = "35"
	},
/area/dropship/generic)
"RT" = (
/turf/closed/wall/indestructible/dropship{
	icon_state = "19"
	},
/area/dropship/generic)
"Sa" = (
/obj/structure/cable/yellow{
	icon_state = "4-8"
	},
/obj/structure/cable/yellow{
	icon_state = "1-8"
	},
/obj/effect/turf_decal/stripes/line{
	dir = 8
	},
/turf/open/indestructible/dropship{
	icon_state = "rasputin15"
	},
/area/dropship/generic{
	lighting_colour_bulb = "#FF3232";
	lighting_colour_night = "#FF3232";
	lighting_colour_tube = "#FF3232"
	})
"SZ" = (
/turf/closed/wall/indestructible/dropship{
	icon_state = "26"
	},
/area/dropship/generic)
"TB" = (
/turf/closed/wall/indestructible/dropship{
	icon_state = "34"
	},
/area/dropship/generic)
"VJ" = (
/turf/closed/wall/indestructible/dropship/entry{
	icon_state = "57"
	},
/area/dropship/generic)
"VX" = (
/obj/structure/chair/fancy/dropship{
	dir = 1
	},
/obj/structure/lattice/catwalk/over/ship/dark,
/obj/structure/cable/yellow{
	icon_state = "2-4"
	},
/obj/item/radio/intercom/overmap{
	pixel_x = -32;
	pixel_y = 12
	},
/turf/open/indestructible/dropship{
	icon_state = "rasputin15"
	},
/area/dropship/generic)
"Wa" = (
/turf/closed/wall/indestructible/dropship{
	icon_state = "blue_rearwing_lt"
	},
/area/dropship/generic)
"Wy" = (
/turf/closed/wall/indestructible/dropship{
	icon_state = "48"
	},
/area/dropship/generic)
"Yo" = (
/obj/effect/turf_decal/stripes/line,
/obj/item/stack/sheet/mineral/plasma/five,
/obj/structure/table/reinforced,
/obj/item/clothing/ears/earmuffs,
/obj/structure/window/reinforced,
/obj/structure/window/reinforced{
	dir = 1;
	pixel_y = 1
	},
/turf/open/indestructible/dropship{
	icon_state = "rasputin15"
	},
/area/dropship/generic{
	lighting_colour_bulb = "#FF3232";
	lighting_colour_night = "#FF3232";
	lighting_colour_tube = "#FF3232"
	})
"YK" = (
/turf/open/indestructible/dropship{
	icon_state = "rasputin3"
	},
/area/dropship/generic{
	lighting_colour_bulb = "#FF3232";
	lighting_colour_night = "#FF3232";
	lighting_colour_tube = "#FF3232"
	})
"ZV" = (
/turf/closed/wall/indestructible/dropship{
	icon_state = "blue_engine_rt"
	},
/area/dropship/generic)

(1,1,1) = {"
GA
GA
GA
GA
GA
GA
GA
GA
GA
GA
GA
GA
GA
GA
GA
GA
GA
GA
GA
"}
(2,1,1) = {"
GA
Jc
Jc
Jc
Jc
Jc
Jc
Jc
Jc
Jc
Jc
Jc
Jc
Jc
Jc
Jc
Jc
Jc
GA
"}
(3,1,1) = {"
GA
Jc
Jc
Jc
Jc
Jc
Jc
Jc
Jc
Gp
Jc
Jc
Jc
Jc
Jc
Jc
Jc
Jc
GA
"}
(4,1,1) = {"
GA
Jc
Jc
Jc
Jc
Jc
Jc
Jc
Jc
hs
hv
Jc
Jc
Jc
Jc
Jc
Jc
Jc
GA
"}
(5,1,1) = {"
GA
Jc
Jc
Jc
Jc
Jc
Jc
bn
TB
IJ
Ad
qf
Jc
Jc
Jc
Jc
Jc
Jc
GA
"}
(6,1,1) = {"
GA
Jc
Jc
Jc
Jc
Jc
Jc
ZV
Rd
Ge
wX
Ba
Jc
Jc
Jc
Jc
Jc
Jc
GA
"}
(7,1,1) = {"
GA
Jc
Jc
Jc
Jc
Jc
JQ
El
KV
OB
iq
KV
VJ
dO
Jc
Jc
Gp
Jc
GA
"}
(8,1,1) = {"
GA
Jc
Jc
Jc
Jc
JQ
El
iy
xg
MY
MY
AJ
vH
yO
dO
Jc
hs
Jc
GA
"}
(9,1,1) = {"
GA
Jc
Jc
JQ
El
LA
FD
ba
Iu
YK
YK
Jv
ij
hx
EK
Wa
Gj
Jc
GA
"}
(10,1,1) = {"
GA
Jc
Jc
OK
um
JB
VX
jI
Sa
IU
Os
ht
DQ
KN
um
Jc
Jc
Jc
GA
"}
(11,1,1) = {"
GA
Jc
Jc
qU
PM
RT
nJ
dn
Bt
zu
zu
zu
qj
mS
EK
Iz
za
Jc
GA
"}
(12,1,1) = {"
GA
Jc
Jc
Jc
Jc
qU
PM
dn
eZ
lS
Lq
Yo
LM
Wy
uq
Jc
Gz
Jc
GA
"}
(13,1,1) = {"
GA
Jc
Jc
Jc
Jc
Jc
qU
PM
RT
Gd
rJ
RT
VJ
uq
Jc
Jc
pv
Jc
GA
"}
(14,1,1) = {"
GA
Jc
Jc
Jc
Jc
Jc
Jc
bn
rW
fF
SZ
qf
Jc
Jc
Jc
Jc
Jc
Jc
GA
"}
(15,1,1) = {"
GA
Jc
Jc
Jc
Jc
Jc
Jc
ZV
aa
QJ
JO
Ba
Jc
Jc
Jc
Jc
Jc
Jc
GA
"}
(16,1,1) = {"
GA
Jc
Jc
Jc
Jc
Jc
Jc
Jc
Jc
Gz
uq
Jc
Jc
Jc
Jc
Jc
Jc
Jc
GA
"}
(17,1,1) = {"
GA
Jc
Jc
Jc
Jc
Jc
Jc
Jc
Jc
pv
Jc
Jc
Jc
Jc
Jc
Jc
Jc
Jc
GA
"}
(18,1,1) = {"
GA
Jc
Jc
Jc
Jc
Jc
Jc
Jc
Jc
Jc
Jc
Jc
Jc
Jc
Jc
Jc
Jc
Jc
GA
"}
(19,1,1) = {"
GA
GA
GA
GA
GA
GA
GA
GA
GA
GA
GA
GA
GA
GA
GA
GA
GA
GA
GA
"}
