//MAP CONVERTED BY dmm2tgm.py THIS HEADER COMMENT PREVENTS RECONVERSION, DO NOT REMOVE
"al" = (
/turf/closed/wall/indestructible/dropship{
	icon_state = "94"
	},
/area/dropship/generic)
"aE" = (
/turf/closed/wall/indestructible/dropship{
	icon_state = "75"
	},
/area/dropship/generic)
"bG" = (
/turf/closed/wall/indestructible/dropship{
	icon_state = "blue_rearwing_rrb"
	},
/area/dropship/generic)
"bK" = (
/turf/closed/wall/indestructible/dropship{
	icon_state = "13"
	},
/area/dropship/generic)
"bL" = (
/obj/structure/lattice/catwalk/over/ship,
/turf/open/indestructible/dropship{
	icon_state = "rasputin15"
	},
/area/dropship/generic)
"cf" = (
/turf/closed/wall/indestructible/dropship{
	icon_state = "blue_rearwing_lb"
	},
/area/dropship/generic)
"cp" = (
/turf/closed/wall/indestructible/dropship{
	icon_state = "34"
	},
/area/dropship/generic)
"cr" = (
/obj/effect/turf_decal/stripes/line{
	dir = 4
	},
/obj/machinery/conveyor_switch{
	id = "ihatetheantichrist_dropship_comedy_gunship";
	name = "VLS"
	},
/turf/open/indestructible/dropship{
	icon_state = "rasputin15"
	},
/area/dropship/generic)
"cs" = (
/obj/machinery/computer/ship/viewscreen{
	pixel_y = 29
	},
/obj/effect/turf_decal/stripes/line{
	dir = 4
	},
/obj/machinery/computer/ship/munitions_computer{
	icon = 'icons/obj/computer.dmi';
	icon_state = "computer"
	},
/turf/open/indestructible/dropship{
	icon_state = "rasputin15"
	},
/area/dropship/generic)
"cL" = (
/obj/structure/chair/fancy/dropship,
/obj/effect/turf_decal/stripes/line{
	dir = 8
	},
/turf/open/indestructible/dropship{
	icon_state = "rasputin15"
	},
/area/dropship/generic)
"cP" = (
/obj/structure/chair/fancy/dropship,
/obj/effect/turf_decal/stripes/line{
	dir = 4
	},
/turf/open/indestructible/dropship{
	icon_state = "rasputin15"
	},
/area/dropship/generic)
"ej" = (
/obj/machinery/computer/ship/helm/console/dropship,
/obj/machinery/camera{
	c_tag = "NSV Sephora - Cockpit";
	network = list("ss13","squad_headcam")
	},
/turf/open/indestructible/dropship{
	icon_state = "rasputin14"
	},
/area/dropship/generic)
"eo" = (
/turf/closed/wall/indestructible/dropship{
	icon_state = "67";
	opacity = 0
	},
/area/dropship/generic)
"eu" = (
/obj/structure/sign/ship/smoking{
	dir = 4
	},
/turf/closed/wall/indestructible/dropship{
	icon_state = "72";
	opacity = 0
	},
/area/dropship/generic)
"eH" = (
/obj/structure/sign/ship/fire{
	dir = 8;
	name = "FLAMMABLE"
	},
/turf/closed/wall/indestructible/dropship{
	icon_state = "22"
	},
/area/dropship/generic)
"eS" = (
/obj/effect/turf_decal/ship/delivery/yellow,
/obj/structure/rack,
/obj/item/clothing/ears/earmuffs,
/obj/item/clothing/ears/earmuffs,
/obj/item/clothing/ears/earmuffs,
/obj/item/clothing/ears/earmuffs,
/obj/item/clothing/ears/earmuffs,
/turf/open/indestructible/dropship{
	icon_state = "rasputin15"
	},
/area/dropship/generic)
"eU" = (
/turf/closed/wall/indestructible/dropship{
	icon_state = "blue_wing_rb"
	},
/area/dropship/generic)
"fR" = (
/obj/structure/chair/fancy/dropship{
	dir = 1
	},
/obj/effect/turf_decal/stripes/line{
	dir = 4
	},
/turf/open/indestructible/dropship{
	icon_state = "rasputin15"
	},
/area/dropship/generic)
"gb" = (
/obj/machinery/computer/ams,
/turf/open/indestructible/dropship{
	icon_state = "rasputin15"
	},
/area/dropship/generic)
"gw" = (
/obj/effect/turf_decal/stripes/line,
/obj/effect/landmark/dropship_entry,
/turf/open/indestructible/dropship{
	icon_state = "rasputin9"
	},
/area/dropship/generic)
"ix" = (
/obj/effect/turf_decal/stripes/line{
	dir = 8
	},
/turf/open/indestructible/dropship{
	icon_state = "rasputin15"
	},
/area/dropship/generic)
"iy" = (
/obj/effect/turf_decal/stripes/line{
	dir = 8
	},
/obj/machinery/conveyor_switch{
	id = "ihatetheantichrist_dropship_comedy_gunship";
	name = "VLS"
	},
/turf/open/indestructible/dropship{
	icon_state = "rasputin15"
	},
/area/dropship/generic)
"iE" = (
/turf/closed/wall/indestructible/dropship{
	icon_state = "blue_rearwing_rrrb"
	},
/area/dropship/generic)
"iK" = (
/turf/closed/wall/indestructible/dropship{
	icon_state = "80"
	},
/area/dropship/generic)
"iX" = (
/turf/closed/wall/indestructible/dropship{
	icon_state = "47"
	},
/area/dropship/generic)
"ja" = (
/obj/effect/turf_decal/stripes/line{
	dir = 4
	},
/turf/open/indestructible/dropship{
	icon_state = "rasputin15"
	},
/area/dropship/generic)
"jb" = (
/turf/closed/wall/indestructible/dropship{
	icon_state = "96"
	},
/area/dropship/generic)
"jK" = (
/turf/closed/wall/indestructible/dropship{
	icon_state = "81"
	},
/area/dropship/generic)
"kY" = (
/obj/item/radio/intercom/directional/north,
/obj/structure/lattice/catwalk/over/ship,
/obj/structure/reagent_dispensers/fueltank,
/obj/structure/window/reinforced,
/obj/machinery/door/window{
	dir = 4;
	name = "volatile supplies"
	},
/turf/open/indestructible/dropship{
	icon_state = "rasputin15"
	},
/area/dropship/generic)
"kZ" = (
/turf/closed/wall/indestructible/dropship{
	icon_state = "blue_fl"
	},
/area/dropship/generic)
"lu" = (
/obj/machinery/camera{
	c_tag = "NSV Sephora - Midsection #2";
	dir = 4;
	network = list("ss13","squad_headcam")
	},
/obj/structure/lattice/catwalk/over/ship,
/obj/structure/rack,
/obj/item/ammo_box/magazine/nsv/pdc,
/obj/item/ammo_box/magazine/nsv/pdc,
/obj/item/ammo_box/magazine/nsv/pdc,
/obj/item/ammo_box/magazine/nsv/pdc,
/obj/item/clothing/ears/earmuffs,
/obj/item/clothing/ears/earmuffs,
/obj/item/clothing/ears/earmuffs,
/obj/item/clothing/ears/earmuffs,
/obj/item/multitool,
/obj/item/radio/intercom/directional/west,
/turf/open/indestructible/dropship{
	icon_state = "rasputin15"
	},
/area/dropship/generic)
"me" = (
/turf/open/indestructible/dropship{
	icon_state = "rasputin8"
	},
/area/dropship/generic)
"mC" = (
/turf/closed/wall/indestructible/dropship{
	icon_state = "blue_fr"
	},
/area/dropship/generic)
"mV" = (
/turf/closed/wall/indestructible/dropship{
	icon_state = "32"
	},
/area/dropship/generic)
"nB" = (
/turf/closed/wall/indestructible/dropship{
	icon_state = "blue_wing_rt"
	},
/area/dropship/generic)
"nV" = (
/obj/structure/chair/fancy/dropship{
	dir = 1
	},
/obj/structure/lattice/catwalk/over/ship/dark,
/obj/machinery/computer/ship/navigation/console{
	density = 0;
	dir = 4;
	pixel_x = -32;
	pixel_y = 32
	},
/turf/open/indestructible/dropship{
	icon_state = "rasputin14"
	},
/area/dropship/generic)
"oj" = (
/obj/effect/turf_decal/stripes/line{
	dir = 8
	},
/obj/machinery/computer/ship/munitions_computer{
	dir = 1;
	icon = 'icons/obj/computer.dmi';
	icon_state = "computer"
	},
/turf/open/indestructible/dropship{
	icon_state = "rasputin15"
	},
/area/dropship/generic)
"on" = (
/turf/closed/wall/indestructible/dropship{
	icon_state = "blue_weapon_lr"
	},
/area/dropship/generic)
"ou" = (
/obj/structure/chair/fancy/dropship{
	dir = 1;
	name = "overwatch command centre"
	},
/obj/structure/lattice/catwalk/over/ship/dark,
/obj/machinery/computer/squad_manager{
	density = 0;
	dir = 8;
	icon = 'nsv13/goonstation/icons/obj/computer.dmi';
	pixel_x = 32;
	pixel_y = 32
	},
/turf/open/indestructible/dropship{
	icon_state = "rasputin14"
	},
/area/dropship/generic)
"oT" = (
/obj/structure/lattice/catwalk/over/ship,
/obj/machinery/ship_weapon/pdc_mount/east,
/turf/open/indestructible/dropship{
	icon_state = "rasputin15"
	},
/area/dropship/generic)
"pe" = (
/turf/closed/wall/indestructible/dropship{
	icon_state = "blue_rearwing_llb"
	},
/area/dropship/generic)
"px" = (
/turf/closed/wall/indestructible/dropship{
	icon_state = "62"
	},
/area/dropship/generic)
"pR" = (
/obj/machinery/light{
	dir = 8
	},
/obj/structure/lattice/catwalk/over/ship,
/obj/machinery/ship_weapon/pdc_mount/west,
/turf/open/indestructible/dropship{
	icon_state = "rasputin15"
	},
/area/dropship/generic)
"rx" = (
/turf/closed/wall/indestructible/dropship{
	icon_state = "blue_weapon_ll"
	},
/area/dropship/generic)
"rH" = (
/obj/machinery/light{
	dir = 8
	},
/obj/machinery/computer/ship/munitions_computer{
	icon = 'icons/obj/computer.dmi';
	icon_state = "computer"
	},
/turf/open/indestructible/dropship{
	icon_state = "rasputin15"
	},
/area/dropship/generic)
"sh" = (
/obj/structure/sign/ship/plaque/dark{
	pixel_y = -4
	},
/turf/closed/wall/indestructible/dropship{
	icon_state = "81"
	},
/area/dropship/generic)
"sF" = (
/obj/structure/sign/ship/smoking{
	dir = 8
	},
/turf/closed/wall/indestructible/dropship{
	icon_state = "69";
	opacity = 0
	},
/area/dropship/generic)
"sG" = (
/obj/machinery/conveyor_switch/oneway{
	id = "ihatetheantichrist_dropship_comedy_gunship_2";
	name = "Ammo loader"
	},
/turf/open/indestructible/dropship{
	icon_state = "rasputin3"
	},
/area/dropship/generic)
"tg" = (
/turf/closed/wall/indestructible/dropship{
	icon_state = "blue_engine_rt"
	},
/area/dropship/generic)
"tD" = (
/obj/machinery/light{
	dir = 4
	},
/obj/machinery/computer/ship/munitions_computer{
	icon = 'icons/obj/computer.dmi';
	icon_state = "computer"
	},
/turf/open/indestructible/dropship{
	icon_state = "rasputin15"
	},
/area/dropship/generic)
"vC" = (
/turf/closed/wall/indestructible/dropship{
	icon_state = "10"
	},
/area/dropship/generic)
"wn" = (
/turf/closed/wall/indestructible/dropship{
	icon_state = "blue_cockpit_fr"
	},
/area/dropship/generic)
"wp" = (
/turf/closed/wall/indestructible/dropship{
	icon_state = "11"
	},
/area/dropship/generic)
"wu" = (
/turf/closed/wall/indestructible/dropship{
	icon_state = "28"
	},
/area/dropship/generic)
"wJ" = (
/turf/closed/wall/indestructible/dropship{
	icon_state = "73";
	opacity = 0
	},
/area/dropship/generic)
"xg" = (
/obj/structure/sign/ship/securearea{
	dir = 4;
	name = "CAUTION: EAR PROTECTION MANDATORY"
	},
/turf/closed/wall/indestructible/dropship{
	icon_state = "18"
	},
/area/dropship/generic)
"xK" = (
/turf/closed/wall/indestructible/dropship{
	icon_state = "64"
	},
/area/dropship/generic)
"xR" = (
/obj/effect/turf_decal/stripes/line,
/obj/effect/landmark/dropship_entry,
/turf/open/indestructible/dropship{
	icon_state = "rasputin8"
	},
/area/dropship/generic)
"yh" = (
/turf/closed/wall/indestructible/dropship{
	icon_state = "blue_wing_lt"
	},
/area/dropship/generic)
"yo" = (
/obj/structure/sign/ship/nosmoking{
	dir = 8
	},
/turf/closed/wall/indestructible/dropship{
	icon_state = "19"
	},
/area/dropship/generic)
"yA" = (
/turf/closed/wall/indestructible/dropship{
	icon_state = "39"
	},
/area/dropship/generic)
"yI" = (
/obj/machinery/computer/ammo_sorter{
	id = "spite_comedy_dropship_gunship"
	},
/obj/effect/turf_decal/box,
/turf/open/indestructible/dropship{
	icon_state = "rasputin15"
	},
/area/dropship/generic)
"zj" = (
/turf/closed/wall/indestructible/dropship{
	icon_state = "98"
	},
/area/dropship/generic)
"zq" = (
/obj/machinery/gauss_dispenser,
/turf/open/indestructible/dropship{
	icon_state = "rasputin6"
	},
/area/dropship/generic)
"zB" = (
/obj/machinery/telecomms/relay/preset/station{
	alpha = 0
	},
/turf/closed/wall/indestructible/dropship{
	icon_state = "12"
	},
/area/dropship/generic)
"zX" = (
/turf/closed/wall/indestructible/dropship{
	icon_state = "blue_engine_lb"
	},
/area/dropship/generic)
"Ae" = (
/turf/open/indestructible/dropship,
/area/dropship/generic)
"Ap" = (
/turf/closed/wall/indestructible/dropship{
	icon_state = "23"
	},
/area/dropship/generic)
"Ax" = (
/obj/machinery/computer/ship/tactical/console,
/turf/open/indestructible/dropship{
	icon_state = "rasputin14"
	},
/area/dropship/generic)
"AN" = (
/obj/structure/lattice/catwalk/over/ship,
/obj/machinery/ship_weapon/gauss_gun/west,
/turf/open/indestructible/dropship{
	icon_state = "rasputin15"
	},
/area/dropship/generic)
"AV" = (
/obj/machinery/gauss_dispenser,
/turf/open/indestructible/dropship{
	icon_state = "rasputin7"
	},
/area/dropship/generic)
"BH" = (
/obj/machinery/ammo_sorter{
	dir = 1;
	id = "spite_comedy_dropship_gunship";
	name = "Dropship Stowage #1"
	},
/obj/item/ship_weapon/ammunition/torpedo,
/obj/item/ship_weapon/ammunition/torpedo,
/obj/item/ship_weapon/ammunition/torpedo,
/obj/item/ship_weapon/ammunition/missile,
/obj/item/ship_weapon/ammunition/missile,
/obj/item/ship_weapon/ammunition/missile,
/obj/item/ship_weapon/ammunition/missile,
/turf/open/indestructible/dropship{
	icon_state = "rasputin15"
	},
/area/dropship/generic)
"BU" = (
/obj/structure/sign/ship/nosmoking{
	dir = 4
	},
/turf/closed/wall/indestructible/dropship{
	icon_state = "18"
	},
/area/dropship/generic)
"CL" = (
/obj/machinery/computer/ship/dradis/console{
	dir = 4
	},
/turf/closed/wall/indestructible/dropship{
	icon_state = "86"
	},
/area/dropship/generic)
"Dw" = (
/obj/structure/sign/ship/securearea{
	dir = 8;
	name = "CAUTION: EAR PROTECTION MANDATORY"
	},
/turf/closed/wall/indestructible/dropship{
	icon_state = "19"
	},
/area/dropship/generic)
"DV" = (
/turf/closed/wall/indestructible/dropship{
	icon_state = "blue_rearwing_lllb"
	},
/area/dropship/generic)
"EJ" = (
/turf/closed/wall/indestructible/dropship{
	icon_state = "97"
	},
/area/dropship/generic)
"Fj" = (
/turf/closed/wall/indestructible/dropship{
	icon_state = "blue_rearwing_rt"
	},
/area/dropship/generic)
"FF" = (
/turf/closed/wall/indestructible/dropship{
	icon_state = "blue_front"
	},
/area/dropship/generic)
"Gu" = (
/turf/closed/wall/indestructible/dropship{
	icon_state = "blue_middle_lc"
	},
/area/dropship/generic)
"GN" = (
/turf/closed/wall/indestructible/dropship{
	icon_state = "35"
	},
/area/dropship/generic)
"Hq" = (
/obj/effect/turf_decal/loading_area{
	dir = 1
	},
/obj/machinery/ship_weapon/torpedo_launcher/north{
	bound_height = 96;
	bound_width = 32;
	pixel_x = -18;
	pixel_y = -50
	},
/turf/open/indestructible/dropship{
	icon_state = "rasputin15"
	},
/area/dropship/generic)
"Hz" = (
/turf/closed/wall/indestructible/dropship{
	icon_state = "66"
	},
/area/dropship/generic)
"HC" = (
/turf/closed/wall/indestructible/dropship{
	icon_state = "83"
	},
/area/dropship/generic)
"Io" = (
/obj/machinery/holopad,
/turf/open/indestructible/dropship{
	icon_state = "rasputin5"
	},
/area/dropship/generic)
"IV" = (
/obj/structure/lattice/catwalk/over/ship,
/obj/machinery/ship_weapon/pdc_mount/west,
/turf/open/indestructible/dropship{
	icon_state = "rasputin15"
	},
/area/dropship/generic)
"Jf" = (
/turf/closed/wall/indestructible/dropship{
	icon_state = "78"
	},
/area/dropship/generic)
"Jx" = (
/turf/closed/wall/indestructible/dropship{
	icon_state = "blue_engine_rb"
	},
/area/dropship/generic)
"Jy" = (
/obj/machinery/light{
	dir = 4
	},
/obj/structure/lattice/catwalk/over/ship,
/obj/machinery/ship_weapon/pdc_mount/east,
/turf/open/indestructible/dropship{
	icon_state = "rasputin15"
	},
/area/dropship/generic)
"Jz" = (
/turf/closed/wall/indestructible/dropship{
	icon_state = "blue_middle_rc"
	},
/area/dropship/generic)
"Kl" = (
/turf/closed/wall/indestructible/dropship{
	icon_state = "19"
	},
/area/dropship/generic)
"LK" = (
/turf/closed/wall/indestructible/dropship{
	icon_state = "82"
	},
/area/dropship/generic)
"LM" = (
/turf/closed/wall/indestructible/dropship{
	icon_state = "92"
	},
/area/dropship/generic)
"LQ" = (
/obj/machinery/ship_weapon/vls,
/obj/machinery/conveyor{
	id = "ihatetheantichrist_dropship_comedy_gunship"
	},
/turf/open/indestructible/dropship{
	icon_state = "rasputin15"
	},
/area/dropship/generic)
"Mc" = (
/obj/effect/turf_decal/loading_area,
/obj/machinery/door/firedoor/border_only{
	dir = 1
	},
/turf/open/indestructible/dropship{
	icon_state = "rasputin3"
	},
/area/dropship/generic)
"MB" = (
/obj/machinery/vending/wallmed{
	products = list(/obj/item/reagent_containers/syringe = 3, /obj/item/stack/medical/gauze = 3, /obj/item/reagent_containers/food/drinks/bottle/vodka = 3, /obj/item/reagent_containers/medspray/sterilizine = 3)
	},
/turf/closed/wall/indestructible/dropship{
	icon_state = "18"
	},
/area/dropship/generic)
"MJ" = (
/obj/effect/turf_decal/stripes/line{
	dir = 4
	},
/obj/machinery/computer/ship/munitions_computer{
	dir = 1;
	icon = 'icons/obj/computer.dmi';
	icon_state = "computer"
	},
/turf/open/indestructible/dropship{
	icon_state = "rasputin15"
	},
/area/dropship/generic)
"Ni" = (
/obj/machinery/door/airlock/ship/hatch{
	name = "cockpit";
	req_one_access_txt = "69;72;73"
	},
/obj/machinery/door/firedoor/border_only,
/obj/machinery/door/firedoor/border_only{
	dir = 1
	},
/turf/open/indestructible/dropship{
	icon_state = "rasputin3"
	},
/area/dropship/generic)
"Nn" = (
/turf/closed/wall/indestructible/dropship{
	icon_state = "70"
	},
/area/dropship/generic)
"NW" = (
/obj/structure/sign/ship/fire{
	dir = 8;
	name = "FLAMMABLE"
	},
/turf/closed/wall/indestructible/dropship{
	icon_state = "31"
	},
/area/dropship/generic)
"Ok" = (
/obj/machinery/holopad,
/turf/open/indestructible/dropship{
	icon_state = "rasputin2"
	},
/area/dropship/generic)
"Os" = (
/obj/structure/sign/ship/fire{
	dir = 4;
	name = "FLAMMABLE"
	},
/turf/closed/wall/indestructible/dropship{
	icon_state = "27"
	},
/area/dropship/generic)
"OA" = (
/turf/open/indestructible/dropship{
	icon_state = "rasputin15"
	},
/area/dropship/generic)
"OF" = (
/obj/structure/lattice/catwalk/over/ship,
/obj/machinery/ship_weapon/gauss_gun/east,
/turf/open/indestructible/dropship{
	icon_state = "rasputin15"
	},
/area/dropship/generic)
"ON" = (
/obj/machinery/conveyor{
	id = "ihatetheantichrist_dropship_comedy_gunship"
	},
/obj/machinery/ship_weapon/vls,
/turf/open/indestructible/dropship{
	icon_state = "rasputin15"
	},
/area/dropship/generic)
"OT" = (
/turf/closed/wall/indestructible/dropship/entry,
/area/dropship/generic)
"Pd" = (
/turf/closed/wall/indestructible/dropship{
	icon_state = "29"
	},
/area/dropship/generic)
"Pm" = (
/turf/closed/wall/indestructible/dropship{
	icon_state = "33"
	},
/area/dropship/generic)
"QI" = (
/turf/closed/wall/indestructible/dropship{
	icon_state = "25"
	},
/area/dropship/generic)
"QY" = (
/turf/closed/wall/indestructible/dropship{
	icon_state = "48"
	},
/area/dropship/generic)
"Rr" = (
/obj/effect/turf_decal/ship/delivery/yellow,
/obj/machinery/conveyor{
	dir = 1;
	id = "ihatetheantichrist_dropship_comedy_gunship_2"
	},
/turf/open/indestructible/dropship{
	icon_state = "rasputin15"
	},
/area/dropship/generic)
"RC" = (
/turf/closed/wall/indestructible/dropship{
	icon_state = "38"
	},
/area/dropship/generic)
"RK" = (
/obj/structure/window/reinforced{
	dir = 1;
	pixel_y = 1
	},
/obj/machinery/door/firedoor/border_only{
	dir = 1
	},
/turf/open/indestructible/dropship{
	icon_state = "rasputin15"
	},
/area/dropship/generic)
"RU" = (
/obj/structure/lattice/catwalk/over/ship,
/obj/machinery/vending/cigarette,
/turf/open/indestructible/dropship{
	icon_state = "rasputin15"
	},
/area/dropship/generic)
"Sa" = (
/turf/closed/wall/indestructible/dropship{
	icon_state = "76"
	},
/area/dropship/generic)
"Sb" = (
/obj/machinery/conveyor{
	dir = 1;
	id = "ihatetheantichrist_dropship_comedy_gunship_2"
	},
/turf/open/indestructible/dropship{
	icon_state = "rasputin15"
	},
/area/dropship/generic)
"Ss" = (
/obj/machinery/camera{
	c_tag = "NSV Sephora - Midsection #1";
	dir = 8;
	network = list("ss13","squad_headcam")
	},
/obj/structure/lattice/catwalk/over/ship,
/obj/structure/rack,
/obj/item/ammo_box/magazine/nsv/pdc,
/obj/item/ammo_box/magazine/nsv/pdc,
/obj/item/ammo_box/magazine/nsv/pdc,
/obj/item/ammo_box/magazine/nsv/pdc,
/obj/item/clothing/ears/earmuffs,
/obj/item/clothing/ears/earmuffs,
/obj/item/clothing/ears/earmuffs,
/obj/item/clothing/ears/earmuffs,
/turf/open/indestructible/dropship{
	icon_state = "rasputin15"
	},
/area/dropship/generic)
"SP" = (
/turf/closed/wall/indestructible/dropship{
	icon_state = "blue_cockpit_fl"
	},
/area/dropship/generic)
"SY" = (
/turf/closed/wall/indestructible/dropship{
	icon_state = "blue_rearwing_rb"
	},
/area/dropship/generic)
"TT" = (
/obj/effect/turf_decal/ship/delivery/yellow,
/obj/machinery/door/firedoor/border_only{
	dir = 4
	},
/obj/machinery/door/firedoor/border_only{
	dir = 8
	},
/obj/structure/fans/tiny,
/turf/open/indestructible/dropship{
	icon_state = "rasputin15"
	},
/area/dropship/generic)
"Ue" = (
/turf/open/indestructible/dropship{
	icon_state = "rasputin3"
	},
/area/dropship/generic)
"Ul" = (
/obj/structure/sign/ship/shock{
	dir = 4
	},
/turf/closed/wall/indestructible/dropship{
	icon_state = "24"
	},
/area/dropship/generic)
"Uq" = (
/turf/closed/wall/indestructible/dropship{
	icon_state = "blue_wing_lb"
	},
/area/dropship/generic)
"Vd" = (
/obj/machinery/camera{
	c_tag = "NSV Sephora - Rear Compartment";
	dir = 4;
	network = list("ss13","squad_headcam")
	},
/obj/effect/turf_decal/loading_area{
	dir = 1
	},
/obj/machinery/ship_weapon/torpedo_launcher/north{
	bound_height = 96;
	bound_width = 32;
	pixel_x = -18;
	pixel_y = -50
	},
/turf/open/indestructible/dropship{
	icon_state = "rasputin15"
	},
/area/dropship/generic)
"Ve" = (
/turf/closed/wall/indestructible/dropship{
	icon_state = "69"
	},
/area/dropship/generic)
"Vj" = (
/turf/open/indestructible/dropship{
	icon_state = "rasputin4"
	},
/area/dropship/generic)
"Vk" = (
/obj/structure/chair/fancy/dropship{
	dir = 1
	},
/obj/effect/turf_decal/stripes/line{
	dir = 8
	},
/turf/open/indestructible/dropship{
	icon_state = "rasputin15"
	},
/area/dropship/generic)
"Vv" = (
/obj/machinery/computer/ship/viewscreen{
	pixel_y = 29
	},
/obj/effect/turf_decal/stripes/line{
	dir = 8
	},
/obj/machinery/computer/ship/munitions_computer{
	icon = 'icons/obj/computer.dmi';
	icon_state = "computer"
	},
/turf/open/indestructible/dropship{
	icon_state = "rasputin15"
	},
/area/dropship/generic)
"Wc" = (
/turf/closed/indestructible/cordon{
	alpha = 0
	},
/area/space/instanced)
"Wd" = (
/turf/closed/wall/indestructible/dropship{
	icon_state = "blue_engine_lt"
	},
/area/dropship/generic)
"We" = (
/turf/closed/wall/indestructible/dropship{
	icon_state = "67"
	},
/area/dropship/generic)
"Wy" = (
/turf/closed/indestructible/cordon{
	alpha = 0
	},
/area/dropship/generic)
"WD" = (
/obj/machinery/light/small{
	dir = 1
	},
/obj/machinery/computer/ship/viewscreen,
/obj/machinery/computer/ship/dradis/console,
/turf/open/indestructible/dropship{
	icon_state = "rasputin14"
	},
/area/dropship/generic)
"WO" = (
/obj/effect/turf_decal/ship/delivery/yellow,
/obj/effect/landmark/trader_drop_point,
/turf/open/indestructible/dropship{
	icon_state = "rasputin15"
	},
/area/dropship/generic)
"Xh" = (
/obj/structure/sign/ship/fire{
	dir = 4;
	name = "FLAMMABLE"
	},
/turf/closed/wall/indestructible/dropship{
	icon_state = "30"
	},
/area/dropship/generic)
"XE" = (
/obj/effect/turf_decal/stripes/line,
/obj/effect/landmark/dropship_entry,
/turf/open/indestructible/dropship{
	icon_state = "rasputin4"
	},
/area/dropship/generic)
"XT" = (
/turf/closed/wall/indestructible/dropship{
	icon_state = "blue_rearwing_lt"
	},
/area/dropship/generic)
"Ya" = (
/turf/closed/wall/indestructible/dropship{
	icon_state = "26"
	},
/area/dropship/generic)
"Zh" = (
/turf/closed/wall/indestructible/dropship{
	icon_state = "blue_weapon_rr"
	},
/area/dropship/generic)
"Zq" = (
/obj/machinery/computer/ship/salvage/console{
	dir = 8
	},
/turf/closed/wall/indestructible/dropship{
	icon_state = "89"
	},
/area/dropship/generic)
"Zy" = (
/obj/structure/munitions_trolley,
/obj/effect/turf_decal/box,
/obj/machinery/door/firedoor/border_only{
	dir = 1
	},
/turf/open/indestructible/dropship{
	icon_state = "rasputin15"
	},
/area/dropship/generic)
"ZZ" = (
/turf/open/space/transit/north,
/area/space/instanced)

(1,1,1) = {"
Wc
Wc
Wc
Wc
Wc
Wc
Wc
Wc
Wc
Wc
Wc
Wc
Wc
Wc
Wc
Wc
Wc
Wc
Wc
Wc
Wc
Wc
Wc
Wc
"}
(2,1,1) = {"
Wc
ZZ
ZZ
ZZ
ZZ
ZZ
ZZ
ZZ
ZZ
ZZ
ZZ
ZZ
ZZ
ZZ
ZZ
ZZ
ZZ
ZZ
ZZ
ZZ
ZZ
ZZ
ZZ
Wc
"}
(3,1,1) = {"
Wc
ZZ
ZZ
ZZ
ZZ
ZZ
yh
Hz
Hz
Uq
Wy
Wy
Wy
Wy
Wd
cp
wu
eH
zX
ZZ
ZZ
ZZ
ZZ
Wc
"}
(4,1,1) = {"
Wc
ZZ
ZZ
ZZ
rx
aE
eu
We
eo
px
TT
TT
TT
Gu
tg
GN
Pd
Ap
Jx
ZZ
ZZ
DV
ZZ
Wc
"}
(5,1,1) = {"
Wc
ZZ
ZZ
ZZ
on
Sa
kY
IV
lu
pR
bL
AN
bL
iX
xg
BU
Xh
Ul
MB
Gu
ZZ
pe
ZZ
Wc
"}
(6,1,1) = {"
Wc
kZ
SP
LM
CL
Jf
Vv
Vk
iy
cL
oj
ix
ix
RK
OA
Vd
rH
WO
eS
vC
XT
cf
ZZ
Wc
"}
(7,1,1) = {"
Wc
FF
jb
ej
nV
jK
zq
Ue
Ue
Ue
Ue
Ue
Vj
Mc
Ue
sG
Ue
Ue
XE
OT
wp
ZZ
ZZ
Wc
"}
(8,1,1) = {"
Wc
FF
EJ
WD
Ok
Ni
Ae
ON
LQ
ON
LQ
gb
Io
Zy
Sb
BH
Rr
yI
gw
OT
zB
ZZ
ZZ
Wc
"}
(9,1,1) = {"
Wc
FF
zj
Ax
ou
LK
AV
Ue
Ue
Ue
Ue
Ue
me
Mc
Ue
Ue
Ue
Ue
xR
OT
bK
ZZ
ZZ
Wc
"}
(10,1,1) = {"
Wc
mC
wn
al
Zq
iK
cs
fR
cr
cP
MJ
ja
ja
RK
OA
Hq
tD
WO
eS
vC
Fj
SY
ZZ
Wc
"}
(11,1,1) = {"
Wc
ZZ
ZZ
ZZ
on
sh
RU
oT
Ss
Jy
bL
OF
bL
QY
Dw
yo
NW
QI
Kl
Jz
ZZ
bG
ZZ
Wc
"}
(12,1,1) = {"
Wc
ZZ
ZZ
ZZ
Zh
HC
wJ
Ve
sF
xK
TT
TT
TT
Jz
Wd
RC
mV
Ya
zX
ZZ
ZZ
iE
ZZ
Wc
"}
(13,1,1) = {"
Wc
ZZ
ZZ
ZZ
ZZ
ZZ
nB
Nn
Nn
eU
Wy
Wy
Wy
Wy
tg
yA
Pm
Os
Jx
ZZ
ZZ
ZZ
ZZ
Wc
"}
(14,1,1) = {"
Wc
ZZ
ZZ
ZZ
ZZ
ZZ
ZZ
ZZ
ZZ
ZZ
ZZ
ZZ
ZZ
ZZ
ZZ
ZZ
ZZ
ZZ
ZZ
ZZ
ZZ
ZZ
ZZ
Wc
"}
(15,1,1) = {"
Wc
Wc
Wc
Wc
Wc
Wc
Wc
Wc
Wc
Wc
Wc
Wc
Wc
Wc
Wc
Wc
Wc
Wc
Wc
Wc
Wc
Wc
Wc
Wc
"}
