//MAP CONVERTED BY dmm2tgm.py THIS HEADER COMMENT PREVENTS RECONVERSION, DO NOT REMOVE
"aK" = (
/obj/machinery/atmospherics/pipe/manifold/general/hidden{
	dir = 4
	},
/obj/effect/landmark/trader_drop_point,
/turf/open/indestructible/dropship{
	icon_state = "rasputin3"
	},
/area/dropship/generic)
"bn" = (
/turf/closed/wall/indestructible/dropship{
	icon_state = "96"
	},
/area/dropship/generic)
"cy" = (
/turf/closed/wall/indestructible/dropship{
	icon_state = "blue_rearwing_rt"
	},
/area/dropship/generic)
"cM" = (
/turf/closed/wall/indestructible/dropship/entry{
	icon_state = "60"
	},
/area/dropship/generic)
"dt" = (
/turf/closed/wall/indestructible/dropship{
	icon_state = "79"
	},
/area/dropship/generic)
"eJ" = (
/turf/closed/wall/indestructible/dropship{
	icon_state = "89"
	},
/area/dropship/generic)
"fa" = (
/turf/closed/wall/indestructible/dropship{
	icon_state = "blue_fr"
	},
/area/dropship/generic)
"fD" = (
/obj/item/radio/intercom/directional/east,
/obj/effect/turf_decal/ship/delivery/yellow,
/obj/machinery/computer/ship/navigation/public{
	dir = 1
	},
/turf/open/indestructible/dropship{
	icon_state = "rasputin15"
	},
/area/dropship/generic)
"fZ" = (
/turf/closed/wall/indestructible/dropship{
	icon_state = "blue_fl"
	},
/area/dropship/generic)
"iv" = (
/turf/closed/wall/indestructible/dropship{
	icon_state = "12"
	},
/area/dropship/generic)
"jl" = (
/obj/structure/lattice/catwalk/over/ship/dark,
/obj/machinery/computer/ship/viewscreen,
/obj/machinery/light{
	dir = 1
	},
/obj/machinery/computer/ship/dradis/mining{
	icon = 'nsv13/goonstation/icons/obj/computer.dmi'
	},
/turf/open/indestructible/dropship{
	icon_state = "rasputin15"
	},
/area/dropship/generic)
"jN" = (
/turf/closed/wall/indestructible/dropship{
	icon_state = "66"
	},
/area/dropship/generic)
"jP" = (
/turf/closed/wall/indestructible/dropship{
	icon_state = "blue_cockpit_fr"
	},
/area/dropship/generic)
"mI" = (
/turf/closed/wall/indestructible/dropship{
	icon_state = "blue_rearwing_lllb"
	},
/area/dropship/generic)
"mM" = (
/turf/closed/wall/indestructible/dropship{
	icon_state = "19"
	},
/area/dropship/generic)
"oV" = (
/turf/closed/wall/indestructible/dropship{
	icon_state = "blue_rearwing_lb"
	},
/area/dropship/generic)
"pC" = (
/turf/open/space/transit/north,
/area/dropship/generic)
"qn" = (
/obj/machinery/atmospherics/pipe/simple/general/hidden,
/turf/open/indestructible/dropship{
	icon_state = "rasputin3"
	},
/area/dropship/generic)
"qq" = (
/turf/closed/wall/indestructible/dropship/entry{
	icon_state = "57"
	},
/area/dropship/generic)
"qw" = (
/obj/structure/lattice/catwalk/over/ship/dark,
/obj/machinery/computer/ship/helm/console/dropship,
/turf/open/indestructible/dropship{
	icon_state = "rasputin15"
	},
/area/dropship/generic)
"rz" = (
/turf/closed/wall/indestructible/dropship{
	icon_state = "blue_front"
	},
/area/dropship/generic)
"rL" = (
/turf/closed/wall/indestructible/dropship{
	icon_state = "blue_rearwing_rrb"
	},
/area/dropship/generic)
"sC" = (
/turf/closed/wall/indestructible/dropship{
	icon_state = "blue_wing_rt"
	},
/area/dropship/generic)
"ud" = (
/turf/closed/wall/indestructible/dropship{
	icon_state = "blue_rearwing_rb"
	},
/area/dropship/generic)
"yU" = (
/turf/closed/wall/indestructible/dropship{
	icon_state = "blue_wing_lt"
	},
/area/dropship/generic)
"zc" = (
/obj/machinery/atmospherics/pipe/simple/general/hidden{
	dir = 10
	},
/obj/structure/chair/fancy/dropship{
	dir = 1
	},
/obj/structure/window/reinforced,
/turf/open/indestructible/dropship{
	icon_state = "rasputin3"
	},
/area/dropship/generic)
"zC" = (
/turf/closed/wall/indestructible/dropship{
	icon_state = "13"
	},
/area/dropship/generic)
"zX" = (
/obj/effect/turf_decal/stripes/line{
	dir = 4
	},
/turf/closed/wall/indestructible/dropship{
	icon_state = "70"
	},
/area/dropship/generic)
"Av" = (
/obj/structure/chair/fancy/dropship{
	dir = 1
	},
/obj/effect/turf_decal/stripes/line,
/obj/structure/window/reinforced,
/turf/open/indestructible/dropship{
	icon_state = "rasputin15"
	},
/area/dropship/generic)
"Cb" = (
/turf/closed/wall/indestructible/dropship{
	icon_state = "11"
	},
/area/dropship/generic)
"CS" = (
/obj/machinery/atmospherics/components/unary/portables_connector/visible{
	dir = 4
	},
/obj/effect/turf_decal/ship/delivery/yellow,
/obj/machinery/portable_atmospherics/canister/oxygen,
/obj/item/wrench,
/turf/open/indestructible/dropship{
	icon_state = "rasputin15"
	},
/area/dropship/generic)
"Dt" = (
/turf/closed/wall/indestructible/dropship{
	icon_state = "97"
	},
/area/dropship/generic)
"Es" = (
/obj/machinery/computer/ship/tactical/console,
/turf/open/indestructible/dropship{
	icon_state = "rasputin15"
	},
/area/dropship/generic)
"EC" = (
/turf/closed/wall/indestructible/dropship{
	icon_state = "blue_rearwing_rrrb"
	},
/area/dropship/generic)
"EG" = (
/turf/closed/wall/indestructible/dropship{
	icon_state = "98"
	},
/area/dropship/generic)
"Ja" = (
/turf/closed/wall/indestructible/dropship{
	icon_state = "blue_wing_lb"
	},
/area/dropship/generic)
"Km" = (
/obj/machinery/airalarm/all_access{
	dir = 8;
	pixel_x = 20
	},
/obj/structure/chair/fancy/dropship{
	dir = 8
	},
/obj/effect/turf_decal/stripes/line{
	dir = 4
	},
/turf/open/indestructible/dropship{
	icon_state = "rasputin15"
	},
/area/dropship/generic)
"KG" = (
/obj/effect/landmark/dropship_entry,
/obj/effect/turf_decal/stripes/line{
	dir = 8
	},
/obj/machinery/atmospherics/components/unary/vent_pump/on{
	dir = 4
	},
/turf/open/indestructible/dropship{
	icon_state = "rasputin15"
	},
/area/dropship/generic)
"ND" = (
/obj/effect/landmark/dropship_entry,
/obj/effect/turf_decal/stripes/line{
	dir = 8
	},
/turf/open/indestructible/dropship{
	icon_state = "rasputin15"
	},
/area/dropship/generic)
"QC" = (
/turf/closed/wall/indestructible/dropship{
	icon_state = "blue_rearwing_lt"
	},
/area/dropship/generic)
"SR" = (
/turf/closed/wall/indestructible/dropship{
	icon_state = "blue_rearwing_llb"
	},
/area/dropship/generic)
"UL" = (
/obj/structure/chair/fancy/dropship{
	dir = 1
	},
/obj/machinery/atmospherics/components/unary/vent_pump/on{
	dir = 4
	},
/obj/machinery/door/window{
	name = "cockpit"
	},
/obj/effect/turf_decal/stripes/line,
/obj/item/radio/intercom/directional/west,
/turf/open/indestructible/dropship{
	icon_state = "rasputin15"
	},
/area/dropship/generic)
"Vv" = (
/turf/closed/wall/indestructible/dropship{
	icon_state = "18"
	},
/area/dropship/generic)
"VW" = (
/turf/closed/wall/indestructible/dropship{
	icon_state = "blue_cockpit_fl"
	},
/area/dropship/generic)
"VY" = (
/turf/closed/indestructible/cordon{
	alpha = 0
	},
/area/dropship/generic)
"WQ" = (
/turf/closed/wall/indestructible/dropship{
	icon_state = "70"
	},
/area/dropship/generic)
"WV" = (
/obj/machinery/atmospherics/pipe/simple/general/hidden{
	dir = 9
	},
/obj/effect/turf_decal/ship/delivery/yellow,
/obj/structure/ore_box,
/turf/open/indestructible/dropship{
	icon_state = "rasputin3"
	},
/area/dropship/generic)
"Zh" = (
/turf/closed/wall/indestructible/dropship{
	icon_state = "86"
	},
/area/dropship/generic)
"Zt" = (
/turf/closed/wall/indestructible/dropship{
	icon_state = "blue_wing_rb"
	},
/area/dropship/generic)
"Zu" = (
/obj/effect/turf_decal/stripes/line{
	dir = 4
	},
/obj/machinery/light{
	dir = 4
	},
/obj/structure/chair/fancy/dropship{
	dir = 8
	},
/turf/open/indestructible/dropship{
	icon_state = "rasputin15"
	},
/area/dropship/generic)

(1,1,1) = {"
VY
VY
VY
VY
VY
VY
VY
VY
VY
VY
VY
VY
VY
"}
(2,1,1) = {"
VY
pC
pC
pC
pC
pC
pC
pC
pC
pC
pC
pC
VY
"}
(3,1,1) = {"
VY
pC
pC
pC
yU
jN
jN
jN
jN
Ja
mI
pC
VY
"}
(4,1,1) = {"
VY
pC
pC
pC
sC
WQ
zX
zX
WQ
Zt
SR
pC
VY
"}
(5,1,1) = {"
VY
pC
fZ
VW
Zh
Vv
qq
cM
Vv
QC
oV
pC
VY
"}
(6,1,1) = {"
VY
pC
rz
bn
qw
UL
ND
KG
CS
dt
Cb
pC
VY
"}
(7,1,1) = {"
VY
pC
rz
Dt
jl
zc
qn
aK
WV
dt
iv
pC
VY
"}
(8,1,1) = {"
VY
pC
rz
EG
Es
Av
Zu
Km
fD
dt
zC
pC
VY
"}
(9,1,1) = {"
VY
pC
fa
jP
eJ
mM
mM
mM
mM
cy
ud
pC
VY
"}
(10,1,1) = {"
VY
pC
pC
pC
yU
jN
jN
jN
jN
Ja
rL
pC
VY
"}
(11,1,1) = {"
VY
pC
pC
pC
sC
WQ
WQ
WQ
WQ
Zt
EC
pC
VY
"}
(12,1,1) = {"
VY
pC
pC
pC
pC
pC
pC
pC
pC
pC
pC
pC
VY
"}
(13,1,1) = {"
VY
VY
VY
VY
VY
VY
VY
VY
VY
VY
VY
VY
VY
"}
