//MAP CONVERTED BY dmm2tgm.py THIS HEADER COMMENT PREVENTS RECONVERSION, DO NOT REMOVE
"ak" = (
/turf/closed/indestructible/abductor{
	icon_state = "alien18"
	},
/area/abductor_ship)
"aS" = (
/turf/closed/indestructible/abductor{
	icon_state = "alien6"
	},
/area/abductor_ship)
"bK" = (
/obj/structure/window/reinforced/tinted/fulltile,
/turf/open/floor/plating/abductor,
/area/abductor_ship)
"cL" = (
/obj/structure/bed/abductor,
/obj/item/bedsheet/cosmos,
/turf/open/floor/plating/abductor,
/area/abductor_ship)
"cN" = (
/obj/effect/landmark/abductor/agent{
	team_number = 2
	},
/turf/open/floor/plating/abductor,
/area/abductor_ship)
"dx" = (
/turf/closed/indestructible/abductor{
	icon_state = "alien9"
	},
/area/abductor_ship)
"dD" = (
/obj/machinery/computer/ship/ftl_computer/preset{
	dir = 8
	},
/turf/open/floor/plating/abductor,
/area/abductor_ship)
"eQ" = (
/obj/structure/table/abductor,
/turf/open/floor/plating/abductor,
/area/abductor_ship)
"gQ" = (
/obj/structure/cable{
	icon_state = "4-8"
	},
/turf/open/floor/plating/abductor,
/area/abductor_ship)
"gZ" = (
/obj/machinery/power/apc/highcap/fifteen_k,
/turf/closed/wall/mineral/abductor,
/area/abductor_ship)
"iW" = (
/obj/structure/showcase/machinery{
	icon = 'nsv13/icons/obj/energy_weapons.dmi';
	icon_state = "ion_cannon";
	pixel_x = -32;
	pixel_y = -32;
	desc = "A massive Ion cannon.";
	name = "Ion Pulse Driver"
	},
/obj/structure/cable{
	icon_state = "0-8"
	},
/turf/open/floor/plating/abductor2,
/area/abductor_ship)
"ja" = (
/turf/closed/indestructible/abductor{
	icon_state = "alien22"
	},
/area/abductor_ship)
"jf" = (
/obj/structure/cable{
	icon_state = "2-4"
	},
/turf/open/floor/plating/abductor,
/area/abductor_ship)
"jp" = (
/obj/machinery/power/rtg/abductor,
/obj/structure/cable/white{
	icon_state = "0-4"
	},
/turf/open/floor/plating/abductor2,
/area/abductor_ship)
"ku" = (
/obj/machinery/power/smes/engineering,
/obj/structure/cable{
	icon_state = "0-4"
	},
/turf/open/floor/plating/abductor2,
/area/abductor_ship)
"kI" = (
/turf/closed/indestructible/abductor{
	icon_state = "alien3"
	},
/area/abductor_ship)
"kY" = (
/obj/structure/table/optable/abductor,
/turf/open/floor/plating/abductor,
/area/abductor_ship)
"lS" = (
/obj/structure/cable{
	icon_state = "1-8"
	},
/turf/open/floor/plating/abductor,
/area/abductor_ship)
"ma" = (
/obj/machinery/door/airlock/abductor,
/turf/open/floor/plating/abductor,
/area/abductor_ship)
"mh" = (
/turf/closed/indestructible/abductor{
	icon_state = "alien20"
	},
/area/abductor_ship)
"ms" = (
/turf/closed/indestructible/abductor{
	icon_state = "alien11"
	},
/area/abductor_ship)
"nd" = (
/obj/machinery/replicator,
/turf/closed/wall/mineral/abductor,
/area/abductor_ship)
"ow" = (
/turf/closed/indestructible/abductor{
	icon_state = "alien5"
	},
/area/abductor_ship)
"oF" = (
/turf/open/floor/plating/abductor2,
/area/abductor_ship)
"pp" = (
/obj/structure/cable/white{
	icon_state = "1-8"
	},
/obj/structure/cable/white{
	icon_state = "5-8"
	},
/obj/machinery/power/terminal,
/obj/structure/cable/white{
	icon_state = "0-8"
	},
/turf/open/floor/plating/abductor2,
/area/abductor_ship)
"qj" = (
/obj/machinery/door/airlock/abductor,
/obj/structure/cable{
	icon_state = "4-8"
	},
/turf/open/floor/plating/abductor2,
/area/abductor_ship)
"rf" = (
/obj/structure/cable/white{
	icon_state = "1-10"
	},
/turf/open/floor/plating/abductor2,
/area/abductor_ship)
"rj" = (
/turf/closed/indestructible/abductor{
	icon_state = "alien10"
	},
/area/abductor_ship)
"sz" = (
/turf/closed/indestructible/dropship/entry{
	icon = 'icons/obj/doors/airlocks/abductor/abductor_airlock.dmi';
	icon_state = "closed"
	},
/area/abductor_ship)
"sO" = (
/turf/closed/indestructible/abductor{
	icon_state = "alien2"
	},
/area/abductor_ship)
"sS" = (
/obj/structure/shuttle/engine/heater{
	dir = 8
	},
/turf/open/floor/plating/abductor2,
/area/abductor_ship)
"tc" = (
/obj/structure/table/abductor,
/obj/machinery/recharger,
/turf/open/floor/plating/abductor,
/area/abductor_ship)
"tJ" = (
/turf/closed/indestructible/abductor{
	icon_state = "alien16"
	},
/area/abductor_ship)
"ug" = (
/turf/closed/wall/mineral/abductor,
/area/abductor_ship)
"uI" = (
/obj/structure/closet/abductor,
/turf/open/floor/plating/abductor,
/area/abductor_ship)
"vA" = (
/obj/structure/cable{
	icon_state = "1-8"
	},
/obj/structure/cable{
	icon_state = "0-8"
	},
/obj/machinery/power/terminal{
	dir = 4
	},
/turf/open/floor/plating/abductor,
/area/abductor_ship)
"vW" = (
/turf/closed/indestructible/abductor{
	icon_state = "alien15"
	},
/area/abductor_ship)
"wF" = (
/turf/closed/indestructible/abductor{
	icon_state = "alien17"
	},
/area/abductor_ship)
"xa" = (
/turf/closed/indestructible/abductor,
/area/abductor_ship)
"yp" = (
/obj/machinery/suit_storage_unit/standard_unit,
/turf/open/floor/plating/abductor,
/area/abductor_ship)
"yR" = (
/obj/machinery/computer/camera_advanced/abductor,
/obj/machinery/abductor/console,
/obj/machinery/abductor/pad{
	team_number = 2
	},
/obj/machinery/computer/camera_advanced/abductor,
/turf/open/floor/plating/abductor,
/area/abductor_ship)
"zS" = (
/obj/structure/cable{
	icon_state = "4-8"
	},
/obj/effect/landmark/abductor/scientist{
	team_number = 2
	},
/turf/open/floor/plating/abductor,
/area/abductor_ship)
"zU" = (
/turf/closed/indestructible/abductor{
	icon_state = "alien8"
	},
/area/abductor_ship)
"AB" = (
/obj/machinery/computer/ship/navigation/console{
	dir = 8;
	icon_state = "computer_mid"
	},
/turf/open/floor/plating/abductor,
/area/abductor_ship)
"Bd" = (
/turf/closed/indestructible/abductor{
	icon_state = "alien14"
	},
/area/abductor_ship)
"Bj" = (
/obj/structure/table/abductor,
/obj/item/surgical_drapes,
/obj/item/surgicaldrill/alien,
/obj/item/circular_saw/alien,
/obj/item/cautery/alien,
/obj/item/hemostat/alien,
/obj/item/retractor/alien,
/obj/item/scalpel/alien,
/turf/open/floor/plating/abductor,
/area/abductor_ship)
"BI" = (
/obj/machinery/door/airlock/abductor,
/obj/structure/cable{
	icon_state = "1-2"
	},
/turf/open/floor/plating/abductor,
/area/abductor_ship)
"CQ" = (
/turf/open/space/transit/north,
/area/space)
"Db" = (
/turf/closed/indestructible/abductor{
	icon_state = "alien7"
	},
/area/abductor_ship)
"Ga" = (
/obj/structure/shuttle/engine/heater{
	dir = 8
	},
/turf/open/floor/plating/abductor,
/area/abductor_ship)
"GK" = (
/obj/structure/cable{
	icon_state = "4-8"
	},
/turf/open/floor/plating/abductor2,
/area/abductor_ship)
"Ia" = (
/obj/structure/table/abductor,
/obj/item/paper/guides/antag/abductor,
/turf/open/floor/plating/abductor,
/area/abductor_ship)
"JE" = (
/obj/machinery/computer/ship/helm/console{
	dir = 8
	},
/turf/open/floor/plating/abductor,
/area/abductor_ship)
"KC" = (
/turf/open/floor/plating/abductor,
/area/abductor_ship)
"KU" = (
/obj/machinery/abductor/experiment,
/obj/machinery/abductor/console,
/turf/open/floor/plating/abductor,
/area/abductor_ship)
"Lc" = (
/obj/structure/cable{
	icon_state = "4-8"
	},
/obj/structure/cable{
	icon_state = "2-8"
	},
/turf/open/floor/plating/abductor,
/area/abductor_ship)
"LD" = (
/obj/structure/closet/abductor,
/obj/item/storage/box/alienhandcuffs,
/turf/open/floor/plating/abductor,
/area/abductor_ship)
"LH" = (
/turf/closed/indestructible/abductor{
	icon_state = "alien24"
	},
/area/abductor_ship)
"LI" = (
/obj/machinery/abductor/experiment,
/turf/open/floor/plating/abductor,
/area/abductor_ship)
"MJ" = (
/turf/closed/indestructible/abductor{
	icon_state = "alien21"
	},
/area/abductor_ship)
"MP" = (
/obj/structure/cable{
	icon_state = "1-2"
	},
/turf/open/floor/plating/abductor,
/area/abductor_ship)
"Na" = (
/obj/structure/cable{
	icon_state = "0-8"
	},
/obj/structure/showcase/machinery{
	icon = 'nsv13/icons/obj/energy_weapons.dmi';
	icon_state = "ion_cannon";
	pixel_x = -32;
	pixel_y = -32;
	desc = "A massive Ion cannon.";
	name = "Ion Pulse Driver"
	},
/turf/open/floor/plating/abductor2,
/area/abductor_ship)
"Ni" = (
/obj/structure/bed/abductor,
/obj/item/bedsheet/random,
/turf/open/floor/plating/abductor,
/area/abductor_ship)
"NQ" = (
/obj/structure/cable{
	icon_state = "1-4"
	},
/turf/open/floor/plating/abductor,
/area/abductor_ship)
"Oi" = (
/obj/machinery/power/rtg/abductor,
/obj/structure/cable/white{
	icon_state = "0-2"
	},
/turf/open/floor/plating/abductor2,
/area/abductor_ship)
"Qa" = (
/obj/machinery/computer/ship/tactical/console{
	dir = 5;
	icon_state = "computer_end"
	},
/turf/open/floor/plating/abductor,
/area/abductor_ship)
"Qt" = (
/turf/closed/indestructible/fakeglass,
/turf/open/floor/plating/abductor2,
/area/abductor_ship)
"Rw" = (
/obj/effect/landmark/dropship_entry,
/turf/open/floor/plating/abductor,
/area/abductor_ship)
"Tq" = (
/turf/closed/indestructible/abductor{
	icon_state = "alien19"
	},
/area/abductor_ship)
"TJ" = (
/turf/closed/indestructible/abductor{
	icon_state = "alien4"
	},
/area/abductor_ship)
"Vl" = (
/obj/machinery/jukebox/disco,
/turf/open/floor/plating/abductor,
/area/abductor_ship)
"VK" = (
/obj/machinery/shuttle/engine/void{
	dir = 4
	},
/turf/closed/indestructible/abductor{
	icon_state = "alien12"
	},
/area/abductor_ship)
"Wx" = (
/obj/machinery/door/airlock/abductor,
/obj/structure/cable{
	icon_state = "4-8"
	},
/turf/open/floor/plating/abductor,
/area/abductor_ship)
"XS" = (
/obj/machinery/abductor/gland_dispenser,
/turf/open/floor/plating/abductor,
/area/abductor_ship)
"Yc" = (
/obj/machinery/abductor/pad{
	team_number = 2
	},
/turf/open/floor/plating/abductor,
/area/abductor_ship)
"YG" = (
/turf/closed/indestructible/abductor{
	icon_state = "alien23"
	},
/area/abductor_ship)

(1,1,1) = {"
CQ
CQ
CQ
CQ
CQ
CQ
CQ
CQ
CQ
CQ
CQ
CQ
CQ
CQ
CQ
CQ
CQ
CQ
CQ
CQ
CQ
CQ
CQ
CQ
CQ
CQ
CQ
CQ
CQ
CQ
"}
(2,1,1) = {"
CQ
CQ
CQ
CQ
CQ
CQ
CQ
CQ
CQ
CQ
CQ
CQ
CQ
CQ
CQ
CQ
CQ
CQ
CQ
CQ
CQ
CQ
CQ
CQ
CQ
CQ
CQ
CQ
CQ
CQ
"}
(3,1,1) = {"
CQ
CQ
CQ
CQ
CQ
CQ
CQ
CQ
CQ
CQ
CQ
CQ
CQ
CQ
CQ
CQ
CQ
CQ
CQ
CQ
CQ
CQ
CQ
CQ
CQ
CQ
CQ
CQ
CQ
CQ
"}
(4,1,1) = {"
CQ
CQ
CQ
CQ
CQ
CQ
CQ
CQ
CQ
CQ
CQ
CQ
CQ
CQ
CQ
CQ
CQ
CQ
CQ
CQ
CQ
CQ
CQ
CQ
CQ
CQ
CQ
CQ
CQ
CQ
"}
(5,1,1) = {"
CQ
CQ
CQ
CQ
CQ
CQ
CQ
CQ
CQ
CQ
CQ
CQ
CQ
CQ
CQ
CQ
CQ
CQ
CQ
CQ
CQ
CQ
CQ
CQ
CQ
CQ
CQ
CQ
CQ
CQ
"}
(6,1,1) = {"
CQ
CQ
CQ
CQ
CQ
CQ
CQ
CQ
CQ
CQ
CQ
CQ
CQ
CQ
CQ
CQ
CQ
CQ
CQ
CQ
CQ
CQ
CQ
CQ
CQ
CQ
CQ
CQ
CQ
CQ
"}
(7,1,1) = {"
CQ
CQ
CQ
CQ
CQ
CQ
CQ
CQ
CQ
CQ
CQ
CQ
CQ
CQ
CQ
CQ
CQ
CQ
CQ
CQ
CQ
CQ
CQ
CQ
CQ
CQ
CQ
CQ
CQ
CQ
"}
(8,1,1) = {"
CQ
CQ
CQ
CQ
CQ
CQ
CQ
CQ
CQ
CQ
CQ
CQ
CQ
CQ
CQ
CQ
CQ
CQ
CQ
CQ
CQ
CQ
CQ
CQ
CQ
CQ
CQ
CQ
CQ
CQ
"}
(9,1,1) = {"
CQ
CQ
CQ
CQ
CQ
CQ
CQ
CQ
CQ
CQ
tJ
Bd
VK
rj
oF
Bd
VK
rj
aS
CQ
CQ
CQ
CQ
CQ
CQ
CQ
CQ
CQ
CQ
CQ
"}
(10,1,1) = {"
CQ
CQ
CQ
CQ
CQ
CQ
CQ
CQ
CQ
mh
wF
jp
sS
ug
sz
ug
Ga
Ni
Db
xa
CQ
CQ
CQ
CQ
CQ
CQ
CQ
CQ
CQ
CQ
"}
(11,1,1) = {"
CQ
CQ
CQ
CQ
CQ
CQ
CQ
CQ
tJ
wF
Oi
pp
ku
ug
Rw
ug
uI
KC
cL
Db
aS
CQ
CQ
CQ
CQ
CQ
CQ
CQ
CQ
CQ
"}
(12,1,1) = {"
CQ
CQ
CQ
CQ
CQ
CQ
CQ
mh
wF
Oi
rf
oF
GK
ug
KC
nd
KC
KC
KC
Ni
Db
xa
CQ
CQ
CQ
CQ
CQ
CQ
CQ
CQ
"}
(13,1,1) = {"
CQ
CQ
CQ
CQ
CQ
CQ
CQ
MJ
ug
ug
ug
ug
Wx
ug
ma
ug
ug
ug
ma
ug
ug
sO
CQ
CQ
CQ
CQ
CQ
CQ
CQ
CQ
"}
(14,1,1) = {"
CQ
CQ
CQ
CQ
CQ
CQ
CQ
ja
KC
KC
dD
KC
gQ
ug
KC
jf
MP
BI
MP
NQ
LD
kI
CQ
CQ
CQ
CQ
CQ
CQ
CQ
CQ
"}
(15,1,1) = {"
CQ
CQ
CQ
CQ
CQ
CQ
CQ
ja
KC
cN
KC
KC
Lc
BI
MP
lS
yp
ug
LI
gQ
XS
kI
CQ
CQ
CQ
CQ
CQ
CQ
CQ
CQ
"}
(16,1,1) = {"
CQ
CQ
CQ
CQ
CQ
CQ
CQ
ja
eQ
eQ
KC
KC
gQ
ug
Vl
KC
yp
ug
KU
zS
kY
kI
CQ
CQ
CQ
CQ
CQ
CQ
CQ
CQ
"}
(17,1,1) = {"
CQ
CQ
CQ
CQ
CQ
CQ
CQ
ja
eQ
eQ
KC
KC
gQ
ma
KC
KC
yp
ug
yR
gQ
Bj
kI
CQ
CQ
CQ
CQ
CQ
CQ
CQ
CQ
"}
(18,1,1) = {"
CQ
CQ
CQ
CQ
CQ
CQ
CQ
ja
KC
KC
jf
MP
lS
nd
KC
KC
KC
ma
jf
vA
KC
kI
CQ
CQ
CQ
CQ
CQ
CQ
CQ
CQ
"}
(19,1,1) = {"
CQ
CQ
CQ
CQ
CQ
CQ
CQ
YG
KC
ug
qj
ug
ug
ug
ma
ug
ug
ug
qj
gZ
Yc
TJ
CQ
CQ
CQ
CQ
CQ
CQ
CQ
CQ
"}
(20,1,1) = {"
CQ
CQ
CQ
CQ
CQ
CQ
CQ
LH
ak
ug
iW
bK
tc
tc
KC
eQ
Ia
bK
Na
ug
zU
ow
CQ
CQ
CQ
CQ
CQ
CQ
CQ
CQ
"}
(21,1,1) = {"
CQ
CQ
CQ
CQ
CQ
CQ
CQ
CQ
Tq
ak
oF
bK
KC
KC
KC
KC
KC
bK
oF
zU
dx
CQ
CQ
CQ
CQ
CQ
CQ
CQ
CQ
CQ
"}
(22,1,1) = {"
CQ
CQ
CQ
CQ
CQ
CQ
CQ
CQ
CQ
LH
ak
ug
uI
JE
AB
Qa
uI
ug
zU
ow
CQ
CQ
CQ
CQ
CQ
CQ
CQ
CQ
CQ
CQ
"}
(23,1,1) = {"
CQ
CQ
CQ
CQ
CQ
CQ
CQ
CQ
CQ
CQ
Tq
vW
ms
Qt
Qt
Qt
vW
ms
dx
CQ
CQ
CQ
CQ
CQ
CQ
CQ
CQ
CQ
CQ
CQ
"}
(24,1,1) = {"
CQ
CQ
CQ
CQ
CQ
CQ
CQ
CQ
CQ
CQ
CQ
CQ
CQ
CQ
CQ
CQ
CQ
CQ
CQ
CQ
CQ
CQ
CQ
CQ
CQ
CQ
CQ
CQ
CQ
CQ
"}
(25,1,1) = {"
CQ
CQ
CQ
CQ
CQ
CQ
CQ
CQ
CQ
CQ
CQ
CQ
CQ
CQ
CQ
CQ
CQ
CQ
CQ
CQ
CQ
CQ
CQ
CQ
CQ
CQ
CQ
CQ
CQ
CQ
"}
(26,1,1) = {"
CQ
CQ
CQ
CQ
CQ
CQ
CQ
CQ
CQ
CQ
CQ
CQ
CQ
CQ
CQ
CQ
CQ
CQ
CQ
CQ
CQ
CQ
CQ
CQ
CQ
CQ
CQ
CQ
CQ
CQ
"}
(27,1,1) = {"
CQ
CQ
CQ
CQ
CQ
CQ
CQ
CQ
CQ
CQ
CQ
CQ
CQ
CQ
CQ
CQ
CQ
CQ
CQ
CQ
CQ
CQ
CQ
CQ
CQ
CQ
CQ
CQ
CQ
CQ
"}
(28,1,1) = {"
CQ
CQ
CQ
CQ
CQ
CQ
CQ
CQ
CQ
CQ
CQ
CQ
CQ
CQ
CQ
CQ
CQ
CQ
CQ
CQ
CQ
CQ
CQ
CQ
CQ
CQ
CQ
CQ
CQ
CQ
"}
(29,1,1) = {"
CQ
CQ
CQ
CQ
CQ
CQ
CQ
CQ
CQ
CQ
CQ
CQ
CQ
CQ
CQ
CQ
CQ
CQ
CQ
CQ
CQ
CQ
CQ
CQ
CQ
CQ
CQ
CQ
CQ
CQ
"}
(30,1,1) = {"
CQ
CQ
CQ
CQ
CQ
CQ
CQ
CQ
CQ
CQ
CQ
CQ
CQ
CQ
CQ
CQ
CQ
CQ
CQ
CQ
CQ
CQ
CQ
CQ
CQ
CQ
CQ
CQ
CQ
CQ
"}
