//MAP CONVERTED BY dmm2tgm.py THIS HEADER COMMENT PREVENTS RECONVERSION, DO NOT REMOVE
"aa" = (
/turf/open/space/basic,
/area/space)
"ab" = (
/obj/structure/lattice,
/turf/open/space/basic,
/area/nsv/shuttle/storage)
"ac" = (
/turf/closed/wall/mineral/titanium,
/area/nsv/shuttle/storage)
"ad" = (
/obj/structure/lattice,
/turf/open/space/basic,
/area/nsv/shuttle/central)
"ae" = (
/turf/open/floor/plating/airless,
/area/nsv/shuttle/central)
"af" = (
/turf/closed/wall/mineral/titanium,
/area/nsv/shuttle/central)
"ag" = (
/turf/open/floor/plating/airless,
/area/nsv/shuttle/storage)
"ah" = (
/obj/structure/window/reinforced{
	dir = 4
	},
/turf/open/floor/plating/airless,
/area/nsv/shuttle/storage)
"ai" = (
/obj/structure/closet/secure_closet/miner,
/turf/open/floor/plasteel,
/area/nsv/shuttle/storage)
"aj" = (
/obj/machinery/airalarm/all_access{
	pixel_y = 23
	},
/obj/structure/closet/secure_closet/miner,
/turf/open/floor/plasteel,
/area/nsv/shuttle/storage)
"ak" = (
/obj/structure/shuttle/engine/large{
	dir = 8
	},
/turf/open/floor/plating/airless,
/area/nsv/shuttle/central)
"al" = (
/turf/open/floor/plasteel,
/area/nsv/shuttle/storage)
"am" = (
/obj/machinery/light{
	dir = 4
	},
/turf/open/floor/plasteel,
/area/nsv/shuttle/storage)
"an" = (
/obj/structure/grille,
/obj/structure/window/reinforced/fulltile,
/turf/open/floor/plating/airless,
/area/nsv/shuttle/central)
"ao" = (
/turf/closed/wall/mineral/titanium,
/area/nsv/shuttle/bridge)
"ap" = (
/obj/structure/shuttle/engine/huge{
	dir = 8
	},
/turf/open/floor/plating/airless,
/area/nsv/shuttle/storage)
"aq" = (
/obj/machinery/atmospherics/components/unary/vent_scrubber/on/layer3,
/turf/open/floor/plasteel,
/area/nsv/shuttle/storage)
"ar" = (
/obj/machinery/atmospherics/components/unary/vent_pump/on/layer1{
	dir = 4
	},
/turf/open/floor/plasteel,
/area/nsv/shuttle/storage)
"as" = (
/obj/machinery/atmospherics/pipe/simple/supply/hidden/layer1{
	dir = 10
	},
/obj/machinery/atmospherics/components/unary/vent_scrubber/on/layer3,
/turf/open/floor/plasteel,
/area/nsv/shuttle/storage)
"at" = (
/obj/machinery/mineral/equipment_vendor,
/turf/open/floor/plasteel,
/area/nsv/shuttle/storage)
"au" = (
/obj/machinery/vending/wardrobe/cargo_wardrobe,
/turf/open/floor/plasteel,
/area/nsv/shuttle/central)
"av" = (
/turf/open/floor/plasteel,
/area/nsv/shuttle/central)
"aw" = (
/obj/structure/table,
/turf/open/floor/plasteel,
/area/nsv/shuttle/central)
"ax" = (
/obj/machinery/airalarm/all_access{
	pixel_y = 23
	},
/obj/structure/table,
/turf/open/floor/plasteel,
/area/nsv/shuttle/central)
"ay" = (
/obj/machinery/computer/operating,
/obj/structure/sink{
	dir = 8;
	pixel_x = -12
	},
/turf/open/floor/plasteel,
/area/nsv/shuttle/central)
"az" = (
/obj/machinery/airalarm/all_access{
	pixel_y = 23
	},
/obj/machinery/stasis,
/turf/open/floor/plasteel,
/area/nsv/shuttle/central)
"aA" = (
/obj/structure/table,
/obj/item/storage/backpack/duffelbag/med/surgery,
/turf/open/floor/plasteel,
/area/nsv/shuttle/central)
"aB" = (
/obj/machinery/suit_storage_unit/mining/eva,
/obj/machinery/light{
	dir = 8
	},
/turf/open/floor/plasteel,
/area/nsv/shuttle/storage)
"aC" = (
/obj/machinery/atmospherics/pipe/simple/scrubbers/hidden/layer3{
	dir = 5
	},
/obj/machinery/suit_storage_unit/mining/eva,
/turf/open/floor/plasteel,
/area/nsv/shuttle/storage)
"aD" = (
/obj/machinery/atmospherics/pipe/simple/scrubbers/hidden/layer3{
	dir = 4
	},
/obj/machinery/suit_storage_unit/mining/eva,
/turf/open/floor/plasteel,
/area/nsv/shuttle/storage)
"aE" = (
/obj/machinery/atmospherics/pipe/simple/supply/hidden/layer1,
/obj/machinery/atmospherics/pipe/manifold/scrubbers/hidden/layer3{
	dir = 4
	},
/obj/structure/cable{
	icon_state = "2-4"
	},
/turf/open/floor/plasteel,
/area/nsv/shuttle/storage)
"aF" = (
/obj/structure/cable{
	icon_state = "0-8"
	},
/obj/machinery/power/apc/auto_name/east,
/turf/open/floor/plasteel,
/area/nsv/shuttle/storage)
"aG" = (
/obj/machinery/light{
	dir = 8
	},
/obj/machinery/autolathe,
/turf/open/floor/plasteel,
/area/nsv/shuttle/central)
"aH" = (
/obj/machinery/atmospherics/components/unary/vent_scrubber/on/layer3,
/turf/open/floor/plasteel,
/area/nsv/shuttle/central)
"aI" = (
/obj/machinery/light{
	dir = 4
	},
/obj/structure/table,
/turf/open/floor/plasteel,
/area/nsv/shuttle/central)
"aJ" = (
/obj/machinery/light{
	dir = 8
	},
/obj/structure/table,
/turf/open/floor/plasteel,
/area/nsv/shuttle/central)
"aK" = (
/obj/machinery/light{
	dir = 4
	},
/obj/structure/table,
/obj/item/storage/firstaid/brute,
/obj/item/storage/firstaid/brute,
/obj/item/storage/firstaid/fire,
/obj/item/storage/firstaid/fire,
/obj/item/storage/firstaid/o2,
/obj/item/storage/firstaid/toxin,
/obj/item/storage/firstaid/regular,
/obj/item/storage/firstaid/regular,
/turf/open/floor/plasteel,
/area/nsv/shuttle/central)
"aL" = (
/obj/machinery/power/smes,
/obj/structure/cable{
	icon_state = "0-4"
	},
/turf/open/floor/plasteel/dark,
/area/nsv/shuttle/bridge)
"aM" = (
/obj/structure/cable{
	icon_state = "2-8"
	},
/turf/closed/wall/mineral/titanium,
/area/nsv/shuttle/bridge)
"aN" = (
/turf/closed/wall/mineral/titanium,
/area/nsv/shuttle/airlock/aft)
"aO" = (
/obj/machinery/atmospherics/pipe/simple/supply/hidden/layer1,
/obj/machinery/atmospherics/pipe/simple/scrubbers/hidden/layer3,
/obj/machinery/door/airlock/mining/glass{
	req_one_access_txt = "48"
	},
/obj/structure/cable{
	icon_state = "1-2"
	},
/turf/open/floor/plasteel,
/area/nsv/shuttle/storage)
"aP" = (
/obj/machinery/rnd/production/techfab/department/cargo,
/turf/open/floor/plasteel,
/area/nsv/shuttle/central)
"aQ" = (
/obj/machinery/atmospherics/pipe/simple/scrubbers/hidden/layer3,
/obj/machinery/atmospherics/components/unary/vent_pump/on/layer1,
/obj/structure/cable{
	icon_state = "2-4"
	},
/turf/open/floor/plasteel,
/area/nsv/shuttle/central)
"aR" = (
/obj/structure/cable{
	icon_state = "4-8"
	},
/obj/structure/table,
/turf/open/floor/plasteel,
/area/nsv/shuttle/central)
"aS" = (
/obj/structure/cable{
	icon_state = "0-8"
	},
/obj/structure/table,
/turf/open/floor/plasteel,
/area/nsv/shuttle/central)
"aT" = (
/obj/structure/cable{
	icon_state = "0-8"
	},
/obj/structure/table,
/obj/item/storage/firstaid/brute,
/obj/item/storage/firstaid/brute,
/obj/item/storage/firstaid/fire,
/obj/item/storage/firstaid/fire,
/obj/item/storage/firstaid/o2,
/obj/item/storage/firstaid/toxin,
/obj/item/storage/firstaid/regular,
/obj/item/storage/firstaid/regular,
/turf/open/floor/plasteel,
/area/nsv/shuttle/central)
"aU" = (
/obj/machinery/power/terminal{
	dir = 1
	},
/obj/structure/cable/yellow{
	icon_state = "0-2"
	},
/obj/machinery/light{
	dir = 8
	},
/turf/open/floor/plasteel/dark,
/area/nsv/shuttle/bridge)
"aV" = (
/obj/machinery/power/apc/auto_name/north,
/obj/structure/cable,
/obj/structure/cable{
	icon_state = "1-2"
	},
/turf/open/floor/plasteel/dark,
/area/nsv/shuttle/bridge)
"aW" = (
/obj/machinery/airalarm/all_access{
	pixel_y = 23
	},
/turf/open/floor/plasteel/dark,
/area/nsv/shuttle/bridge)
"aX" = (
/obj/machinery/door/airlock/ship/external/glass{
	dir = 4;
	name = "Mining External airlock";
	req_one_access_txt = "48"
	},
/turf/open/floor/plasteel,
/area/nsv/shuttle/airlock/aft)
"aY" = (
/turf/open/floor/plasteel,
/area/nsv/shuttle/airlock/aft)
"aZ" = (
/obj/machinery/atmospherics/components/unary/vent_scrubber/on/layer3,
/obj/machinery/airalarm/all_access{
	pixel_y = 23
	},
/turf/open/floor/plasteel,
/area/nsv/shuttle/airlock/aft)
"ba" = (
/obj/machinery/atmospherics/components/unary/vent_pump/on/layer1,
/obj/machinery/power/apc/auto_name/north,
/obj/structure/cable{
	icon_state = "0-2"
	},
/turf/open/floor/plasteel,
/area/nsv/shuttle/airlock/aft)
"bb" = (
/obj/machinery/mineral/ore_redemption{
	input_dir = 8
	},
/turf/open/floor/plasteel,
/area/nsv/shuttle/airlock/aft)
"bc" = (
/obj/structure/grille,
/obj/structure/window/reinforced/fulltile,
/turf/open/floor/plasteel,
/area/nsv/shuttle/airlock/aft)
"bd" = (
/obj/machinery/atmospherics/components/unary/vent_pump/on/layer1{
	dir = 4
	},
/turf/open/floor/plasteel,
/area/nsv/shuttle/central)
"be" = (
/obj/machinery/atmospherics/pipe/manifold/supply/hidden/layer1{
	dir = 4
	},
/obj/machinery/atmospherics/pipe/simple/scrubbers/hidden/layer3,
/obj/structure/cable{
	icon_state = "1-2"
	},
/turf/open/floor/plasteel,
/area/nsv/shuttle/central)
"bf" = (
/obj/structure/grille,
/obj/structure/window/reinforced/fulltile,
/turf/open/floor/plating,
/area/nsv/shuttle/central)
"bg" = (
/obj/machinery/atmospherics/pipe/simple/supply/hidden/layer1,
/obj/machinery/atmospherics/pipe/simple/scrubbers/hidden/layer3,
/obj/machinery/door/airlock/research/glass{
	req_one_access_txt = "48"
	},
/obj/structure/cable{
	icon_state = "1-2"
	},
/turf/open/floor/plasteel,
/area/nsv/shuttle/central)
"bh" = (
/obj/machinery/atmospherics/pipe/simple/supply/hidden/layer1,
/obj/machinery/atmospherics/pipe/simple/scrubbers/hidden/layer3,
/obj/machinery/door/airlock/medical/glass{
	req_one_access_txt = "48"
	},
/obj/structure/cable{
	icon_state = "1-2"
	},
/turf/open/floor/plasteel,
/area/nsv/shuttle/central)
"bi" = (
/obj/machinery/atmospherics/components/unary/vent_pump/on/layer1{
	dir = 4
	},
/obj/structure/cable/yellow{
	icon_state = "1-2"
	},
/turf/open/floor/plasteel/dark,
/area/nsv/shuttle/bridge)
"bj" = (
/obj/machinery/atmospherics/pipe/simple/supply/hidden/layer1{
	dir = 10
	},
/obj/machinery/atmospherics/components/unary/vent_scrubber/on/layer3,
/obj/structure/cable{
	icon_state = "1-2"
	},
/turf/open/floor/plasteel/dark,
/area/nsv/shuttle/bridge)
"bk" = (
/turf/open/floor/plasteel/dark,
/area/nsv/shuttle/bridge)
"bl" = (
/obj/structure/grille,
/obj/structure/window/reinforced/fulltile,
/turf/open/floor/plating/airless,
/area/nsv/shuttle/bridge)
"bm" = (
/obj/machinery/door/airlock/ship/external/glass{
	dir = 4;
	name = "Mining External airlock";
	req_one_access_txt = "48"
	},
/obj/structure/cable{
	icon_state = "4-8"
	},
/turf/open/floor/plasteel,
/area/nsv/shuttle/airlock/aft)
"bn" = (
/obj/structure/cable{
	icon_state = "4-8"
	},
/turf/open/floor/plasteel,
/area/nsv/shuttle/airlock/aft)
"bo" = (
/obj/machinery/atmospherics/pipe/simple/supply/hidden/layer1{
	dir = 6
	},
/obj/machinery/atmospherics/pipe/simple/scrubbers/hidden/layer3{
	dir = 5
	},
/obj/structure/cable{
	icon_state = "4-8"
	},
/turf/open/floor/plasteel,
/area/nsv/shuttle/airlock/aft)
"bp" = (
/obj/machinery/atmospherics/pipe/manifold/supply/hidden/layer1,
/obj/machinery/atmospherics/pipe/manifold/scrubbers/hidden/layer3{
	dir = 1
	},
/obj/structure/cable{
	icon_state = "4-8"
	},
/obj/structure/cable{
	icon_state = "1-8"
	},
/turf/open/floor/plasteel,
/area/nsv/shuttle/airlock/aft)
"bq" = (
/obj/machinery/atmospherics/pipe/simple/supply/hidden/layer1{
	dir = 4
	},
/obj/machinery/atmospherics/pipe/simple/scrubbers/hidden/layer3{
	dir = 4
	},
/obj/structure/cable{
	icon_state = "4-8"
	},
/turf/open/floor/plasteel,
/area/nsv/shuttle/airlock/aft)
"br" = (
/obj/machinery/door/airlock/ship/external/glass{
	dir = 4;
	name = "Mining External airlock";
	req_one_access_txt = "48"
	},
/obj/machinery/atmospherics/pipe/simple/supply/hidden/layer1{
	dir = 4
	},
/obj/machinery/atmospherics/pipe/simple/scrubbers/hidden/layer3{
	dir = 4
	},
/obj/structure/cable{
	icon_state = "4-8"
	},
/turf/open/floor/plasteel,
/area/nsv/shuttle/airlock/aft)
"bs" = (
/obj/machinery/atmospherics/pipe/simple/supply/hidden/layer1{
	dir = 4
	},
/obj/machinery/atmospherics/pipe/simple/scrubbers/hidden/layer3{
	dir = 4
	},
/obj/structure/cable{
	icon_state = "4-8"
	},
/turf/open/floor/plasteel,
/area/nsv/shuttle/central)
"bt" = (
/obj/machinery/atmospherics/pipe/manifold4w/supply/hidden/layer1,
/obj/machinery/atmospherics/pipe/manifold4w/scrubbers/hidden/layer3,
/obj/structure/cable{
	icon_state = "4-8"
	},
/obj/structure/cable{
	icon_state = "1-8"
	},
/obj/structure/cable{
	icon_state = "2-8"
	},
/turf/open/floor/plasteel,
/area/nsv/shuttle/central)
"bu" = (
/obj/machinery/atmospherics/pipe/simple/supply/hidden/layer1{
	dir = 4
	},
/obj/machinery/atmospherics/pipe/simple/scrubbers/hidden/layer3{
	dir = 4
	},
/obj/machinery/door/airlock/public/glass,
/obj/structure/cable{
	icon_state = "4-8"
	},
/turf/open/floor/plasteel,
/area/nsv/shuttle/central)
"bv" = (
/obj/machinery/atmospherics/pipe/simple/supply/hidden/layer1{
	dir = 4
	},
/obj/machinery/atmospherics/pipe/manifold/scrubbers/hidden/layer3{
	dir = 1
	},
/obj/structure/cable{
	icon_state = "4-8"
	},
/turf/open/floor/plasteel,
/area/nsv/shuttle/central)
"bw" = (
/obj/machinery/atmospherics/pipe/manifold4w/supply/hidden/layer1,
/obj/machinery/atmospherics/pipe/manifold4w/scrubbers/hidden/layer3,
/obj/structure/cable{
	icon_state = "4-8"
	},
/obj/structure/cable{
	icon_state = "1-8"
	},
/turf/open/floor/plasteel,
/area/nsv/shuttle/central)
"bx" = (
/obj/machinery/atmospherics/pipe/simple/supply/hidden/layer1{
	dir = 4
	},
/obj/machinery/atmospherics/pipe/simple/scrubbers/hidden/layer3{
	dir = 4
	},
/obj/structure/cable{
	icon_state = "4-8"
	},
/obj/machinery/airalarm/all_access{
	pixel_y = 23
	},
/turf/open/floor/plasteel,
/area/nsv/shuttle/central)
"by" = (
/obj/machinery/atmospherics/pipe/simple/supply/hidden/layer1{
	dir = 4
	},
/obj/machinery/atmospherics/pipe/simple/scrubbers/hidden/layer3{
	dir = 4
	},
/obj/structure/cable{
	icon_state = "4-8"
	},
/obj/structure/cable{
	icon_state = "0-8"
	},
/obj/machinery/power/apc/auto_name/north,
/turf/open/floor/plasteel,
/area/nsv/shuttle/central)
"bz" = (
/obj/machinery/atmospherics/pipe/manifold4w/supply/hidden/layer1,
/obj/machinery/atmospherics/pipe/manifold/scrubbers/hidden/layer3,
/obj/structure/cable{
	icon_state = "4-8"
	},
/obj/structure/cable{
	icon_state = "1-8"
	},
/turf/open/floor/plasteel,
/area/nsv/shuttle/central)
"bA" = (
/obj/machinery/atmospherics/pipe/simple/supply/hidden/layer1{
	dir = 4
	},
/obj/machinery/atmospherics/pipe/simple/scrubbers/hidden/layer3{
	dir = 4
	},
/obj/structure/cable{
	icon_state = "4-8"
	},
/obj/machinery/door/airlock/command/glass,
/turf/open/floor/plasteel/dark,
/area/nsv/shuttle/bridge)
"bB" = (
/obj/machinery/atmospherics/pipe/simple/supply/hidden/layer1{
	dir = 4
	},
/obj/machinery/atmospherics/pipe/simple/scrubbers/hidden/layer3{
	dir = 4
	},
/obj/structure/cable/yellow{
	icon_state = "1-2"
	},
/obj/structure/cable{
	icon_state = "4-8"
	},
/turf/open/floor/plasteel/dark,
/area/nsv/shuttle/bridge)
"bC" = (
/obj/machinery/atmospherics/pipe/manifold/supply/hidden/layer1{
	dir = 4
	},
/obj/machinery/atmospherics/pipe/manifold/scrubbers/hidden/layer3{
	dir = 4
	},
/obj/structure/cable{
	icon_state = "1-8"
	},
/turf/open/floor/plasteel/dark,
/area/nsv/shuttle/bridge)
"bD" = (
/obj/machinery/atmospherics/components/unary/vent_pump/on/layer1{
	dir = 1
	},
/obj/machinery/light,
/turf/open/floor/plasteel,
/area/nsv/shuttle/airlock/aft)
"bE" = (
/obj/machinery/atmospherics/components/unary/vent_scrubber/on/layer3{
	dir = 1
	},
/turf/open/floor/plasteel,
/area/nsv/shuttle/airlock/aft)
"bF" = (
/obj/machinery/atmospherics/components/unary/vent_scrubber/on/layer3{
	dir = 4
	},
/turf/open/floor/plasteel,
/area/nsv/shuttle/central)
"bG" = (
/obj/machinery/atmospherics/pipe/simple/supply/hidden/layer1,
/obj/machinery/atmospherics/pipe/manifold/scrubbers/hidden/layer3{
	dir = 4
	},
/obj/structure/cable{
	icon_state = "1-2"
	},
/turf/open/floor/plasteel,
/area/nsv/shuttle/central)
"bH" = (
/obj/machinery/light,
/turf/open/floor/plasteel,
/area/nsv/shuttle/central)
"bI" = (
/obj/machinery/atmospherics/components/unary/vent_scrubber/on/layer3{
	dir = 1
	},
/turf/open/floor/plasteel,
/area/nsv/shuttle/central)
"bJ" = (
/obj/machinery/atmospherics/pipe/simple/supply/hidden/layer1,
/obj/machinery/atmospherics/pipe/simple/scrubbers/hidden/layer3,
/obj/structure/cable/yellow{
	icon_state = "2-4"
	},
/turf/open/floor/plasteel,
/area/nsv/shuttle/central)
"bK" = (
/obj/structure/cable/yellow{
	icon_state = "4-8"
	},
/turf/open/floor/plasteel,
/area/nsv/shuttle/central)
"bL" = (
/obj/machinery/atmospherics/pipe/simple/scrubbers/hidden/layer3,
/obj/structure/cable/yellow{
	icon_state = "4-8"
	},
/turf/open/floor/plasteel,
/area/nsv/shuttle/central)
"bM" = (
/obj/machinery/atmospherics/pipe/simple/supply/hidden/layer1,
/obj/structure/cable/yellow{
	icon_state = "4-8"
	},
/turf/open/floor/plasteel,
/area/nsv/shuttle/central)
"bN" = (
/obj/structure/cable/yellow{
	icon_state = "4-8"
	},
/obj/machinery/light{
	dir = 4
	},
/turf/open/floor/plasteel,
/area/nsv/shuttle/central)
"bO" = (
/obj/structure/cable/yellow{
	icon_state = "4-8"
	},
/turf/closed/wall/mineral/titanium,
/area/nsv/shuttle/bridge)
"bP" = (
/obj/machinery/atmospherics/components/unary/vent_pump/on/layer1{
	dir = 4
	},
/obj/structure/cable/yellow{
	icon_state = "1-8"
	},
/turf/open/floor/plasteel/dark,
/area/nsv/shuttle/bridge)
"bQ" = (
/obj/machinery/atmospherics/pipe/simple/supply/hidden/layer1{
	dir = 9
	},
/obj/machinery/atmospherics/components/unary/vent_scrubber/on/layer3{
	dir = 1
	},
/turf/open/floor/plasteel/dark,
/area/nsv/shuttle/bridge)
"bR" = (
/turf/closed/wall/mineral/titanium,
/area/nsv/shuttle/atmospherics)
"bS" = (
/obj/machinery/door/airlock/ship/engineering{
	name = "Mining Atmospherics";
	req_one_access_txt = "48"
	},
/obj/machinery/atmospherics/pipe/simple/supply/hidden/layer1,
/obj/machinery/atmospherics/pipe/simple/scrubbers/hidden/layer3,
/obj/structure/cable{
	icon_state = "1-2"
	},
/turf/open/floor/plasteel,
/area/nsv/shuttle/atmospherics)
"bT" = (
/obj/structure/grille,
/obj/structure/window/reinforced/fulltile,
/turf/open/floor/plating,
/area/nsv/shuttle/airlock/starboard)
"bU" = (
/obj/machinery/door/airlock/ship/external/glass{
	dir = 2;
	name = "Mining External airlock";
	req_one_access_txt = "48"
	},
/obj/machinery/atmospherics/pipe/simple/supply/hidden/layer1,
/obj/machinery/atmospherics/pipe/simple/scrubbers/hidden/layer3,
/obj/structure/cable/yellow{
	icon_state = "1-2"
	},
/turf/open/floor/plasteel,
/area/nsv/shuttle/airlock/starboard)
"bV" = (
/obj/structure/window/reinforced{
	dir = 8
	},
/turf/open/floor/plasteel,
/area/nsv/shuttle/central)
"bW" = (
/obj/machinery/atmospherics/components/unary/vent_scrubber/on/layer3{
	dir = 1
	},
/obj/structure/table/wood,
/turf/open/floor/plasteel,
/area/nsv/shuttle/central)
"bX" = (
/obj/machinery/atmospherics/components/unary/vent_pump/on/layer1{
	dir = 1
	},
/obj/structure/table/wood,
/turf/open/floor/plasteel,
/area/nsv/shuttle/central)
"bY" = (
/obj/structure/table/wood,
/obj/machinery/microwave,
/turf/open/floor/plasteel,
/area/nsv/shuttle/central)
"bZ" = (
/obj/machinery/light{
	dir = 8
	},
/turf/open/floor/plasteel/dark,
/area/nsv/shuttle/bridge)
"ca" = (
/obj/structure/lattice,
/turf/open/space/basic,
/area/nsv/shuttle/atmospherics)
"cb" = (
/obj/machinery/atmospherics/components/unary/outlet_injector/on{
	dir = 4
	},
/turf/open/floor/plating/airless,
/area/nsv/shuttle/atmospherics)
"cc" = (
/obj/structure/grille,
/obj/machinery/atmospherics/pipe/simple/scrubbers/hidden{
	dir = 4
	},
/obj/structure/window/reinforced/fulltile,
/turf/open/floor/plating/airless,
/area/nsv/shuttle/atmospherics)
"cd" = (
/obj/machinery/atmospherics/components/trinary/filter/flipped{
	dir = 4;
	filter_type = "o2"
	},
/turf/open/floor/plating,
/area/nsv/shuttle/atmospherics)
"ce" = (
/obj/machinery/atmospherics/pipe/simple/scrubbers/hidden{
	dir = 4
	},
/obj/structure/rack,
/obj/item/storage/toolbox/mechanical,
/obj/item/storage/toolbox/mechanical,
/obj/item/storage/toolbox/electrical,
/turf/open/floor/plating,
/area/nsv/shuttle/atmospherics)
"cf" = (
/obj/machinery/atmospherics/pipe/simple/scrubbers/hidden{
	dir = 4
	},
/obj/machinery/airalarm/all_access{
	pixel_y = 23
	},
/obj/structure/rack,
/obj/item/storage/toolbox/mechanical,
/obj/item/storage/toolbox/mechanical,
/obj/item/storage/toolbox/electrical,
/turf/open/floor/plating,
/area/nsv/shuttle/atmospherics)
"cg" = (
/obj/machinery/atmospherics/pipe/layer_manifold{
	dir = 4
	},
/turf/open/floor/plating,
/area/nsv/shuttle/atmospherics)
"ch" = (
/obj/machinery/atmospherics/pipe/simple/supply/hidden/layer1,
/obj/machinery/atmospherics/pipe/manifold/scrubbers/hidden/layer3,
/obj/structure/cable{
	icon_state = "1-2"
	},
/turf/open/floor/plating,
/area/nsv/shuttle/atmospherics)
"ci" = (
/obj/machinery/atmospherics/components/unary/vent_scrubber/on/layer3{
	dir = 8
	},
/obj/machinery/light{
	dir = 1
	},
/turf/open/floor/plating,
/area/nsv/shuttle/atmospherics)
"cj" = (
/obj/structure/tank_dispenser,
/turf/open/floor/plating,
/area/nsv/shuttle/atmospherics)
"ck" = (
/obj/machinery/atmospherics/components/unary/vent_scrubber/on/layer3{
	dir = 4
	},
/obj/machinery/airalarm/all_access{
	dir = 4;
	pixel_x = -23
	},
/obj/machinery/suit_storage_unit/standard_unit,
/turf/open/floor/plasteel,
/area/nsv/shuttle/airlock/starboard)
"cl" = (
/obj/machinery/atmospherics/pipe/simple/scrubbers/hidden/layer3{
	dir = 9
	},
/obj/machinery/atmospherics/components/unary/vent_pump/on/layer1{
	dir = 1
	},
/obj/structure/cable/yellow{
	icon_state = "1-2"
	},
/turf/open/floor/plasteel,
/area/nsv/shuttle/airlock/starboard)
"cm" = (
/obj/structure/window/reinforced{
	dir = 4
	},
/obj/machinery/suit_storage_unit/standard_unit,
/turf/open/floor/plasteel,
/area/nsv/shuttle/airlock/starboard)
"cn" = (
/obj/structure/table/wood,
/turf/open/floor/plasteel,
/area/nsv/shuttle/central)
"co" = (
/turf/open/floor/plating/airless,
/area/nsv/shuttle/atmospherics)
"cp" = (
/obj/structure/window/reinforced{
	dir = 4
	},
/turf/open/floor/plating/airless,
/area/nsv/shuttle/atmospherics)
"cq" = (
/obj/machinery/atmospherics/pipe/layer_manifold,
/turf/open/floor/plating,
/area/nsv/shuttle/atmospherics)
"cr" = (
/turf/open/floor/plating,
/area/nsv/shuttle/atmospherics)
"cs" = (
/obj/machinery/atmospherics/pipe/simple/supply/hidden/layer1{
	dir = 6
	},
/turf/open/floor/plating,
/area/nsv/shuttle/atmospherics)
"ct" = (
/obj/machinery/atmospherics/components/binary/pump/layer1{
	dir = 4;
	name = "Air to Distro"
	},
/turf/open/floor/plating,
/area/nsv/shuttle/atmospherics)
"cu" = (
/obj/machinery/atmospherics/pipe/manifold/supply/hidden/layer1,
/obj/structure/cable{
	icon_state = "1-4"
	},
/turf/open/floor/plating,
/area/nsv/shuttle/atmospherics)
"cv" = (
/obj/machinery/atmospherics/components/unary/vent_pump/on/layer1{
	dir = 8
	},
/obj/structure/cable{
	icon_state = "4-8"
	},
/turf/open/floor/plating,
/area/nsv/shuttle/atmospherics)
"cw" = (
/obj/structure/cable{
	icon_state = "0-8"
	},
/obj/machinery/power/apc/auto_name/east,
/obj/machinery/vending/cigarette,
/turf/open/floor/plating,
/area/nsv/shuttle/atmospherics)
"cx" = (
/obj/machinery/suit_storage_unit/standard_unit,
/obj/machinery/light{
	dir = 8
	},
/turf/open/floor/plasteel,
/area/nsv/shuttle/airlock/starboard)
"cy" = (
/obj/structure/cable/yellow{
	icon_state = "1-2"
	},
/turf/open/floor/plasteel,
/area/nsv/shuttle/airlock/starboard)
"cz" = (
/obj/structure/window/reinforced{
	dir = 8
	},
/obj/machinery/light,
/turf/open/floor/plasteel,
/area/nsv/shuttle/central)
"cA" = (
/obj/structure/closet/secure_closet/freezer/kitchen/mining,
/turf/open/floor/plasteel,
/area/nsv/shuttle/central)
"cB" = (
/obj/machinery/atmospherics/pipe/simple/supply/hidden/layer1{
	dir = 5
	},
/obj/machinery/portable_atmospherics/canister/oxygen,
/turf/open/floor/plating,
/area/nsv/shuttle/atmospherics)
"cC" = (
/obj/machinery/atmospherics/components/binary/volume_pump/layer1{
	dir = 4
	},
/turf/open/floor/plating,
/area/nsv/shuttle/atmospherics)
"cD" = (
/obj/machinery/atmospherics/pipe/manifold4w/supply/hidden/layer1,
/turf/open/floor/plating,
/area/nsv/shuttle/atmospherics)
"cE" = (
/obj/machinery/atmospherics/components/unary/thermomachine/freezer{
	dir = 8
	},
/turf/open/floor/plating/airless,
/area/nsv/shuttle/atmospherics)
"cF" = (
/obj/structure/grille,
/obj/structure/window/reinforced/fulltile,
/turf/open/floor/plating/airless,
/area/nsv/shuttle/airlock/starboard)
"cG" = (
/obj/machinery/door/airlock/ship/external/glass{
	dir = 2;
	name = "Mining External airlock";
	req_one_access_txt = "48"
	},
/obj/structure/cable/yellow{
	icon_state = "1-2"
	},
/turf/open/floor/plating/airless,
/area/nsv/shuttle/airlock/starboard)
"cH" = (
/obj/structure/window/reinforced{
	dir = 4
	},
/obj/structure/window/reinforced{
	dir = 8
	},
/obj/machinery/vending/boozeomat/all_access,
/turf/open/floor/plasteel,
/area/nsv/shuttle/central)
"cI" = (
/obj/structure/shuttle/engine/huge{
	dir = 8
	},
/turf/open/floor/plating/airless,
/area/nsv/shuttle/atmospherics)
"cJ" = (
/obj/machinery/atmospherics/components/unary/tank/air{
	dir = 4
	},
/obj/machinery/light,
/turf/open/floor/plating,
/area/nsv/shuttle/atmospherics)
"cK" = (
/obj/machinery/atmospherics/pipe/layer_manifold{
	dir = 4
	},
/obj/structure/reagent_dispensers/fueltank,
/turf/open/floor/plating,
/area/nsv/shuttle/atmospherics)
"cL" = (
/obj/machinery/atmospherics/pipe/manifold/supply/hidden/layer1,
/obj/structure/reagent_dispensers/foamtank,
/turf/open/floor/plating,
/area/nsv/shuttle/atmospherics)
"cM" = (
/obj/machinery/atmospherics/components/unary/portables_connector/layer1{
	dir = 8
	},
/obj/structure/reagent_dispensers/watertank,
/turf/open/floor/plating,
/area/nsv/shuttle/atmospherics)
"cN" = (
/obj/structure/grille,
/obj/structure/window/reinforced/fulltile,
/turf/open/floor/plating/airless,
/area/nsv/shuttle/storage)

(1,1,1) = {"
aa
aa
aa
aa
aa
aa
aa
aa
aa
aa
aa
aa
aa
aa
aa
aa
aa
"}
(2,1,1) = {"
aa
ab
ag
ag
ap
ab
aN
aX
bm
aX
aN
ca
co
co
cI
ca
aa
"}
(3,1,1) = {"
aa
ac
ag
ag
ag
ag
aN
aY
bn
aY
aN
cb
co
co
co
bR
aa
"}
(4,1,1) = {"
aa
ac
ah
ah
ah
cN
aN
aZ
bo
bD
aN
cc
cp
cp
cp
bR
aa
"}
(5,1,1) = {"
aa
ac
ai
al
al
aB
aN
ba
bp
bE
aN
cd
cq
cB
cJ
bR
aa
"}
(6,1,1) = {"
aa
ac
ai
al
aq
aC
aN
bb
bq
aY
aN
ce
cr
cC
cK
bR
aa
"}
(7,1,1) = {"
aa
ac
aj
al
al
aD
aN
bc
br
bc
aN
cf
cs
cD
cL
bR
aa
"}
(8,1,1) = {"
aa
ac
ai
al
ar
aD
ac
bd
bs
bF
bR
cg
ct
cg
cM
bR
aa
"}
(9,1,1) = {"
aa
ac
ac
am
as
aE
aO
be
bt
bG
bS
ch
cu
cE
bR
bR
aa
"}
(10,1,1) = {"
aa
ab
ac
ac
at
aF
ac
av
bs
bH
bR
ci
cv
bR
bR
ca
aa
"}
(11,1,1) = {"
aa
ab
ab
ac
ac
ac
ac
af
bu
bf
bR
cj
cw
bR
ca
ca
aa
"}
(12,1,1) = {"
aa
ad
ad
af
au
aG
aP
af
bs
av
bR
bR
bR
bR
ca
ca
aa
"}
(13,1,1) = {"
aa
ad
ad
an
av
av
av
bf
bv
bI
bT
ck
cx
cF
ad
ad
aa
"}
(14,1,1) = {"
aa
ad
ad
an
av
aH
aQ
bg
bw
bJ
bU
cl
cy
cG
ad
ad
aa
"}
(15,1,1) = {"
aa
ad
ad
an
aw
av
aR
bf
bs
bK
bT
cm
cm
cF
ad
ad
aa
"}
(16,1,1) = {"
aa
ad
ad
af
ax
aI
aS
af
bx
bK
bV
bV
cz
af
ad
ad
aa
"}
(17,1,1) = {"
aa
ae
ak
af
af
af
af
af
by
bK
av
av
av
an
ae
ak
aa
"}
(18,1,1) = {"
aa
af
af
af
ay
aJ
aw
af
bv
bL
bW
av
av
af
af
af
aa
"}
(19,1,1) = {"
aa
af
af
af
az
aH
aQ
bh
bz
bM
bX
av
av
cH
af
af
aa
"}
(20,1,1) = {"
aa
af
af
af
aA
aK
aT
bf
bs
bN
bY
cn
cA
af
af
af
aa
"}
(21,1,1) = {"
aa
aa
ao
ao
ao
ao
ao
ao
bA
bO
ao
ao
ao
ao
ao
aa
aa
"}
(22,1,1) = {"
aa
aa
aa
ao
ao
aL
aU
bi
bB
bP
bZ
bk
ao
ao
aa
aa
aa
"}
(23,1,1) = {"
aa
aa
aa
aa
ao
aM
aV
bj
bC
bQ
bk
ao
ao
aa
aa
aa
aa
"}
(24,1,1) = {"
aa
aa
aa
aa
ao
ao
aW
bk
bk
bk
bk
ao
ao
aa
aa
aa
aa
"}
(25,1,1) = {"
aa
aa
aa
aa
aa
ao
ao
bl
bl
bl
ao
ao
aa
aa
aa
aa
aa
"}
(26,1,1) = {"
aa
aa
aa
aa
aa
aa
aa
aa
aa
aa
aa
aa
aa
aa
aa
aa
aa
"}
