//MAP CONVERTED BY dmm2tgm.py THIS HEADER COMMENT PREVENTS RECONVERSION, DO NOT REMOVE
"aa" = (
/turf/open/space/basic,
/area/space)
"ab" = (
/turf/closed/wall/ship,
/area/space)
"ac" = (
/obj/effect/spawner/structure/window/reinforced,
/turf/open/floor/plating,
/area/space)
"ad" = (
/obj/machinery/door/firedoor,
/turf/open/floor/plasteel/ship/techfloor/alt,
/area/space)
"ae" = (
/turf/open/floor/plating,
/area/space)
"af" = (
/obj/machinery/suit_storage_unit/pilot,
/turf/open/floor/carpet/black,
/area/space)
"ag" = (
/turf/open/floor/carpet/black,
/area/space)
"ah" = (
/obj/effect/landmark/start/fighter_pilot,
/turf/open/floor/carpet/black,
/area/space)
"ai" = (
/turf/open/floor/plasteel/ship/techfloor/alt,
/area/space)
"aj" = (
/turf/open/floor/plasteel/ship,
/area/space)
"ak" = (
/obj/effect/turf_decal/box/corners{
	icon_state = "box_corners";
	dir = 1
	},
/turf/open/floor/plating,
/area/space)
"al" = (
/obj/effect/turf_decal/box/corners{
	icon_state = "box_corners";
	dir = 4
	},
/turf/open/floor/plating,
/area/space)
"am" = (
/obj/effect/turf_decal/box/red/corners{
	icon_state = "box_corners_red";
	dir = 1
	},
/turf/open/floor/plating,
/area/space)
"an" = (
/obj/effect/turf_decal/box/red/corners{
	icon_state = "box_corners_red";
	dir = 4
	},
/turf/open/floor/plating,
/area/space)
"ao" = (
/obj/effect/turf_decal/box/white/corners{
	icon_state = "box_corners_white";
	dir = 1
	},
/turf/open/floor/plating,
/area/space)
"ap" = (
/obj/effect/turf_decal/box/white/corners{
	icon_state = "box_corners_white";
	dir = 4
	},
/turf/open/floor/plating,
/area/space)
"aq" = (
/obj/effect/turf_decal/delivery/white,
/turf/open/floor/plasteel/ship,
/area/space)
"ar" = (
/obj/structure/overmap/fighter/prebuilt,
/turf/open/floor/plating,
/area/space)
"as" = (
/obj/structure/overmap/fighter/prebuilt/raptor,
/turf/open/floor/plating,
/area/space)
"at" = (
/obj/effect/turf_decal/box/corners{
	icon_state = "box_corners";
	dir = 8
	},
/turf/open/floor/plating,
/area/space)
"au" = (
/obj/effect/turf_decal/box/corners,
/turf/open/floor/plating,
/area/space)
"av" = (
/obj/effect/turf_decal/box/red/corners{
	icon_state = "box_corners_red";
	dir = 8
	},
/turf/open/floor/plating,
/area/space)
"aw" = (
/obj/effect/turf_decal/box/red/corners,
/turf/open/floor/plating,
/area/space)
"ax" = (
/obj/effect/turf_decal/box/white/corners{
	icon_state = "box_corners_white";
	dir = 8
	},
/turf/open/floor/plating,
/area/space)
"ay" = (
/obj/effect/turf_decal/box/white/corners,
/turf/open/floor/plating,
/area/space)
"az" = (
/obj/machinery/door/firedoor,
/turf/open/floor/plasteel/ship/riveted,
/area/space)
"aA" = (
/obj/effect/turf_decal/loading_area,
/turf/open/floor/plasteel/ship,
/area/space)
"aB" = (
/obj/effect/turf_decal/loading_area/red,
/turf/open/floor/plasteel/ship,
/area/space)
"aC" = (
/obj/effect/turf_decal/loading_area/white,
/turf/open/floor/plasteel/ship,
/area/space)
"aD" = (
/obj/effect/turf_decal/caution/stand_clear,
/turf/open/floor/plasteel/ship,
/area/space)
"aE" = (
/obj/effect/turf_decal/caution/stand_clear/white,
/turf/open/floor/plasteel/ship,
/area/space)
"aF" = (
/obj/effect/turf_decal/arrows,
/turf/open/floor/plasteel/ship,
/area/space)
"aG" = (
/obj/effect/turf_decal/caution/white,
/turf/open/floor/plasteel/ship,
/area/space)
"aH" = (
/obj/effect/turf_decal/caution,
/turf/open/floor/plasteel/ship,
/area/space)
"aI" = (
/obj/effect/turf_decal/arrows/white,
/turf/open/floor/plasteel/ship,
/area/space)
"aJ" = (
/obj/machinery/door/firedoor,
/turf/open/floor/plasteel/dark,
/area/space)
"aK" = (
/turf/open/floor/plasteel/dark,
/area/space)
"aL" = (
/obj/structure/reagent_dispensers/fueltank,
/obj/machinery/light,
/turf/open/floor/plasteel/ship/techfloor/alt,
/area/space)
"aM" = (
/obj/effect/turf_decal/stripes/line,
/obj/machinery/atmospherics/pipe/simple/supply/hidden/layer1,
/turf/open/floor/plasteel/ship/techfloor/alt,
/area/space)
"aN" = (
/obj/effect/turf_decal/stripes/line,
/turf/open/floor/plasteel/ship/techfloor/alt,
/area/space)
"aO" = (
/obj/machinery/button/door{
	id = "launchbay_access";
	name = "Launch bay doors";
	pixel_y = -26;
	req_one_access_txt = "69"
	},
/turf/open/floor/plasteel/ship/techfloor/alt,
/area/space)
"aP" = (
/obj/machinery/light,
/obj/machinery/atmospherics/pipe/simple/scrubbers/hidden,
/obj/machinery/atmospherics/pipe/simple/supply/hidden/layer1,
/turf/open/floor/plasteel/ship/techfloor/alt,
/area/space)
"aQ" = (
/obj/machinery/door/poddoor/ship{
	id = "launchbay_access";
	name = "Launch tube access"
	},
/obj/machinery/atmospherics/pipe/simple/supply/hidden/layer1,
/turf/open/floor/plasteel/ship/techfloor/alt,
/area/space)
"aR" = (
/obj/machinery/door/poddoor/ship{
	id = "launchbay_access";
	name = "Launch tube access"
	},
/turf/open/floor/plasteel/ship/techfloor/alt,
/area/space)
"aS" = (
/obj/machinery/door/airlock/ship{
	name = "Launch control room 2";
	req_one_access_txt = "69"
	},
/turf/open/floor/plasteel/ship/padded,
/area/space)
"aT" = (
/obj/structure/extinguisher_cabinet{
	pixel_y = -4
	},
/obj/machinery/atmospherics/pipe/simple/scrubbers/hidden,
/obj/machinery/atmospherics/pipe/simple/supply/hidden/layer1,
/turf/closed/wall/ship,
/area/space)
"aU" = (
/obj/structure/cable,
/turf/open/floor/plating,
/area/space)
"aV" = (
/obj/structure/cable,
/obj/machinery/door/airlock/ship/maintenance{
	icon_state = "closed";
	dir = 8
	},
/turf/open/floor/plating,
/area/space)
"aW" = (
/obj/structure/cable,
/obj/effect/turf_decal/stripes/line,
/obj/machinery/atmospherics/pipe/simple/supply/hidden/layer1,
/turf/open/floor/plasteel/ship/riveted,
/area/space)
"aX" = (
/obj/structure/cable,
/obj/effect/turf_decal/stripes/line,
/turf/open/floor/plasteel/ship/riveted,
/area/space)
"aY" = (
/obj/structure/cable,
/turf/open/floor/plasteel/ship/riveted,
/area/space)
"aZ" = (
/obj/structure/cable,
/obj/machinery/light{
	dir = 1
	},
/obj/machinery/atmospherics/pipe/simple/scrubbers/hidden,
/obj/machinery/atmospherics/pipe/simple/supply/hidden/layer1,
/turf/open/floor/plasteel/ship/riveted,
/area/space)
"ba" = (
/turf/closed/wall/mineral/titanium,
/area/space)
"bb" = (
/turf/closed/wall/r_wall/ship,
/area/space)
"bc" = (
/obj/machinery/door/poddoor/ship{
	id = "launchbay_access2";
	name = "Launch tube access"
	},
/obj/machinery/atmospherics/pipe/simple/supply/hidden/layer1,
/turf/open/floor/plating,
/area/space)
"bd" = (
/obj/machinery/door/poddoor/ship{
	id = "launchbay_access2";
	name = "Launch tube access"
	},
/obj/structure/cable,
/turf/open/floor/plating,
/area/space)
"be" = (
/obj/machinery/door/poddoor/ship{
	id = "launchbay_access2";
	name = "Launch tube access"
	},
/turf/open/floor/plating,
/area/space)
"bf" = (
/obj/machinery/door/airlock/ship{
	name = "Launch control room 2";
	req_one_access_txt = "69"
	},
/obj/machinery/atmospherics/pipe/simple/scrubbers/hidden,
/obj/machinery/atmospherics/pipe/simple/supply/hidden/layer1,
/turf/open/floor/plasteel/ship,
/area/space)
"bg" = (
/obj/effect/turf_decal/stripes/line{
	dir = 8
	},
/obj/machinery/atmospherics/components/unary/vent_pump/high_volume/on/layer1{
	icon_state = "vent_map_on-1";
	dir = 1
	},
/turf/open/floor/plating,
/area/space)
"bh" = (
/obj/structure/lattice/catwalk,
/obj/structure/cable,
/turf/open/floor/plating,
/area/space)
"bi" = (
/obj/effect/turf_decal/stripes/line{
	dir = 4
	},
/turf/open/floor/plating,
/area/space)
"bj" = (
/obj/machinery/computer/ship/viewscreen,
/obj/effect/turf_decal/stripes/line{
	dir = 8
	},
/obj/machinery/computer/ship/dradis/minor,
/turf/open/floor/plasteel/ship,
/area/space)
"bk" = (
/obj/structure/cable,
/obj/machinery/atmospherics/pipe/simple/supply/hidden/layer1,
/obj/machinery/atmospherics/components/unary/vent_scrubber/on{
	dir = 1
	},
/turf/open/floor/plasteel/ship,
/area/space)
"bl" = (
/obj/effect/turf_decal/stripes/line{
	dir = 4
	},
/obj/machinery/button/door{
	dir = 8;
	id = "launchbay_access2";
	name = "Launch bay doors";
	pixel_x = 22;
	pixel_y = 0;
	req_one_access_txt = "69"
	},
/obj/structure/table/reinforced,
/obj/item/clothing/ears/earmuffs,
/obj/machinery/power/apc/auto_name/north,
/obj/structure/cable,
/turf/open/floor/plasteel/ship,
/area/space)
"bm" = (
/obj/effect/turf_decal/stripes/line{
	dir = 8
	},
/turf/open/floor/plating,
/area/space)
"bn" = (
/obj/effect/turf_decal/stripes/line{
	dir = 4
	},
/obj/machinery/atmospherics/components/unary/vent_pump/high_volume/on/layer1{
	icon_state = "vent_map_on-1";
	dir = 1
	},
/turf/open/floor/plating,
/area/space)
"bo" = (
/obj/structure/lattice/catwalk,
/turf/open/space/basic,
/area/space)
"bp" = (
/obj/effect/turf_decal/stripes/line{
	dir = 8
	},
/obj/machinery/light{
	dir = 8
	},
/obj/structure/fighter_launcher{
	name = "electromagnetic catapult 3";
	pixel_x = 38;
	pixel_y = -64
	},
/turf/open/floor/plating,
/area/space)
"bq" = (
/obj/structure/window/reinforced/fulltile/ship,
/turf/open/floor/plasteel/ship/padded,
/area/space)
"br" = (
/obj/effect/turf_decal/stripes/line{
	dir = 8
	},
/turf/open/floor/plasteel/ship,
/area/space)
"bs" = (
/obj/structure/chair/office,
/obj/machinery/atmospherics/components/unary/vent_pump/high_volume/on/layer1{
	icon_state = "vent_map_on-1";
	dir = 1
	},
/turf/open/floor/plasteel/ship/padded,
/area/space)
"bt" = (
/obj/effect/turf_decal/stripes/line{
	dir = 4
	},
/turf/open/floor/plasteel/ship,
/area/space)
"bu" = (
/obj/effect/turf_decal/stripes/line{
	dir = 8
	},
/obj/structure/fighter_launcher{
	name = "electromagnetic catapult 4";
	pixel_x = 38;
	pixel_y = -64
	},
/turf/open/floor/plating,
/area/space)
"bv" = (
/obj/effect/turf_decal/stripes/line{
	dir = 4
	},
/obj/machinery/light{
	dir = 4
	},
/turf/open/floor/plating,
/area/space)
"bw" = (
/obj/structure/grille,
/obj/structure/window/reinforced/fulltile/ship,
/turf/open/floor/plating,
/area/space)
"bx" = (
/obj/structure/lattice/catwalk,
/turf/open/floor/plating,
/area/space)
"by" = (
/obj/machinery/button/door{
	id = "launch3";
	name = "Tube 3 exterior doors";
	pixel_y = 0;
	req_one_access_txt = "69"
	},
/obj/structure/table/reinforced,
/obj/effect/turf_decal/stripes/line{
	dir = 8
	},
/turf/open/floor/plasteel/ship,
/area/space)
"bz" = (
/obj/machinery/computer/ship/fighter_launcher{
	icon_state = "computer";
	dir = 1
	},
/turf/open/floor/plasteel/ship,
/area/space)
"bA" = (
/obj/machinery/button/door{
	id = "launch4";
	name = "Tube 4 exterior doors";
	pixel_y = 0;
	req_one_access_txt = "69"
	},
/obj/structure/table/reinforced,
/obj/effect/turf_decal/stripes/line{
	dir = 4
	},
/turf/open/floor/plasteel/ship,
/area/space)
"bB" = (
/turf/open/floor/mineral/plastitanium,
/area/space)
"bC" = (
/obj/structure/window/reinforced/fulltile/ship,
/turf/open/floor/plasteel/ship,
/area/space)
"bD" = (
/obj/machinery/door/poddoor/ship{
	id = "launch3"
	},
/obj/effect/turf_decal/stripes/line{
	dir = 10
	},
/turf/open/floor/plating,
/area/space)
"bE" = (
/obj/machinery/door/poddoor/ship{
	id = "launch3"
	},
/obj/effect/turf_decal/stripes/line,
/turf/open/floor/plating,
/area/space)
"bF" = (
/obj/machinery/door/poddoor/ship{
	id = "launch3"
	},
/obj/effect/turf_decal/stripes/line{
	dir = 6
	},
/turf/open/floor/plating,
/area/space)
"bG" = (
/obj/machinery/door/poddoor/ship{
	id = "launch4"
	},
/obj/effect/turf_decal/stripes/line{
	dir = 10
	},
/turf/open/floor/plating,
/area/space)
"bH" = (
/obj/machinery/door/poddoor/ship{
	id = "launch4"
	},
/obj/effect/turf_decal/stripes/line,
/turf/open/floor/plating,
/area/space)
"bI" = (
/obj/machinery/door/poddoor/ship{
	id = "launch4"
	},
/obj/effect/turf_decal/stripes/line{
	dir = 6
	},
/turf/open/floor/plating,
/area/space)
"bJ" = (
/obj/structure/lattice,
/obj/machinery/light/runway/delay5,
/turf/open/space/basic,
/area/space)
"bK" = (
/obj/structure/lattice,
/obj/machinery/light/runway/delay4,
/turf/open/space/basic,
/area/space)
"bL" = (
/obj/structure/lattice,
/obj/machinery/light/runway/delay3,
/turf/open/space/basic,
/area/space)
"bM" = (
/obj/structure/lattice,
/obj/machinery/light/runway/delay2,
/turf/open/space/basic,
/area/space)
"bN" = (
/obj/structure/lattice,
/obj/machinery/light/runway,
/turf/open/space/basic,
/area/space)
"bO" = (
/obj/effect/turf_decal/delivery,
/turf/open/floor/plating,
/area/space)
"bP" = (
/obj/effect/turf_decal/delivery/white,
/turf/open/floor/plating,
/area/space)
"bQ" = (
/obj/structure/lattice,
/turf/open/space/basic,
/area/space)

(1,1,1) = {"
aa
aa
aa
aa
aa
aa
aa
aa
aa
aa
aa
aa
aa
aa
aa
aa
aa
aa
aa
aa
aa
aa
aa
aa
aa
aa
aa
aa
aa
aa
aa
aa
aa
aa
aa
aa
aa
aa
aa
aa
aa
aa
aa
aa
aa
aa
aa
aa
aa
aa
"}
(2,1,1) = {"
aa
aa
aa
aa
aa
aa
aa
aa
aa
aa
aa
aa
aa
aa
aa
aa
aa
aa
aa
aa
aa
aa
aa
aa
aa
aa
aa
aa
aa
aa
aa
aa
aa
aa
aa
aa
aa
aa
aa
aa
aa
aa
aa
aa
aa
aa
aa
aa
aa
aa
"}
(3,1,1) = {"
aa
aa
aa
aa
aa
aa
aa
aa
aa
aa
aa
aa
aa
aa
aa
aa
aa
aa
aa
aa
aa
aa
aa
aa
aa
aa
aa
aa
aa
aa
aa
aa
aa
aa
aa
aa
aa
aa
aa
aa
aa
aa
aa
aa
aa
aa
aa
aa
aa
aa
"}
(4,1,1) = {"
aa
aa
aa
aa
aa
aa
aa
aa
aa
aa
aa
aa
aa
aa
aa
aa
aa
aa
aa
aa
aa
aa
aa
aa
aa
aa
aa
aa
aa
aa
aa
aa
aa
aa
aa
aa
aa
aa
aa
aa
aa
aa
aa
aa
aa
aa
aa
aa
aa
aa
"}
(5,1,1) = {"
aa
aa
aa
aa
aa
aa
aa
aa
aa
aa
aa
aa
aa
aa
aa
aa
aa
aa
aa
aa
aa
aa
aa
aa
aa
aa
aa
aa
aa
aa
aa
aa
aa
aa
aa
aa
aa
aa
aa
aa
aa
aa
aa
aa
aa
aa
aa
aa
aa
aa
"}
(6,1,1) = {"
aa
aa
aa
aa
aa
aa
aa
aa
aa
aa
aa
aa
aa
aa
aa
aa
aa
aa
aa
aa
aa
aa
aa
aa
aa
aa
aa
aa
aa
aa
aa
aa
aa
aa
aa
aa
aa
aa
aa
aa
aa
aa
aa
aa
aa
aa
aa
aa
aa
aa
"}
(7,1,1) = {"
aa
aa
aa
aa
aa
aa
aa
aa
aa
aa
aa
aa
aa
aa
aa
aa
aa
aa
aa
aa
aa
aa
aa
aa
aa
aa
aa
aa
aa
aa
aa
aa
aa
aa
aa
aa
aa
aa
aa
aa
aa
aa
aa
aa
aa
aa
aa
aa
aa
aa
"}
(8,1,1) = {"
aa
aa
aa
ab
ab
ab
ab
ab
ab
ab
ab
ab
ab
ab
ab
ab
ab
aJ
aJ
aJ
ab
aa
aa
ba
ba
ba
ba
bB
ba
ba
ba
aa
aa
aa
aa
aa
aa
aa
aa
aa
aa
aa
aa
aa
aa
aa
aa
aa
aa
aa
"}
(9,1,1) = {"
aa
aa
aa
ab
af
af
af
ag
ag
ag
ag
ag
ag
af
af
af
ab
aK
aK
aK
ab
aa
aa
aa
aa
aa
bw
ae
bw
aa
aa
aa
aa
aa
aa
aa
aa
aa
aa
aa
aa
aa
aa
aa
aa
aa
aa
aa
aa
aa
"}
(10,1,1) = {"
aa
aa
aa
ab
ag
ag
ag
ag
ag
ag
ag
ag
ag
ag
ag
ag
aJ
aK
aK
aK
ab
ab
ab
ab
ab
ab
ab
ae
ab
ab
aa
aa
aa
aa
aa
aa
aa
aa
aa
aa
aa
aa
aa
aa
aa
aa
aa
aa
aa
aa
"}
(11,1,1) = {"
aa
aa
aa
ab
ag
ag
ag
ag
ag
ag
ag
ag
ag
ag
ag
ag
aJ
aK
aK
aK
ae
ae
ae
ae
ae
ae
ae
ae
ae
ab
aa
aa
aa
aa
aa
aa
aa
aa
aa
aa
aa
aa
aa
aa
aa
aa
aa
aa
aa
aa
"}
(12,1,1) = {"
aa
aa
aa
ab
ah
ah
ah
ag
ag
ag
ag
ag
ag
ah
ah
ah
ab
aK
aK
aK
ab
ae
ae
ae
ab
ab
ab
ab
ab
ab
aa
aa
aa
aa
aa
aa
aa
aa
aa
aa
aa
aa
aa
aa
aa
aa
aa
aa
aa
aa
"}
(13,1,1) = {"
aa
aa
aa
ab
ac
ac
ac
ab
ab
az
az
ab
ab
ac
ac
ac
ab
ab
ab
ab
ab
ab
aU
aU
bb
bo
bo
bo
bo
bo
bo
bo
bo
bo
bo
bo
bo
bo
bo
bo
bo
bo
bo
bo
bo
bo
bo
bo
aa
aa
"}
(14,1,1) = {"
aa
aa
aa
ab
ai
ai
ai
ai
ai
ai
ai
ai
ai
ai
ai
ai
ai
ai
ai
ai
aL
ab
aV
bb
bb
bb
bb
bb
bb
bJ
bK
bL
bM
bN
bQ
bQ
bQ
bQ
bQ
bQ
bQ
bQ
bJ
bK
bL
bM
bN
bo
aa
aa
"}
(15,1,1) = {"
aa
aa
aa
ac
ai
ak
ae
ar
at
ai
aj
aj
aj
aj
ai
aj
aj
aj
aj
aj
aM
aQ
aW
bc
bg
bp
bm
bm
bD
aa
aa
aa
aa
bO
aa
aa
aa
aa
aa
aa
aa
aa
aa
aa
aa
aa
aa
bo
aa
aa
"}
(16,1,1) = {"
aa
aa
aa
ac
ai
ae
ae
ae
ae
ai
aA
aj
aj
aD
ai
aF
aj
aF
aj
aF
aN
aR
aX
bd
bh
bh
bx
bx
bE
aa
aa
aa
aa
bO
aa
aa
aa
aa
aa
aa
aa
aa
aa
aa
aa
aa
aa
bo
aa
aa
"}
(17,1,1) = {"
aa
aa
aa
ac
ai
al
ae
ae
au
ai
aj
aj
aj
aj
ai
aj
aj
aj
aj
aj
aN
aR
aX
be
bi
bi
bi
bi
bF
aa
aa
aa
aa
bO
aa
aa
aa
aa
aa
aa
aa
aa
aa
aa
aa
aa
aa
bo
aa
aa
"}
(18,1,1) = {"
aa
aa
aa
ab
ai
ai
ai
ai
ai
ai
ai
ai
ai
ai
ai
ai
ai
ai
ai
ai
aO
ab
aY
bb
bb
bq
bq
bb
bb
bJ
bK
bL
bM
bN
bQ
bQ
bQ
bQ
bQ
bQ
bQ
bQ
bJ
bK
bL
bM
bN
bo
aa
aa
"}
(19,1,1) = {"
aa
aa
aa
ac
ai
am
ae
as
av
ai
aj
aj
aj
aj
ai
aG
aj
aj
aj
aj
ai
aS
aY
bb
bj
br
by
bC
bo
bo
bo
bo
bo
bo
bo
bo
bo
bo
bo
bo
bo
bo
bo
bo
bo
bo
bo
bo
aa
aa
"}
(20,1,1) = {"
aa
aa
aa
ac
ai
ae
ae
ae
ae
ai
aB
aj
aj
aj
ai
aH
aj
aj
aj
aj
aP
aT
aZ
bf
bk
bs
bz
bC
bo
aa
aa
aa
aa
bo
aa
aa
aa
aa
aa
aa
aa
aa
aa
aa
aa
aa
bo
bo
aa
aa
"}
(21,1,1) = {"
aa
aa
aa
ac
ai
an
ae
ae
aw
ai
aj
aj
aj
aj
ai
aG
aj
aj
aj
aj
ai
aS
aY
bb
bl
bt
bA
bC
bo
bo
bo
bo
bo
bo
bo
bo
bo
bo
bo
bo
bo
bo
bo
bo
bo
bo
bo
bo
aa
aa
"}
(22,1,1) = {"
aa
aa
aa
ab
ai
ai
ai
ai
ai
ai
ai
ai
ai
ai
ai
ai
ai
ai
ai
ai
aO
ab
aY
bb
bb
bq
bq
bb
bb
bJ
bK
bL
bM
bN
bQ
bQ
bQ
bQ
bQ
bQ
bQ
bQ
bJ
bK
bL
bM
bN
bo
aa
aa
"}
(23,1,1) = {"
aa
aa
aa
ac
ai
ao
ae
ar
ax
ai
aj
aj
aj
aj
ai
aj
aj
aj
aj
aj
aN
aR
aX
be
bm
bu
bm
bm
bG
aa
aa
aa
aa
bP
aa
aa
aa
aa
aa
aa
aa
aa
aa
aa
aa
aa
aa
bo
aa
aa
"}
(24,1,1) = {"
aa
aa
aa
ac
ai
ae
ae
ae
ae
ai
aC
aj
aj
aE
ai
aI
aj
aI
aj
aI
aN
aR
aX
bd
bh
bh
bx
bx
bH
aa
aa
aa
aa
bP
aa
aa
aa
aa
aa
aa
aa
aa
aa
aa
aa
aa
aa
bo
aa
aa
"}
(25,1,1) = {"
aa
aa
aa
ab
ai
ap
ae
ae
ay
ai
aj
aj
aj
aj
ai
aj
aj
aj
aj
aj
aM
aQ
aW
bc
bn
bv
bi
bi
bI
aa
aa
aa
aa
bP
aa
aa
aa
aa
aa
aa
aa
aa
aa
aa
aa
aa
aa
bo
aa
aa
"}
(26,1,1) = {"
aa
aa
aa
ad
ai
ai
ai
ai
ai
ai
ai
ai
ai
ai
ai
ai
ai
ai
ai
ai
ai
ab
aV
bb
bb
bb
bb
bb
bb
bJ
bK
bL
bM
bN
bQ
bQ
bQ
bQ
bQ
bQ
bQ
bQ
bJ
bK
bL
bM
bN
bo
aa
aa
"}
(27,1,1) = {"
aa
aa
aa
ab
aj
aq
aq
aq
aq
ai
ab
ab
ab
ab
ai
aq
aq
aq
aq
aq
ai
ab
aU
aU
ae
ae
ae
bo
bo
bo
bo
bo
bo
bo
bo
bo
bo
bo
bo
bo
bo
bo
bo
bo
bo
bo
bo
bo
aa
aa
"}
(28,1,1) = {"
aa
aa
aa
ad
ai
ai
ai
ai
ai
ai
ai
ai
ai
ai
ai
ai
ai
ai
ai
ai
aL
ab
aV
bb
bb
bb
bb
bb
bb
bJ
bK
bL
bM
bN
bQ
bQ
bQ
bQ
bQ
bQ
bQ
bQ
bJ
bK
bL
bM
bN
bo
aa
aa
"}
(29,1,1) = {"
aa
aa
aa
ab
ai
ao
ae
ar
ax
ai
aj
aj
aj
aj
ai
aj
aj
aj
aj
aj
aM
aQ
aW
bc
bg
bp
bm
bm
bD
aa
aa
aa
aa
bP
aa
aa
aa
aa
aa
aa
aa
aa
aa
aa
aa
aa
aa
bo
aa
aa
"}
(30,1,1) = {"
aa
aa
aa
ac
ai
ae
ae
ae
ae
ai
aC
aj
aj
aE
ai
aI
aj
aI
aj
aI
aN
aR
aX
bd
bh
bh
bx
bx
bE
aa
aa
aa
aa
bP
aa
aa
aa
aa
aa
aa
aa
aa
aa
aa
aa
aa
aa
bo
aa
aa
"}
(31,1,1) = {"
aa
aa
aa
ac
ai
ap
ae
ae
ay
ai
aj
aj
aj
aj
ai
aj
aj
aj
aj
aj
aN
aR
aX
be
bi
bi
bi
bi
bF
aa
aa
aa
aa
bP
aa
aa
aa
aa
aa
aa
aa
aa
aa
aa
aa
aa
aa
bo
aa
aa
"}
(32,1,1) = {"
aa
aa
aa
ab
ai
ai
ai
ai
ai
ai
ai
ai
ai
ai
ai
ai
ai
ai
ai
ai
aO
ab
aY
bb
bb
bq
bq
bb
bb
bJ
bK
bL
bM
bN
bQ
bQ
bQ
bQ
bQ
bQ
bQ
bQ
bJ
bK
bL
bM
bN
bo
aa
aa
"}
(33,1,1) = {"
aa
aa
aa
ac
ai
am
ae
ae
av
ai
aj
aj
aj
aj
ai
aG
aj
aj
aj
aj
ai
aS
aY
bb
bj
br
by
bC
bo
bo
bo
bo
bo
bo
bo
bo
bo
bo
bo
bo
bo
bo
bo
bo
bo
bo
bo
bo
aa
aa
"}
(34,1,1) = {"
aa
aa
aa
ac
ai
ae
ae
ae
ae
ai
aB
aj
aj
aj
ai
aH
aj
aj
aj
aj
aP
aT
aZ
bf
bk
bs
bz
bC
bo
aa
aa
aa
aa
bo
aa
aa
aa
aa
aa
aa
aa
aa
aa
aa
aa
aa
bo
bo
aa
aa
"}
(35,1,1) = {"
aa
aa
aa
ac
ai
an
ae
ae
aw
ai
aj
aj
aj
aj
ai
aG
aj
aj
aj
aj
ai
aS
aY
bb
bl
bt
bA
bC
bo
bo
bo
bo
bo
bo
bo
bo
bo
bo
bo
bo
bo
bo
bo
bo
bo
bo
bo
bo
aa
aa
"}
(36,1,1) = {"
aa
aa
aa
ab
ai
ai
ai
ai
ai
ai
ai
ai
ai
ai
ai
ai
ai
ai
ai
ai
aO
ab
aY
bb
bb
bq
bq
bb
bb
bJ
bK
bL
bM
bN
bQ
bQ
bQ
bQ
bQ
bQ
bQ
bQ
bJ
bK
bL
bM
bN
bo
aa
aa
"}
(37,1,1) = {"
aa
aa
aa
ac
ai
ak
ae
ar
at
ai
aj
aj
aj
aj
ai
aj
aj
aj
aj
aj
aN
aR
aX
be
bm
bu
bm
bm
bG
aa
aa
aa
aa
bO
aa
aa
aa
aa
aa
aa
aa
aa
aa
aa
aa
aa
aa
bo
aa
aa
"}
(38,1,1) = {"
aa
aa
aa
ac
ai
ae
ae
ae
ae
ai
aA
aj
aj
aD
ai
aF
aj
aF
aj
aF
aN
aR
aX
bd
bh
bh
bx
bx
bH
aa
aa
aa
aa
bO
aa
aa
aa
aa
aa
aa
aa
aa
aa
aa
aa
aa
aa
bo
aa
aa
"}
(39,1,1) = {"
aa
aa
aa
ac
ai
al
ae
ae
au
ai
aj
aj
aj
aj
ai
aj
aj
aj
aj
aj
aM
aQ
aW
bc
bn
bv
bi
bi
bI
aa
aa
aa
aa
bO
aa
aa
aa
aa
aa
aa
aa
aa
aa
aa
aa
aa
aa
bo
aa
aa
"}
(40,1,1) = {"
aa
aa
aa
ab
ai
ai
ai
ai
ai
ai
ai
ai
ai
ai
ai
ai
ai
ai
ai
ai
ab
ab
aV
bb
bb
bb
bb
bb
bb
bJ
bK
bL
bM
bN
bQ
bQ
bQ
bQ
bQ
bQ
bQ
bQ
bJ
bK
bL
bM
bN
bo
aa
aa
"}
(41,1,1) = {"
aa
aa
aa
ab
ab
ab
ab
ab
ab
ab
ab
ab
ab
ab
ab
ab
ab
ab
ab
ab
ab
aU
aU
bb
bo
bo
bo
bo
bo
bo
bo
bo
bo
bo
bo
bo
bo
bo
bo
bo
bo
bo
bo
bo
bo
bo
bo
bo
aa
aa
"}
(42,1,1) = {"
aa
aa
aa
ae
ae
ae
ae
ae
ae
ae
ae
ae
ae
ae
ae
ae
ae
ae
ae
ae
ae
ae
ae
ae
aa
aa
aa
aa
aa
aa
aa
aa
aa
aa
aa
aa
aa
aa
aa
aa
aa
aa
aa
aa
aa
aa
aa
aa
aa
aa
"}
(43,1,1) = {"
aa
aa
aa
ab
ab
ab
ab
ab
ab
ab
ab
ab
ab
ab
ab
ab
ab
ab
ae
ab
ab
ae
ae
ab
aa
aa
aa
aa
aa
aa
aa
aa
aa
aa
aa
aa
aa
aa
aa
aa
aa
aa
aa
aa
aa
aa
aa
aa
aa
aa
"}
(44,1,1) = {"
aa
aa
aa
aa
aa
aa
aa
aa
aa
aa
aa
aa
aa
aa
aa
aa
aa
aa
aa
aa
aa
aa
aa
aa
aa
aa
aa
aa
aa
aa
aa
aa
aa
aa
aa
aa
aa
aa
aa
aa
aa
aa
aa
aa
aa
aa
aa
aa
aa
aa
"}
(45,1,1) = {"
aa
aa
aa
aa
aa
aa
aa
aa
aa
aa
aa
aa
aa
aa
aa
aa
aa
aa
aa
aa
aa
aa
aa
aa
aa
aa
aa
aa
aa
aa
aa
aa
aa
aa
aa
aa
aa
aa
aa
aa
aa
aa
aa
aa
aa
aa
aa
aa
aa
aa
"}
(46,1,1) = {"
aa
aa
aa
aa
aa
aa
aa
aa
aa
aa
aa
aa
aa
aa
aa
aa
aa
aa
aa
aa
aa
aa
aa
aa
aa
aa
aa
aa
aa
aa
aa
aa
aa
aa
aa
aa
aa
aa
aa
aa
aa
aa
aa
aa
aa
aa
aa
aa
aa
aa
"}
(47,1,1) = {"
aa
aa
aa
aa
aa
aa
aa
aa
aa
aa
aa
aa
aa
aa
aa
aa
aa
aa
aa
aa
aa
aa
aa
aa
aa
aa
aa
aa
aa
aa
aa
aa
aa
aa
aa
aa
aa
aa
aa
aa
aa
aa
aa
aa
aa
aa
aa
aa
aa
aa
"}
(48,1,1) = {"
aa
aa
aa
aa
aa
aa
aa
aa
aa
aa
aa
aa
aa
aa
aa
aa
aa
aa
aa
aa
aa
aa
aa
aa
aa
aa
aa
aa
aa
aa
aa
aa
aa
aa
aa
aa
aa
aa
aa
aa
aa
aa
aa
aa
aa
aa
aa
aa
aa
aa
"}
(49,1,1) = {"
aa
aa
aa
aa
aa
aa
aa
aa
aa
aa
aa
aa
aa
aa
aa
aa
aa
aa
aa
aa
aa
aa
aa
aa
aa
aa
aa
aa
aa
aa
aa
aa
aa
aa
aa
aa
aa
aa
aa
aa
aa
aa
aa
aa
aa
aa
aa
aa
aa
aa
"}
(50,1,1) = {"
aa
aa
aa
aa
aa
aa
aa
aa
aa
aa
aa
aa
aa
aa
aa
aa
aa
aa
aa
aa
aa
aa
aa
aa
aa
aa
aa
aa
aa
aa
aa
aa
aa
aa
aa
aa
aa
aa
aa
aa
aa
aa
aa
aa
aa
aa
aa
aa
aa
aa
"}
