"aa" = (/turf/open/space/basic,/area/space)
"ab" = (/turf/closed/wall/ship,/area/space)
"ac" = (/obj/effect/spawner/structure/window/reinforced,/turf/open/floor/plating,/area/space)
"ad" = (/obj/machinery/door/firedoor,/turf/open/floor/plasteel/ship/techfloor/alt,/area/space)
"ae" = (/turf/open/floor/plating,/area/space)
"af" = (/obj/machinery/suit_storage_unit/pilot,/turf/open/floor/carpet/black,/area/space)
"ag" = (/turf/open/floor/carpet/black,/area/space)
"ah" = (/obj/effect/landmark/start/fighter_pilot,/turf/open/floor/carpet/black,/area/space)
"ai" = (/turf/open/floor/plasteel/ship/techfloor/alt,/area/space)
"aj" = (/turf/open/floor/plasteel/ship,/area/space)
"ak" = (/obj/effect/turf_decal/box/corners{icon_state = "box_corners"; dir = 1},/turf/open/floor/plating,/area/space)
"al" = (/obj/effect/turf_decal/box/corners{icon_state = "box_corners"; dir = 4},/turf/open/floor/plating,/area/space)
"am" = (/obj/effect/turf_decal/box/red/corners{icon_state = "box_corners_red"; dir = 1},/turf/open/floor/plating,/area/space)
"an" = (/obj/effect/turf_decal/box/red/corners{icon_state = "box_corners_red"; dir = 4},/turf/open/floor/plating,/area/space)
"ao" = (/obj/effect/turf_decal/box/white/corners{icon_state = "box_corners_white"; dir = 1},/turf/open/floor/plating,/area/space)
"ap" = (/obj/effect/turf_decal/box/white/corners{icon_state = "box_corners_white"; dir = 4},/turf/open/floor/plating,/area/space)
"aq" = (/obj/effect/turf_decal/delivery/white,/turf/open/floor/plasteel/ship,/area/space)
"ar" = (/obj/structure/overmap/fighter/prebuilt,/turf/open/floor/plating,/area/space)
"as" = (/obj/structure/overmap/fighter/prebuilt/raptor,/turf/open/floor/plating,/area/space)
"at" = (/obj/effect/turf_decal/box/corners{icon_state = "box_corners"; dir = 8},/turf/open/floor/plating,/area/space)
"au" = (/obj/effect/turf_decal/box/corners,/turf/open/floor/plating,/area/space)
"av" = (/obj/effect/turf_decal/box/red/corners{icon_state = "box_corners_red"; dir = 8},/turf/open/floor/plating,/area/space)
"aw" = (/obj/effect/turf_decal/box/red/corners,/turf/open/floor/plating,/area/space)
"ax" = (/obj/effect/turf_decal/box/white/corners{icon_state = "box_corners_white"; dir = 8},/turf/open/floor/plating,/area/space)
"ay" = (/obj/effect/turf_decal/box/white/corners,/turf/open/floor/plating,/area/space)
"az" = (/obj/machinery/door/firedoor,/turf/open/floor/plasteel/ship/riveted,/area/space)
"aA" = (/obj/effect/turf_decal/loading_area,/turf/open/floor/plasteel/ship,/area/space)
"aB" = (/obj/effect/turf_decal/loading_area/red,/turf/open/floor/plasteel/ship,/area/space)
"aC" = (/obj/effect/turf_decal/loading_area/white,/turf/open/floor/plasteel/ship,/area/space)
"aD" = (/obj/effect/turf_decal/caution/stand_clear,/turf/open/floor/plasteel/ship,/area/space)
"aE" = (/obj/effect/turf_decal/caution/stand_clear/white,/turf/open/floor/plasteel/ship,/area/space)
"aF" = (/obj/effect/turf_decal/arrows,/turf/open/floor/plasteel/ship,/area/space)
"aG" = (/obj/effect/turf_decal/caution/white,/turf/open/floor/plasteel/ship,/area/space)
"aH" = (/obj/effect/turf_decal/caution,/turf/open/floor/plasteel/ship,/area/space)
"aI" = (/obj/effect/turf_decal/arrows/white,/turf/open/floor/plasteel/ship,/area/space)
"aJ" = (/obj/machinery/door/firedoor,/turf/open/floor/plasteel/dark,/area/space)
"aK" = (/turf/open/floor/plasteel/dark,/area/space)
"aL" = (/obj/structure/reagent_dispensers/fueltank,/obj/machinery/light,/turf/open/floor/plasteel/ship/techfloor/alt,/area/space)
"aM" = (/obj/effect/turf_decal/stripes/line,/obj/machinery/atmospherics/pipe/simple/supply/hidden/layer1,/turf/open/floor/plasteel/ship/techfloor/alt,/area/space)
"aN" = (/obj/effect/turf_decal/stripes/line,/turf/open/floor/plasteel/ship/techfloor/alt,/area/space)
"aO" = (/obj/machinery/button/door{id = "launchbay_access"; name = "Launch bay doors"; pixel_y = -26; req_one_access_txt = "69"},/turf/open/floor/plasteel/ship/techfloor/alt,/area/space)
"aP" = (/obj/machinery/light,/obj/machinery/atmospherics/pipe/simple/scrubbers/hidden,/obj/machinery/atmospherics/pipe/simple/supply/hidden/layer1,/turf/open/floor/plasteel/ship/techfloor/alt,/area/space)
"aQ" = (/obj/machinery/door/poddoor/ship{id = "launchbay_access"; name = "Launch tube access"},/obj/machinery/atmospherics/pipe/simple/supply/hidden/layer1,/turf/open/floor/plasteel/ship/techfloor/alt,/area/space)
"aR" = (/obj/machinery/door/poddoor/ship{id = "launchbay_access"; name = "Launch tube access"},/turf/open/floor/plasteel/ship/techfloor/alt,/area/space)
"aS" = (/obj/machinery/door/airlock/ship{name = "Launch control room 2"; req_one_access_txt = "69"},/turf/open/floor/plasteel/ship/padded,/area/space)
"aT" = (/obj/structure/extinguisher_cabinet{pixel_y = -4},/obj/machinery/atmospherics/pipe/simple/scrubbers/hidden,/obj/machinery/atmospherics/pipe/simple/supply/hidden/layer1,/turf/closed/wall/ship,/area/space)
"aU" = (/obj/structure/cable,/turf/open/floor/plating,/area/space)
"aV" = (/obj/structure/cable,/obj/machinery/door/airlock/ship/maintenance{icon_state = "closed"; dir = 8},/turf/open/floor/plating,/area/space)
"aW" = (/obj/structure/cable,/obj/effect/turf_decal/stripes/line,/obj/machinery/atmospherics/pipe/simple/supply/hidden/layer1,/turf/open/floor/plasteel/ship/riveted,/area/space)
"aX" = (/obj/structure/cable,/obj/effect/turf_decal/stripes/line,/turf/open/floor/plasteel/ship/riveted,/area/space)
"aY" = (/obj/structure/cable,/turf/open/floor/plasteel/ship/riveted,/area/space)
"aZ" = (/obj/structure/cable,/obj/machinery/light{dir = 1},/obj/machinery/atmospherics/pipe/simple/scrubbers/hidden,/obj/machinery/atmospherics/pipe/simple/supply/hidden/layer1,/turf/open/floor/plasteel/ship/riveted,/area/space)
"ba" = (/turf/closed/wall/mineral/titanium,/area/space)
"bb" = (/turf/closed/wall/r_wall/ship,/area/space)
"bc" = (/obj/machinery/door/poddoor/ship{id = "launchbay_access2"; name = "Launch tube access"},/obj/machinery/atmospherics/pipe/simple/supply/hidden/layer1,/turf/open/floor/plating,/area/space)
"bd" = (/obj/machinery/door/poddoor/ship{id = "launchbay_access2"; name = "Launch tube access"},/obj/structure/cable,/turf/open/floor/plating,/area/space)
"be" = (/obj/machinery/door/poddoor/ship{id = "launchbay_access2"; name = "Launch tube access"},/turf/open/floor/plating,/area/space)
"bf" = (/obj/machinery/door/airlock/ship{name = "Launch control room 2"; req_one_access_txt = "69"},/obj/machinery/atmospherics/pipe/simple/scrubbers/hidden,/obj/machinery/atmospherics/pipe/simple/supply/hidden/layer1,/turf/open/floor/plasteel/ship,/area/space)
"bg" = (/obj/effect/turf_decal/stripes/line{dir = 8},/obj/machinery/atmospherics/components/unary/vent_pump/high_volume/on/layer1{icon_state = "vent_map_on-1"; dir = 1},/turf/open/floor/plating,/area/space)
"bh" = (/obj/structure/lattice/catwalk,/obj/structure/cable,/turf/open/floor/plating,/area/space)
"bi" = (/obj/effect/turf_decal/stripes/line{dir = 4},/turf/open/floor/plating,/area/space)
"bj" = (/obj/machinery/computer/ship/viewscreen,/obj/effect/turf_decal/stripes/line{dir = 8},/obj/machinery/computer/ship/dradis/minor,/turf/open/floor/plasteel/ship,/area/space)
"bk" = (/obj/structure/cable,/obj/machinery/atmospherics/pipe/simple/supply/hidden/layer1,/obj/machinery/atmospherics/components/unary/vent_scrubber/on{dir = 1},/turf/open/floor/plasteel/ship,/area/space)
"bl" = (/obj/effect/turf_decal/stripes/line{dir = 4},/obj/machinery/button/door{dir = 8; id = "launchbay_access2"; name = "Launch bay doors"; pixel_x = 22; pixel_y = 0; req_one_access_txt = "69"},/obj/structure/table/reinforced,/obj/item/clothing/ears/earmuffs,/obj/machinery/power/apc/auto_name/north,/obj/structure/cable,/turf/open/floor/plasteel/ship,/area/space)
"bm" = (/obj/effect/turf_decal/stripes/line{dir = 8},/turf/open/floor/plating,/area/space)
"bn" = (/obj/effect/turf_decal/stripes/line{dir = 4},/obj/machinery/atmospherics/components/unary/vent_pump/high_volume/on/layer1{icon_state = "vent_map_on-1"; dir = 1},/turf/open/floor/plating,/area/space)
"bo" = (/obj/structure/lattice/catwalk,/turf/open/space/basic,/area/space)
"bp" = (/obj/effect/turf_decal/stripes/line{dir = 8},/obj/machinery/light{dir = 8},/obj/structure/fighter_launcher{name = "electromagnetic catapult 3"; pixel_x = 38; pixel_y = -64},/turf/open/floor/plating,/area/space)
"bq" = (/obj/structure/window/reinforced/fulltile/ship,/turf/open/floor/plasteel/ship/padded,/area/space)
"br" = (/obj/effect/turf_decal/stripes/line{dir = 8},/turf/open/floor/plasteel/ship,/area/space)
"bs" = (/obj/structure/chair/office,/obj/machinery/atmospherics/components/unary/vent_pump/high_volume/on/layer1{icon_state = "vent_map_on-1"; dir = 1},/turf/open/floor/plasteel/ship/padded,/area/space)
"bt" = (/obj/effect/turf_decal/stripes/line{dir = 4},/turf/open/floor/plasteel/ship,/area/space)
"bu" = (/obj/effect/turf_decal/stripes/line{dir = 8},/obj/structure/fighter_launcher{name = "electromagnetic catapult 4"; pixel_x = 38; pixel_y = -64},/turf/open/floor/plating,/area/space)
"bv" = (/obj/effect/turf_decal/stripes/line{dir = 4},/obj/machinery/light{dir = 4},/turf/open/floor/plating,/area/space)
"bw" = (/obj/structure/grille,/obj/structure/window/reinforced/fulltile/ship,/turf/open/floor/plating,/area/space)
"bx" = (/obj/structure/lattice/catwalk,/turf/open/floor/plating,/area/space)
"by" = (/obj/machinery/button/door{id = "launch3"; name = "Tube 3 exterior doors"; pixel_y = 0; req_one_access_txt = "69"},/obj/structure/table/reinforced,/obj/effect/turf_decal/stripes/line{dir = 8},/turf/open/floor/plasteel/ship,/area/space)
"bz" = (/obj/machinery/computer/ship/fighter_launcher{icon_state = "computer"; dir = 1},/turf/open/floor/plasteel/ship,/area/space)
"bA" = (/obj/machinery/button/door{id = "launch4"; name = "Tube 4 exterior doors"; pixel_y = 0; req_one_access_txt = "69"},/obj/structure/table/reinforced,/obj/effect/turf_decal/stripes/line{dir = 4},/turf/open/floor/plasteel/ship,/area/space)
"bB" = (/turf/open/floor/mineral/plastitanium,/area/space)
"bC" = (/obj/structure/window/reinforced/fulltile/ship,/turf/open/floor/plasteel/ship,/area/space)
"bD" = (/obj/machinery/door/poddoor/ship{id = "launch3"},/obj/effect/turf_decal/stripes/line{dir = 10},/turf/open/floor/plating,/area/space)
"bE" = (/obj/machinery/door/poddoor/ship{id = "launch3"},/obj/effect/turf_decal/stripes/line,/turf/open/floor/plating,/area/space)
"bF" = (/obj/machinery/door/poddoor/ship{id = "launch3"},/obj/effect/turf_decal/stripes/line{dir = 6},/turf/open/floor/plating,/area/space)
"bG" = (/obj/machinery/door/poddoor/ship{id = "launch4"},/obj/effect/turf_decal/stripes/line{dir = 10},/turf/open/floor/plating,/area/space)
"bH" = (/obj/machinery/door/poddoor/ship{id = "launch4"},/obj/effect/turf_decal/stripes/line,/turf/open/floor/plating,/area/space)
"bI" = (/obj/machinery/door/poddoor/ship{id = "launch4"},/obj/effect/turf_decal/stripes/line{dir = 6},/turf/open/floor/plating,/area/space)
"bJ" = (/obj/structure/lattice,/obj/machinery/light/runway/delay5,/turf/open/space/basic,/area/space)
"bK" = (/obj/structure/lattice,/obj/machinery/light/runway/delay4,/turf/open/space/basic,/area/space)
"bL" = (/obj/structure/lattice,/obj/machinery/light/runway/delay3,/turf/open/space/basic,/area/space)
"bM" = (/obj/structure/lattice,/obj/machinery/light/runway/delay2,/turf/open/space/basic,/area/space)
"bN" = (/obj/structure/lattice,/obj/machinery/light/runway,/turf/open/space/basic,/area/space)
"bO" = (/obj/effect/turf_decal/delivery,/turf/open/floor/plating,/area/space)
"bP" = (/obj/effect/turf_decal/delivery/white,/turf/open/floor/plating,/area/space)
"bQ" = (/obj/structure/lattice,/turf/open/space/basic,/area/space)

(1,1,1) = {"
aaaaaaaaaaaaaaaaaaaaaaaaaaaaaaaaaaaaaaaaaaaaaaaaaaaaaaaaaaaaaaaaaaaaaaaaaaaaaaaaaaaaaaaaaaaaaaaaaaaa
aaaaaaaaaaaaaaaaaaaaaaaaaaaaaaaaaaaaaaaaaaaaaaaaaaaaaaaaaaaaaaaaaaaaaaaaaaaaaaaaaaaaaaaaaaaaaaaaaaaa
aaaaaaaaaaaaaaaaaaaaaaaaaaaaaaaaaaaaaaaaaaaaaaaaaaaaaaaaaaaaaaaaaaaaaaaaaaaaaaaaaaaaaaaaaaaaaaaaaaaa
aaaaaaaaaaaaaaabababababababacacacabacacacabacacabadabadabacacabacacacabacacacababaeabaaaaaaaaaaaaaa
aaaaaaaaaaaaaaabafagagahacaiaiaiaiaiaiaiaiaiaiaiaiaiajaiaiaiaiaiaiaiaiaiaiaiaiaiabaeabaaaaaaaaaaaaaa
aaaaaaaaaaaaaaabafagagahacaiakaealaiamaeanaiaoaeapaiaqaiaoaeapaiamaeanaiakaealaiabaeabaaaaaaaaaaaaaa
aaaaaaaaaaaaaaabafagagahacaiaeaeaeaiaeaeaeaiaeaeaeaiaqaiaeaeaeaiaeaeaeaiaeaeaeaiabaeabaaaaaaaaaaaaaa
aaaaaaaaaaaaaaabagagagagabaiaraeaeaiasaeaeaiaraeaeaiaqaiaraeaeaiaeaeaeaiaraeaeaiabaeabaaaaaaaaaaaaaa
aaaaaaaaaaaaaaabagagagagabaiataeauaiavaeawaiaxaeayaiaqaiaxaeayaiavaeawaiataeauaiabaeabaaaaaaaaaaaaaa
aaaaaaaaaaaaaaabagagagagazaiaiaiaiaiaiaiaiaiaiaiaiaiaiaiaiaiaiaiaiaiaiaiaiaiaiaiabaeabaaaaaaaaaaaaaa
aaaaaaaaaaaaaaabagagagagazaiajaAajaiajaBajaiajaCajaiabaiajaCajaiajaBajaiajaAajaiabaeabaaaaaaaaaaaaaa
aaaaaaaaaaaaaaabagagagagabaiajajajaiajajajaiajajajaiabaiajajajaiajajajaiajajajaiabaeabaaaaaaaaaaaaaa
aaaaaaaaaaaaaaabagagagagabaiajajajaiajajajaiajajajaiabaiajajajaiajajajaiajajajaiabaeabaaaaaaaaaaaaaa
aaaaaaaaaaaaaaabafagagahacaiajaDajaiajajajaiajaEajaiabaiajaEajaiajajajaiajaDajaiabaeabaaaaaaaaaaaaaa
aaaaaaaaaaaaaaabafagagahacaiaiaiaiaiaiaiaiaiaiaiaiaiaiaiaiaiaiaiaiaiaiaiaiaiaiaiabaeabaaaaaaaaaaaaaa
aaaaaaaaaaaaaaabafagagahacaiajaFajaiaGaHaGaiajaIajaiaqaiajaIajaiaGaHaGaiajaFajaiabaeabaaaaaaaaaaaaaa
aaaaaaaaaaaaaaababaJaJababaiajajajaiajajajaiajajajaiaqaiajajajaiajajajaiajajajaiabaeabaaaaaaaaaaaaaa
aaaaaaaaaaaaaaaJaKaKaKaKabaiajaFajaiajajajaiajaIajaiaqaiajaIajaiajajajaiajaFajaiabaeabaaaaaaaaaaaaaa
aaaaaaaaaaaaaaaJaKaKaKaKabaiajajajaiajajajaiajajajaiaqaiajajajaiajajajaiajajajaiabaeaeaaaaaaaaaaaaaa
aaaaaaaaaaaaaaaJaKaKaKaKabaiajaFajaiajajajaiajaIajaiaqaiajaIajaiajajajaiajaFajaiabaeabaaaaaaaaaaaaaa
aaaaaaaaaaaaaaabababaeababaLaMaNaNaOaiaPaiaOaNaNaMaiaiaLaMaNaNaOaiaPaiaOaNaNaMababaeabaaaaaaaaaaaaaa
aaaaaaaaaaaaaaaaaaabaeaeababaQaRaRabaSaTaSabaRaRaQabababaQaRaRabaSaTaSabaRaRaQabaUaeaeaaaaaaaaaaaaaa
aaaaaaaaaaaaaaaaaaabaeaeaUaVaWaXaXaYaYaZaYaYaXaXaWaVaUaVaWaXaXaYaYaZaYaYaXaXaWaVaUaeaeaaaaaaaaaaaaaa
aaaaaaaaaaaaaabaaaabaeaeaUbbbcbdbebbbbbfbbbbbebdbcbbaUbbbcbdbebbbbbfbbbbbebdbcbbbbaeabaaaaaaaaaaaaaa
aaaaaaaaaaaaaabaaaabaeabbbbbbgbhbibbbjbkblbbbmbhbnbbaebbbgbhbibbbjbkblbbbmbhbnbbboaaaaaaaaaaaaaaaaaa
aaaaaaaaaaaaaabaaaabaeabbobbbpbhbibqbrbsbtbqbubhbvbbaebbbpbhbibqbrbsbtbqbubhbvbbboaaaaaaaaaaaaaaaaaa
aaaaaaaaaaaaaababwabaeabbobbbmbxbibqbybzbAbqbmbxbibbaebbbmbxbibqbybzbAbqbmbxbibbboaaaaaaaaaaaaaaaaaa
aaaaaaaaaaaaaabBaeaeaeabbobbbmbxbibbbCbCbCbbbmbxbibbbobbbmbxbibbbCbCbCbbbmbxbibbboaaaaaaaaaaaaaaaaaa
aaaaaaaaaaaaaababwabaeabbobbbDbEbFbbbobobobbbGbHbIbbbobbbDbEbFbbbobobobbbGbHbIbbboaaaaaaaaaaaaaaaaaa
aaaaaaaaaaaaaabaaaabababbobJaaaaaabJboaabobJaaaaaabJbobJaaaaaabJboaabobJaaaaaabJboaaaaaaaaaaaaaaaaaa
aaaaaaaaaaaaaabaaaaaaaaabobKaaaaaabKboaabobKaaaaaabKbobKaaaaaabKboaabobKaaaaaabKboaaaaaaaaaaaaaaaaaa
aaaaaaaaaaaaaaaaaaaaaaaabobLaaaaaabLboaabobLaaaaaabLbobLaaaaaabLboaabobLaaaaaabLboaaaaaaaaaaaaaaaaaa
aaaaaaaaaaaaaaaaaaaaaaaabobMaaaaaabMboaabobMaaaaaabMbobMaaaaaabMboaabobMaaaaaabMboaaaaaaaaaaaaaaaaaa
aaaaaaaaaaaaaaaaaaaaaaaabobNbObObObNbobobobNbPbPbPbNbobNbPbPbPbNbobobobNbObObObNboaaaaaaaaaaaaaaaaaa
aaaaaaaaaaaaaaaaaaaaaaaabobQaaaaaabQboaabobQaaaaaabQbobQaaaaaabQboaabobQaaaaaabQboaaaaaaaaaaaaaaaaaa
aaaaaaaaaaaaaaaaaaaaaaaabobQaaaaaabQboaabobQaaaaaabQbobQaaaaaabQboaabobQaaaaaabQboaaaaaaaaaaaaaaaaaa
aaaaaaaaaaaaaaaaaaaaaaaabobQaaaaaabQboaabobQaaaaaabQbobQaaaaaabQboaabobQaaaaaabQboaaaaaaaaaaaaaaaaaa
aaaaaaaaaaaaaaaaaaaaaaaabobQaaaaaabQboaabobQaaaaaabQbobQaaaaaabQboaabobQaaaaaabQboaaaaaaaaaaaaaaaaaa
aaaaaaaaaaaaaaaaaaaaaaaabobQaaaaaabQboaabobQaaaaaabQbobQaaaaaabQboaabobQaaaaaabQboaaaaaaaaaaaaaaaaaa
aaaaaaaaaaaaaaaaaaaaaaaabobQaaaaaabQboaabobQaaaaaabQbobQaaaaaabQboaabobQaaaaaabQboaaaaaaaaaaaaaaaaaa
aaaaaaaaaaaaaaaaaaaaaaaabobQaaaaaabQboaabobQaaaaaabQbobQaaaaaabQboaabobQaaaaaabQboaaaaaaaaaaaaaaaaaa
aaaaaaaaaaaaaaaaaaaaaaaabobQaaaaaabQboaabobQaaaaaabQbobQaaaaaabQboaabobQaaaaaabQboaaaaaaaaaaaaaaaaaa
aaaaaaaaaaaaaaaaaaaaaaaabobJaaaaaabJboaabobJaaaaaabJbobJaaaaaabJboaabobJaaaaaabJboaaaaaaaaaaaaaaaaaa
aaaaaaaaaaaaaaaaaaaaaaaabobKaaaaaabKboaabobKaaaaaabKbobKaaaaaabKboaabobKaaaaaabKboaaaaaaaaaaaaaaaaaa
aaaaaaaaaaaaaaaaaaaaaaaabobLaaaaaabLboaabobLaaaaaabLbobLaaaaaabLboaabobLaaaaaabLboaaaaaaaaaaaaaaaaaa
aaaaaaaaaaaaaaaaaaaaaaaabobMaaaaaabMboaabobMaaaaaabMbobMaaaaaabMboaabobMaaaaaabMboaaaaaaaaaaaaaaaaaa
aaaaaaaaaaaaaaaaaaaaaaaabobNaaaaaabNbobobobNaaaaaabNbobNaaaaaabNbobobobNaaaaaabNboaaaaaaaaaaaaaaaaaa
aaaaaaaaaaaaaaaaaaaaaaaaboboboboboboboboboboboboboboboboboboboboboboboboboboboboboaaaaaaaaaaaaaaaaaa
aaaaaaaaaaaaaaaaaaaaaaaaaaaaaaaaaaaaaaaaaaaaaaaaaaaaaaaaaaaaaaaaaaaaaaaaaaaaaaaaaaaaaaaaaaaaaaaaaaaa
aaaaaaaaaaaaaaaaaaaaaaaaaaaaaaaaaaaaaaaaaaaaaaaaaaaaaaaaaaaaaaaaaaaaaaaaaaaaaaaaaaaaaaaaaaaaaaaaaaaa
"}
