//MAP CONVERTED BY dmm2tgm.py THIS HEADER COMMENT PREVENTS RECONVERSION, DO NOT REMOVE
"a" = (
/turf/closed/mineral,
/area/template_noop)
"b" = (
/turf/template_noop,
/area/template_noop)
"c" = (
/turf/closed/mineral/random/high_chance,
/area/template_noop)
"d" = (
/turf/open/floor/plating/asteroid/airless,
/area/template_noop)

(1,1,1) = {"
b
b
b
b
b
b
b
b
b
b
b
b
b
b
b
b
b
b
b
b
b
b
b
b
b
b
b
b
b
b
b
b
b
b
b
b
b
b
b
b
"}
(2,1,1) = {"
b
b
b
b
b
b
b
b
b
b
b
b
b
b
b
b
b
b
b
b
b
b
b
b
b
b
b
b
b
b
b
b
a
c
c
c
b
b
b
b
"}
(3,1,1) = {"
b
b
b
b
b
b
b
b
b
b
b
b
b
b
b
b
b
b
b
b
b
b
b
b
b
b
b
b
b
b
b
b
a
a
a
c
a
a
b
b
"}
(4,1,1) = {"
b
b
b
b
b
b
b
a
a
c
c
b
b
b
b
b
b
b
b
b
b
b
b
b
b
b
b
b
b
b
d
d
d
a
a
c
a
a
a
a
"}
(5,1,1) = {"
b
b
b
b
b
b
b
a
a
a
a
a
b
b
b
b
b
b
b
b
b
b
b
b
b
b
b
b
d
d
d
d
d
a
a
a
a
a
a
a
"}
(6,1,1) = {"
b
b
b
b
b
c
c
a
a
a
a
a
a
a
a
b
b
b
b
b
b
b
b
b
b
b
b
b
d
d
d
d
d
a
a
a
a
a
a
a
"}
(7,1,1) = {"
b
b
b
b
b
c
a
a
a
a
a
a
a
a
a
c
c
c
b
b
b
b
b
b
b
b
a
a
d
d
d
d
a
a
a
a
a
a
a
a
"}
(8,1,1) = {"
b
b
b
b
b
c
a
a
a
a
a
a
a
a
a
c
c
c
b
b
b
b
b
b
b
a
d
d
d
d
a
c
c
a
c
a
a
a
a
a
"}
(9,1,1) = {"
b
b
b
b
a
c
a
a
a
a
a
d
d
d
d
a
a
a
b
b
b
b
b
b
b
d
d
d
a
a
a
a
a
a
a
a
a
a
c
b
"}
(10,1,1) = {"
b
b
b
b
a
a
a
a
a
d
d
d
d
d
d
d
d
a
b
b
b
b
b
b
a
d
d
a
a
a
a
a
a
c
a
a
a
a
c
b
"}
(11,1,1) = {"
b
b
b
a
a
a
a
a
c
d
d
d
b
b
d
d
d
c
b
b
b
b
b
b
d
d
d
a
c
c
a
c
a
a
c
a
a
a
a
b
"}
(12,1,1) = {"
b
b
b
a
a
a
a
a
d
d
b
b
b
b
d
d
d
a
b
b
b
b
b
b
d
d
a
a
a
a
c
a
d
d
d
a
a
a
b
b
"}
(13,1,1) = {"
b
b
b
a
a
a
a
d
d
b
b
b
b
b
b
b
a
b
a
a
a
b
b
b
d
d
a
a
c
d
d
d
d
d
d
a
a
a
a
b
"}
(14,1,1) = {"
b
b
b
a
a
a
c
d
d
b
b
b
b
b
a
b
a
a
a
a
a
b
a
a
d
d
a
a
a
d
d
c
d
d
d
a
a
a
a
b
"}
(15,1,1) = {"
b
b
b
a
a
a
c
d
b
b
b
b
b
b
b
a
a
a
a
a
a
a
b
d
d
a
a
a
a
d
d
a
d
d
d
a
a
a
a
b
"}
(16,1,1) = {"
b
b
a
a
a
d
d
d
b
b
b
b
b
a
a
a
a
a
a
a
a
a
a
d
d
a
a
a
a
a
a
a
d
d
d
a
a
a
a
b
"}
(17,1,1) = {"
b
b
a
a
a
d
d
d
b
b
b
b
b
b
a
a
a
a
a
a
a
a
b
d
d
a
a
a
a
a
d
d
d
d
d
a
a
a
a
a
"}
(18,1,1) = {"
b
b
a
a
a
d
d
d
b
b
b
b
a
a
a
a
a
a
a
a
a
a
a
d
d
a
a
a
a
a
d
d
d
d
a
a
a
a
c
a
"}
(19,1,1) = {"
b
b
c
a
d
d
d
b
b
a
a
b
a
a
a
a
a
a
a
a
a
a
a
d
d
a
a
a
a
d
d
d
c
a
a
a
a
a
a
c
"}
(20,1,1) = {"
b
b
a
c
d
d
d
b
b
a
a
a
a
a
a
a
a
a
c
c
a
a
a
a
d
a
a
a
a
d
d
d
a
a
a
c
a
a
a
a
"}
(21,1,1) = {"
b
b
a
a
d
d
d
b
b
a
a
a
a
a
a
a
a
a
a
a
a
a
b
a
d
d
d
a
a
d
d
d
d
a
a
a
a
a
c
c
"}
(22,1,1) = {"
b
b
c
c
a
d
d
b
b
b
b
b
b
a
a
a
a
a
a
a
a
a
b
a
d
d
d
c
a
a
a
d
d
a
a
a
a
a
a
a
"}
(23,1,1) = {"
b
b
a
a
a
d
d
b
b
b
b
b
b
b
a
a
a
a
a
a
a
a
b
b
d
d
d
a
c
a
a
d
d
a
a
a
a
a
a
a
"}
(24,1,1) = {"
b
b
b
a
a
d
d
d
b
b
b
b
b
b
b
b
a
a
a
a
a
a
b
b
b
b
d
d
d
d
d
d
d
a
a
a
a
a
a
b
"}
(25,1,1) = {"
b
b
b
a
a
c
d
d
d
d
b
b
b
b
b
b
b
b
b
b
b
b
b
b
b
b
a
c
d
d
d
d
d
a
a
a
a
a
a
b
"}
(26,1,1) = {"
b
b
b
a
a
a
a
d
d
d
b
b
b
b
b
b
b
b
b
b
b
b
b
b
b
b
b
b
d
d
d
d
d
c
c
a
b
b
b
b
"}
(27,1,1) = {"
b
b
b
a
a
a
a
d
d
d
b
b
b
b
b
b
b
b
b
b
b
b
b
b
b
b
b
b
b
b
b
b
b
b
b
b
b
b
b
b
"}
(28,1,1) = {"
b
b
b
a
a
a
a
a
a
a
b
b
b
a
a
b
b
b
b
b
b
b
b
a
b
b
b
b
b
b
b
b
b
b
b
b
b
b
b
b
"}
(29,1,1) = {"
b
b
b
b
a
a
a
a
a
a
a
a
a
a
a
b
b
b
b
d
d
d
a
a
a
b
b
b
b
b
b
b
b
b
b
b
b
b
b
b
"}
(30,1,1) = {"
b
b
b
b
b
b
b
b
a
a
a
a
a
b
b
b
b
b
b
d
d
d
c
a
a
b
b
b
b
b
b
b
b
b
b
b
b
b
b
b
"}
(31,1,1) = {"
b
b
b
b
b
b
b
b
b
b
b
b
b
b
b
b
b
b
b
d
d
d
a
a
a
a
a
a
b
b
b
b
b
b
b
b
b
b
b
b
"}
(32,1,1) = {"
b
b
b
b
b
b
b
b
b
b
b
b
b
b
b
b
b
d
d
d
d
d
a
a
a
a
a
a
a
b
b
b
b
b
b
b
b
b
b
b
"}
(33,1,1) = {"
b
b
b
b
b
b
b
b
b
b
b
b
b
b
b
b
b
d
d
d
a
a
a
a
a
a
a
a
c
b
b
b
b
b
b
b
b
b
b
b
"}
(34,1,1) = {"
b
b
b
b
b
b
b
b
b
b
b
b
b
b
b
b
d
d
d
d
d
d
d
c
a
c
a
a
c
a
b
b
b
b
b
b
b
a
a
b
"}
(35,1,1) = {"
b
b
b
b
b
b
b
b
b
b
b
b
b
b
b
b
d
d
d
d
d
d
d
d
d
d
a
a
a
a
b
b
b
b
b
b
a
a
a
b
"}
(36,1,1) = {"
b
b
b
b
b
b
b
b
b
b
b
b
b
a
a
a
d
d
d
a
a
a
d
d
d
d
a
a
a
c
b
b
b
b
b
a
a
a
a
b
"}
(37,1,1) = {"
b
b
b
b
b
b
b
b
b
b
b
b
a
a
a
c
a
a
a
a
a
a
a
d
d
a
a
a
b
b
b
b
b
b
b
a
a
a
b
b
"}
(38,1,1) = {"
b
b
b
b
b
b
b
b
b
b
b
a
c
a
a
a
a
a
a
a
a
a
a
c
a
a
a
a
b
b
b
b
b
b
b
b
b
b
b
b
"}
(39,1,1) = {"
b
b
b
b
b
b
b
b
b
b
b
b
b
c
c
c
a
b
b
b
a
a
a
a
a
b
b
b
b
b
b
b
b
b
b
b
b
b
b
b
"}
(40,1,1) = {"
b
b
b
b
b
b
b
b
b
b
b
b
b
b
b
b
b
b
b
b
b
b
b
b
b
b
b
b
b
b
b
b
b
b
b
b
b
b
b
b
"}
