//MAP CONVERTED BY dmm2tgm.py THIS HEADER COMMENT PREVENTS RECONVERSION, DO NOT REMOVE
"aa" = (
/obj/machinery/stasis,
/obj/machinery/shower{
	icon_state = "shower";
	dir = 1
	},
/turf/open/floor/mineral/titanium/white,
/area/shuttle/escape)
"ab" = (
/obj/machinery/sleeper{
	dir = 4
	},
/turf/open/floor/mineral/titanium/white,
/area/shuttle/escape)
"ac" = (
/obj/machinery/stasis,
/obj/machinery/shower{
	dir = 4
	},
/turf/open/floor/mineral/titanium/white,
/area/shuttle/escape)
"ad" = (
/turf/closed/wall/mineral/titanium,
/area/shuttle/escape)
"ae" = (
/obj/structure/chair/comfy/shuttle,
/turf/open/floor/mineral/plastitanium/red/brig,
/area/shuttle/escape)
"af" = (
/obj/effect/spawner/structure/window/shuttle,
/turf/open/floor/plating,
/area/shuttle/escape)
"ag" = (
/turf/open/floor/mineral/titanium/white,
/area/shuttle/escape)
"ah" = (
/obj/structure/closet/radiation{
	anchored = 1
	},
/obj/item/storage/firstaid/radbgone{
	pixel_x = -3;
	pixel_y = -3
	},
/obj/item/clothing/head/radiation,
/obj/item/clothing/head/radiation,
/obj/item/clothing/head/radiation,
/obj/item/clothing/head/radiation,
/obj/item/clothing/suit/radiation,
/obj/item/clothing/suit/radiation,
/obj/item/clothing/suit/radiation,
/obj/item/clothing/suit/radiation,
/obj/item/clothing/mask/gas,
/obj/item/clothing/mask/gas,
/obj/item/clothing/mask/gas,
/obj/item/clothing/mask/gas,
/turf/open/floor/mineral/titanium/white,
/area/shuttle/escape)
"ai" = (
/obj/machinery/door/airlock/titanium{
	name = "Emergency Shuttle Airlock"
	},
/turf/open/floor/mineral/titanium/white,
/area/shuttle/escape)
"aj" = (
/obj/machinery/computer/emergency_shuttle{
	icon_state = "computer";
	dir = 8
	},
/turf/open/floor/mineral/titanium/blue,
/area/shuttle/escape)
"ak" = (
/obj/machinery/computer/crew{
	dir = 1
	},
/turf/open/floor/mineral/titanium/blue,
/area/shuttle/escape)
"al" = (
/obj/machinery/computer/atmos_alert{
	dir = 1
	},
/turf/open/floor/mineral/titanium/blue,
/area/shuttle/escape)
"am" = (
/obj/machinery/computer/communications{
	dir = 1
	},
/turf/open/floor/mineral/titanium/blue,
/area/shuttle/escape)
"an" = (
/obj/machinery/computer/security{
	dir = 1
	},
/turf/open/floor/mineral/titanium/blue,
/area/shuttle/escape)
"ao" = (
/obj/machinery/door/airlock/public/glass{
	name = "Emergency Shuttle Brig";
	req_access_txt = "2"
	},
/turf/open/floor/mineral/plastitanium/red/brig,
/area/shuttle/escape)
"ap" = (
/turf/open/floor/mineral/plastitanium/red/brig,
/area/shuttle/escape)
"aq" = (
/obj/structure/table,
/obj/machinery/recharger,
/turf/open/floor/mineral/titanium/blue,
/area/shuttle/escape)
"ar" = (
/obj/structure/chair/comfy/shuttle{
	dir = 1
	},
/turf/open/floor/mineral/plastitanium/red/brig,
/area/shuttle/escape)
"as" = (
/obj/structure/table,
/obj/item/storage/firstaid/regular{
	pixel_x = 2;
	pixel_y = 3
	},
/obj/item/crowbar,
/obj/item/storage/firstaid/fire,
/turf/open/floor/mineral/titanium/blue,
/area/shuttle/escape)
"az" = (
/obj/structure/chair/comfy/shuttle{
	dir = 4
	},
/turf/open/floor/mineral/titanium/white,
/area/shuttle/escape)
"aA" = (
/turf/closed/wall/mineral/titanium/nodiagonal,
/area/shuttle/escape)
"aB" = (
/obj/structure/chair/comfy/shuttle,
/turf/open/floor/mineral/titanium/white,
/area/shuttle/escape)
"aC" = (
/obj/structure/chair/comfy/shuttle{
	dir = 1
	},
/turf/open/floor/mineral/titanium/white,
/area/shuttle/escape)
"aE" = (
/obj/structure/chair/comfy/shuttle{
	dir = 8
	},
/turf/open/floor/mineral/titanium/white,
/area/shuttle/escape)
"aJ" = (
/obj/machinery/door/airlock/titanium{
	name = "Emergency Shuttle Airlock"
	},
/turf/open/floor/plating,
/area/shuttle/escape)
"bd" = (
/obj/machinery/door/airlock/titanium{
	name = "Emergency Shuttle Airlock"
	},
/obj/docking_port/mobile/emergency{
	dir = 1;
	name = "Box emergency shuttle"
	},
/turf/open/floor/plating,
/area/shuttle/escape)
"be" = (
/obj/structure/table,
/obj/item/storage/firstaid/fire,
/obj/item/storage/firstaid/radbgone{
	pixel_x = -3;
	pixel_y = -3
	},
/turf/open/floor/mineral/titanium/white,
/area/shuttle/escape)

(1,1,1) = {"
ad
ad
ad
ad
ad
ad
ad
ad
ad
"}
(2,1,1) = {"
ad
be
ab
ac
be
ac
ab
be
ad
"}
(3,1,1) = {"
ad
ac
ag
ag
ag
ag
ag
aa
ad
"}
(4,1,1) = {"
ad
ac
ag
ag
ag
ag
ag
aa
ad
"}
(5,1,1) = {"
ad
be
ag
ag
ag
ag
ag
aa
ad
"}
(6,1,1) = {"
aJ
ag
ag
aE
aE
aE
ag
be
ad
"}
(7,1,1) = {"
ad
ad
ai
af
ad
af
ai
ad
ad
"}
(8,1,1) = {"
aJ
ag
ag
aC
ag
aB
ag
aC
ad
"}
(9,1,1) = {"
aA
ah
ag
aC
ag
aB
ag
aC
ad
"}
(10,1,1) = {"
af
ah
ag
aC
ag
aB
ag
aC
ad
"}
(11,1,1) = {"
af
ah
ag
aC
ag
aB
ag
aC
ad
"}
(12,1,1) = {"
af
ah
ag
aC
ag
aB
ag
aC
ad
"}
(13,1,1) = {"
aA
ah
ag
ag
ag
ag
ag
ag
ad
"}
(14,1,1) = {"
aJ
ag
ag
ag
aE
aE
aE
aE
ad
"}
(15,1,1) = {"
aA
ag
ag
ag
ad
ad
ad
ad
ad
"}
(16,1,1) = {"
bd
ag
ag
ag
ai
ag
ag
as
ad
"}
(17,1,1) = {"
ad
af
ao
af
af
ag
aB
ak
ad
"}
(18,1,1) = {"
ad
ae
ap
ar
ad
ag
aB
al
ad
"}
(19,1,1) = {"
ad
ae
ap
ar
ad
az
aB
am
ad
"}
(20,1,1) = {"
ad
ae
ap
ar
ad
aj
aq
an
ad
"}
(21,1,1) = {"
ad
ad
ad
ad
ad
ad
ad
ad
ad
"}
