//MAP CONVERTED BY dmm2tgm.py THIS HEADER COMMENT PREVENTS RECONVERSION, DO NOT REMOVE
"aa" = (
/obj/structure/shuttle/engine/large{
	icon_state = "large_engine";
	dir = 1
	},
/turf/open/floor/plating/airless,
/area/shuttle/escape)
"ac" = (
/obj/structure/closet/radiation{
	anchored = 1
	},
/obj/item/storage/firstaid/radbgone{
	pixel_x = -3;
	pixel_y = -3
	},
/obj/item/clothing/head/radiation,
/obj/item/clothing/head/radiation,
/obj/item/clothing/head/radiation,
/obj/item/clothing/head/radiation,
/obj/item/clothing/suit/radiation,
/obj/item/clothing/suit/radiation,
/obj/item/clothing/suit/radiation,
/obj/item/clothing/suit/radiation,
/obj/item/clothing/mask/gas,
/obj/item/clothing/mask/gas,
/obj/item/clothing/mask/gas,
/obj/item/clothing/mask/gas,
/obj/machinery/light{
	icon_state = "tube";
	dir = 4
	},
/turf/open/floor/mineral/titanium,
/area/shuttle/escape)
"ad" = (
/turf/closed/wall/mineral/titanium,
/area/shuttle/escape)
"ag" = (
/obj/effect/spawner/structure/window/shuttle,
/turf/open/floor/plating,
/area/shuttle/escape)
"ah" = (
/turf/open/floor/mineral/titanium,
/area/shuttle/escape)
"ai" = (
/obj/structure/shuttle/engine/heater{
	icon_state = "heater";
	dir = 1
	},
/turf/closed/wall/mineral/titanium/nodiagonal,
/area/shuttle/escape)
"al" = (
/obj/machinery/computer/atmos_alert{
	dir = 4
	},
/turf/open/floor/mineral/titanium/blue,
/area/shuttle/escape)
"am" = (
/obj/structure/chair/comfy/shuttle{
	dir = 8
	},
/obj/structure/window/reinforced{
	dir = 4
	},
/obj/machinery/light{
	icon_state = "tube";
	dir = 4
	},
/turf/open/floor/mineral/titanium/blue,
/area/shuttle/escape)
"an" = (
/obj/structure/chair/comfy/shuttle{
	dir = 4
	},
/obj/structure/window/reinforced{
	dir = 8
	},
/turf/open/floor/mineral/titanium/blue,
/area/shuttle/escape)
"ao" = (
/obj/structure/chair/comfy/shuttle{
	dir = 8
	},
/obj/structure/window/reinforced{
	dir = 4
	},
/turf/open/floor/mineral/titanium/blue,
/area/shuttle/escape)
"ap" = (
/turf/open/floor/mineral/titanium/white,
/area/shuttle/escape)
"aq" = (
/obj/structure/chair/comfy/shuttle{
	dir = 4
	},
/obj/structure/window/reinforced{
	dir = 8
	},
/obj/structure/window/reinforced{
	dir = 1
	},
/turf/open/floor/mineral/plastitanium/red/brig,
/area/shuttle/escape)
"ar" = (
/turf/open/floor/mineral/plastitanium/red/brig,
/area/shuttle/escape)
"as" = (
/obj/structure/chair/comfy/shuttle{
	dir = 8
	},
/obj/structure/window/reinforced{
	dir = 4
	},
/obj/structure/window/reinforced{
	dir = 1
	},
/turf/open/floor/mineral/plastitanium/red/brig,
/area/shuttle/escape)
"at" = (
/obj/machinery/light{
	dir = 8
	},
/turf/open/floor/mineral/titanium,
/area/shuttle/escape)
"au" = (
/obj/structure/closet/radiation{
	anchored = 1
	},
/obj/item/storage/firstaid/radbgone{
	pixel_x = -3;
	pixel_y = -3
	},
/obj/item/clothing/head/radiation,
/obj/item/clothing/head/radiation,
/obj/item/clothing/head/radiation,
/obj/item/clothing/head/radiation,
/obj/item/clothing/suit/radiation,
/obj/item/clothing/suit/radiation,
/obj/item/clothing/suit/radiation,
/obj/item/clothing/suit/radiation,
/obj/item/clothing/mask/gas,
/obj/item/clothing/mask/gas,
/obj/item/clothing/mask/gas,
/obj/item/clothing/mask/gas,
/turf/open/floor/mineral/titanium,
/area/shuttle/escape)
"ay" = (
/obj/structure/chair/comfy/shuttle{
	dir = 4
	},
/obj/structure/window/reinforced{
	dir = 8
	},
/turf/open/floor/mineral/plastitanium/red/brig,
/area/shuttle/escape)
"az" = (
/turf/open/floor/plating/airless,
/area/shuttle/escape)
"aA" = (
/turf/closed/wall/mineral/titanium/nodiagonal,
/area/shuttle/escape)
"aB" = (
/obj/structure/shuttle/engine/heater{
	icon_state = "heater";
	dir = 1
	},
/turf/closed/wall/mineral/titanium,
/area/shuttle/escape)
"aC" = (
/obj/structure/chair/comfy/shuttle{
	dir = 8
	},
/obj/structure/window/reinforced{
	dir = 4
	},
/turf/open/floor/mineral/plastitanium/red/brig,
/area/shuttle/escape)
"aD" = (
/obj/effect/spawner/structure/window/shuttle,
/obj/structure/shuttle/engine/heater{
	icon_state = "heater";
	dir = 1
	},
/turf/open/floor/plating,
/area/shuttle/escape)
"aE" = (
/obj/structure/chair/comfy/shuttle{
	dir = 8
	},
/obj/structure/window/reinforced{
	dir = 4
	},
/obj/machinery/light,
/turf/open/floor/mineral/titanium/blue,
/area/shuttle/escape)
"aF" = (
/obj/structure/chair/comfy/shuttle{
	dir = 8
	},
/obj/structure/window/reinforced{
	dir = 4
	},
/obj/machinery/light{
	icon_state = "tube";
	dir = 4
	},
/turf/open/floor/mineral/plastitanium/red/brig,
/area/shuttle/escape)
"aG" = (
/obj/machinery/sleeper{
	icon_state = "sleeper";
	dir = 1
	},
/obj/machinery/shower{
	pixel_y = 21
	},
/turf/open/floor/mineral/titanium/white,
/area/shuttle/escape)
"aH" = (
/obj/machinery/sleeper{
	icon_state = "sleeper";
	dir = 1
	},
/obj/machinery/shower{
	icon_state = "shower";
	dir = 8
	},
/turf/open/floor/mineral/titanium/white,
/area/shuttle/escape)
"aI" = (
/obj/structure/shuttle/engine/huge{
	icon_state = "huge_engine";
	dir = 1
	},
/turf/open/floor/plating/airless,
/area/shuttle/escape)
"aJ" = (
/obj/machinery/door/airlock/titanium{
	name = "Emergency Shuttle Airlock"
	},
/turf/open/floor/plating,
/area/shuttle/escape)
"aK" = (
/obj/machinery/door/airlock/public/glass{
	name = "Emergency Shuttle Cockpit";
	req_access_txt = "19"
	},
/turf/open/floor/mineral/titanium,
/area/shuttle/escape)
"aM" = (
/turf/template_noop,
/area/template_noop)
"aP" = (
/obj/machinery/button/flasher{
	id = "cockpit_flasher";
	pixel_x = -6;
	pixel_y = 24
	},
/turf/open/floor/mineral/titanium,
/area/shuttle/escape)
"aQ" = (
/obj/machinery/door/airlock/public/glass{
	name = "Emergency Shuttle Infirmary"
	},
/turf/open/floor/mineral/titanium,
/area/shuttle/escape)
"aR" = (
/obj/structure/chair/comfy/shuttle{
	dir = 4
	},
/turf/open/floor/mineral/titanium/blue,
/area/shuttle/escape)
"aS" = (
/obj/machinery/flasher{
	id = "cockpit_flasher";
	pixel_x = 24;
	pixel_y = 6
	},
/turf/open/floor/mineral/titanium,
/area/shuttle/escape)
"aT" = (
/obj/machinery/computer/security{
	dir = 8
	},
/turf/open/floor/mineral/titanium/blue,
/area/shuttle/escape)
"aV" = (
/obj/machinery/sleeper,
/obj/machinery/shower{
	icon_state = "shower";
	dir = 4
	},
/turf/open/floor/mineral/titanium/white,
/area/shuttle/escape)
"aW" = (
/obj/machinery/sleeper,
/obj/machinery/shower{
	pixel_y = 21
	},
/turf/open/floor/mineral/titanium/white,
/area/shuttle/escape)
"aX" = (
/obj/machinery/computer/communications{
	dir = 8
	},
/turf/open/floor/mineral/titanium/blue,
/area/shuttle/escape)
"aZ" = (
/obj/structure/table,
/obj/item/storage/firstaid/regular{
	pixel_x = 2;
	pixel_y = 3
	},
/obj/item/crowbar,
/obj/item/storage/firstaid/fire,
/turf/open/floor/mineral/titanium/blue,
/area/shuttle/escape)
"bb" = (
/obj/machinery/sleeper{
	icon_state = "sleeper";
	dir = 1
	},
/obj/machinery/shower{
	icon_state = "shower";
	dir = 4
	},
/turf/open/floor/mineral/titanium/white,
/area/shuttle/escape)
"bc" = (
/obj/machinery/sleeper{
	icon_state = "sleeper";
	dir = 1
	},
/obj/machinery/shower{
	icon_state = "shower";
	dir = 1
	},
/turf/open/floor/mineral/titanium/white,
/area/shuttle/escape)
"bd" = (
/obj/machinery/door/airlock/titanium{
	name = "Emergency Shuttle Airlock"
	},
/obj/docking_port/mobile/emergency{
	dir = 1;
	name = "Box emergency shuttle"
	},
/turf/open/floor/plating,
/area/shuttle/escape)
"be" = (
/obj/structure/table,
/obj/item/storage/firstaid/fire,
/obj/item/storage/firstaid/radbgone{
	pixel_x = -3;
	pixel_y = -3
	},
/turf/open/floor/mineral/titanium/white,
/area/shuttle/escape)
"bg" = (
/obj/machinery/stasis,
/obj/machinery/shower{
	icon_state = "shower";
	dir = 8
	},
/turf/open/floor/mineral/titanium/white,
/area/shuttle/escape)
"bj" = (
/obj/structure/closet/emcloset,
/turf/open/floor/mineral/titanium/white,
/area/shuttle/escape)
"bk" = (
/obj/structure/chair/comfy/shuttle{
	dir = 8
	},
/turf/open/floor/mineral/titanium/blue,
/area/shuttle/escape)
"bl" = (
/obj/machinery/computer/crew{
	dir = 4
	},
/turf/open/floor/mineral/titanium/blue,
/area/shuttle/escape)
"bm" = (
/obj/structure/table,
/obj/machinery/recharger,
/turf/open/floor/mineral/titanium/blue,
/area/shuttle/escape)
"bn" = (
/obj/structure/chair/comfy/shuttle,
/turf/open/floor/mineral/titanium/blue,
/area/shuttle/escape)
"bo" = (
/obj/structure/closet/radiation{
	anchored = 1
	},
/obj/item/storage/firstaid/radbgone{
	pixel_x = -3;
	pixel_y = -3
	},
/obj/item/clothing/head/radiation,
/obj/item/clothing/head/radiation,
/obj/item/clothing/head/radiation,
/obj/item/clothing/head/radiation,
/obj/item/clothing/suit/radiation,
/obj/item/clothing/suit/radiation,
/obj/item/clothing/suit/radiation,
/obj/item/clothing/suit/radiation,
/obj/item/clothing/mask/gas,
/obj/item/clothing/mask/gas,
/obj/item/clothing/mask/gas,
/obj/item/clothing/mask/gas,
/obj/machinery/light{
	dir = 8
	},
/turf/open/floor/mineral/titanium,
/area/shuttle/escape)
"bp" = (
/obj/structure/chair/comfy/shuttle{
	dir = 4
	},
/obj/structure/window/reinforced{
	dir = 8
	},
/obj/machinery/light{
	dir = 8
	},
/turf/open/floor/mineral/titanium/blue,
/area/shuttle/escape)
"bq" = (
/obj/structure/chair/comfy/shuttle{
	dir = 4
	},
/obj/structure/window/reinforced{
	dir = 8
	},
/obj/machinery/light,
/turf/open/floor/mineral/titanium/blue,
/area/shuttle/escape)
"bs" = (
/obj/machinery/light{
	dir = 8
	},
/turf/open/floor/mineral/titanium/white,
/area/shuttle/escape)
"bQ" = (
/obj/machinery/light{
	icon_state = "tube";
	dir = 4
	},
/turf/open/floor/mineral/titanium/white,
/area/shuttle/escape)
"cp" = (
/obj/machinery/computer/emergency_shuttle{
	icon_state = "computer";
	dir = 1
	},
/obj/machinery/light,
/turf/open/floor/mineral/titanium/blue,
/area/shuttle/escape)
"cv" = (
/obj/machinery/light{
	dir = 1
	},
/turf/open/floor/mineral/titanium,
/area/shuttle/escape)
"cw" = (
/obj/machinery/light{
	icon_state = "tube";
	dir = 4
	},
/turf/open/floor/mineral/titanium,
/area/shuttle/escape)

(1,1,1) = {"
az
aa
ai
ad
ad
ad
ad
ad
ad
ad
ad
ad
ad
ad
ad
ad
ad
ad
aM
aM
aM
aM
"}
(2,1,1) = {"
az
az
aB
au
au
an
an
bp
an
an
an
an
bp
ad
aV
bs
bb
ad
aM
aM
aM
aM
"}
(3,1,1) = {"
aA
ad
ad
ah
ah
ah
ah
ah
ah
ah
ah
ah
ah
ad
aW
ap
bc
ag
aM
aM
aM
aM
"}
(4,1,1) = {"
ag
bo
au
ah
ah
ao
ao
ao
ao
ao
ao
ao
ao
ag
ap
ap
ap
ag
aM
aM
aM
aM
"}
(5,1,1) = {"
ad
ah
ah
ah
ah
an
an
an
an
an
an
an
an
ag
ap
ap
ap
ag
aM
aM
aM
aM
"}
(6,1,1) = {"
aJ
ah
ah
ah
ah
ah
ah
ah
ah
ah
ah
ah
ah
aQ
ap
ap
bj
ad
aM
aM
aM
aM
"}
(7,1,1) = {"
ad
ah
ah
ah
ah
ah
ao
ao
ao
ao
ao
ao
ao
ag
bg
ap
be
ad
ag
ag
ad
aM
"}
(8,1,1) = {"
aJ
ah
ah
ah
ah
ah
an
an
an
an
an
an
an
ag
bg
ap
be
ad
al
bl
ad
ad
"}
(9,1,1) = {"
aA
ad
ad
ad
ah
ah
ah
ah
ah
ah
cw
ah
ah
ad
bg
bQ
be
ag
bk
bk
bm
ag
"}
(10,1,1) = {"
az
az
aI
aD
ah
ah
an
an
an
an
an
an
bq
ad
ad
ad
ad
ad
ah
ah
bn
ag
"}
(11,1,1) = {"
az
az
az
aD
cv
ah
ah
ah
ah
ah
ah
ah
ah
aK
ah
aS
ah
aK
ah
ah
cp
ad
"}
(12,1,1) = {"
az
az
az
aD
ah
ah
ao
ao
ao
ao
ao
ao
aE
ad
ad
ad
ad
ad
aP
ah
bn
ag
"}
(13,1,1) = {"
aA
ad
ad
ad
ah
ah
ah
ah
ah
ah
at
ah
ah
ad
bg
bs
be
ag
aR
aR
aZ
ag
"}
(14,1,1) = {"
aJ
ah
ah
ah
ah
ah
ao
ao
ao
ao
ao
ao
ao
ag
bg
ap
be
ad
aT
aX
ad
ad
"}
(15,1,1) = {"
ad
ah
ah
ah
ah
ah
an
an
an
an
an
an
an
ag
bg
ap
be
ad
ag
ag
ad
aM
"}
(16,1,1) = {"
bd
ah
ah
ah
ah
ah
ah
ah
ah
ah
ah
ah
ah
aQ
ap
ap
bj
ad
aM
aM
aM
aM
"}
(17,1,1) = {"
ad
ah
ah
ah
ah
ao
ao
ao
ao
ao
ao
ao
ao
ag
ap
ap
ap
ag
aM
aM
aM
aM
"}
(18,1,1) = {"
ag
ac
au
ah
ah
an
an
an
an
aq
ay
ay
ay
ag
ap
ap
ap
ag
aM
aM
aM
aM
"}
(19,1,1) = {"
aA
ad
ad
ah
ah
ah
ah
ah
ah
ar
ar
ar
ar
ad
aG
ap
bc
ag
aM
aM
aM
aM
"}
(20,1,1) = {"
az
aa
aB
au
au
ao
ao
am
ao
as
aC
aC
aF
ad
aH
bQ
aH
ad
aM
aM
aM
aM
"}
(21,1,1) = {"
az
az
ai
ad
ad
ad
ad
ad
ad
ad
ad
ad
ad
ad
ad
ad
ad
ad
aM
aM
aM
aM
"}
