"a" = (/turf/template_noop,/area/template_noop)
"b" = (/obj/item/radio/intercom{pixel_x = 30},/turf/open/floor/mineral/titanium/blue,/area/shuttle/arrival)
"c" = (/obj/structure/chair/comfy/shuttle{dir = 8},/turf/open/floor/mineral/titanium/blue,/area/shuttle/pod_1)
"d" = (/obj/structure/chair/comfy/shuttle{dir = 8},/obj/machinery/light,/turf/open/floor/mineral/titanium/blue,/area/shuttle/arrival)
"e" = (/obj/structure/chair/comfy/shuttle{dir = 4},/turf/open/floor/mineral/titanium/blue,/area/shuttle/arrival)
"f" = (/turf/open/floor/mineral/titanium,/area/shuttle/arrival)
"g" = (/obj/structure/chair/comfy/shuttle,/obj/machinery/light{dir = 1},/turf/open/floor/mineral/titanium/blue,/area/shuttle/arrival)
"h" = (/obj/structure/window/shuttle,/turf/open/floor/plating,/area/shuttle/arrival)
"i" = (/obj/machinery/light{dir = 8},/turf/open/floor/mineral/titanium,/area/shuttle/arrival)
"j" = (/obj/structure/chair/comfy/shuttle{dir = 8},/turf/open/floor/mineral/titanium/blue,/area/shuttle/arrival)
"k" = (/turf/closed/wall/mineral/titanium,/area/shuttle/arrival)
"l" = (/obj/machinery/door/airlock/titanium{name = "Arrivals Shuttle Airlock"},/turf/open/floor/mineral/titanium,/area/shuttle/arrival)
"m" = (/obj/structure/closet/emcloset,/turf/open/floor/mineral/titanium,/area/shuttle/arrival)
"n" = (/obj/structure/chair/comfy/shuttle,/turf/open/floor/mineral/titanium/blue,/area/shuttle/arrival)
"o" = (/obj/effect/spawner/structure/window/shuttle,/turf/open/floor/plating,/area/shuttle/arrival)
"p" = (/obj/structure/table,/obj/item/storage/firstaid/ancient,/turf/open/floor/mineral/titanium/blue,/area/shuttle/arrival)
"q" = (/obj/machinery/light{dir = 4},/turf/open/floor/mineral/titanium,/area/shuttle/arrival)
"r" = (/obj/structure/shuttle/engine/propulsion/burst,/turf/open/floor/plating{icon_state = "panelscorched"},/area/shuttle/arrival)
"s" = (/obj/item/storage/toolbox/emergency,/obj/item/storage/toolbox/emergency,/obj/structure/table,/turf/open/floor/mineral/titanium/blue,/area/shuttle/arrival)
"t" = (/obj/docking_port/mobile/arrivals{dheight = 9; dir = 8; dwidth = 2; height = 9; width = 10},/turf/closed/wall/mineral/titanium,/area/shuttle/arrival)
"L" = (/obj/structure/chair/comfy/shuttle{dir = 4},/turf/open/floor/mineral/titanium/blue,/area/shuttle/pod_1)

(1,1,1) = {"
ahhhhhhha
hefchLfjh
hefdhefjh
kklkkklkk
kefmgmfjk
oeffnffjo
kpffnffbk
kkkinqkkt
rrkfsfkrr
aaklklkaa
"}
