//MAP CONVERTED BY dmm2tgm.py THIS HEADER COMMENT PREVENTS RECONVERSION, DO NOT REMOVE
"e" = (
/turf/open/floor/mineral/titanium/blue,
/area/shuttle/arrival)
"f" = (
/obj/machinery/light{
	dir = 1
	},
/obj/structure/closet/emcloset,
/turf/open/floor/mineral/titanium,
/area/shuttle/arrival)
"h" = (
/obj/structure/chair/comfy/shuttle{
	dir = 4
	},
/turf/open/floor/mineral/titanium,
/area/shuttle/arrival)
"j" = (
/obj/structure/chair/comfy/shuttle{
	dir = 4
	},
/obj/machinery/requests_console{
	department = "Arrival shuttle";
	name = "Arrivals Shuttle console";
	pixel_y = 30
	},
/turf/open/floor/mineral/titanium,
/area/shuttle/arrival)
"k" = (
/obj/effect/spawner/structure/window/shuttle,
/turf/open/floor/plating,
/area/shuttle/arrival)
"q" = (
/obj/structure/chair/comfy/shuttle{
	dir = 4
	},
/turf/open/floor/mineral/titanium/blue,
/area/shuttle/arrival)
"r" = (
/obj/machinery/light,
/obj/structure/chair/comfy/shuttle{
	dir = 4
	},
/turf/open/floor/mineral/titanium,
/area/shuttle/arrival)
"t" = (
/obj/machinery/door/airlock/titanium{
	name = "Arrivals Shuttle Airlock"
	},
/obj/structure/fans/tiny,
/obj/docking_port/mobile/arrivals{
	dir = 4;
	dwidth = 2;
	height = 8;
	width = 5
	},
/turf/open/floor/mineral/titanium/blue,
/area/shuttle/arrival)
"A" = (
/obj/structure/table,
/obj/item/storage/firstaid/regular,
/turf/open/floor/mineral/titanium,
/area/shuttle/arrival)
"F" = (
/obj/machinery/light{
	dir = 1
	},
/obj/structure/chair/comfy/shuttle{
	dir = 4
	},
/turf/open/floor/mineral/titanium,
/area/shuttle/arrival)
"M" = (
/obj/machinery/computer/ship/navigation/public{
	dir = 8
	},
/turf/open/floor/mineral/titanium,
/area/shuttle/arrival)
"N" = (
/obj/machinery/light,
/obj/machinery/computer/station_alert{
	dir = 8
	},
/turf/open/floor/mineral/titanium,
/area/shuttle/arrival)
"Y" = (
/obj/item/twohanded/required/kirbyplants,
/turf/open/floor/mineral/titanium,
/area/shuttle/arrival)
"Z" = (
/turf/closed/wall/mineral/titanium,
/area/shuttle/arrival)

(1,1,1) = {"
Z
Z
t
Z
Z
"}
(2,1,1) = {"
Z
j
e
h
Z
"}
(3,1,1) = {"
Z
F
e
r
Z
"}
(4,1,1) = {"
Z
h
e
h
k
"}
(5,1,1) = {"
Z
e
e
e
k
"}
(6,1,1) = {"
Z
Y
q
A
k
"}
(7,1,1) = {"
Z
f
M
N
Z
"}
(8,1,1) = {"
Z
k
k
k
Z
"}
