//MAP CONVERTED BY dmm2tgm.py THIS HEADER COMMENT PREVENTS RECONVERSION, DO NOT REMOVE
"a" = (
/obj/effect/decal/cleanable/dirt,
/obj/docking_port/mobile/supply{
	dir = 4;
	dwidth = 4;
	height = 8;
	width = 16
	},
/obj/structure/fans/tiny,
/obj/machinery/door/airlock/shuttle{
	name = "Supply Shuttle Airlock";
	req_one_access_txt = "31;69"
	},
/turf/open/floor/mineral/plastitanium,
/area/shuttle/supply)
"b" = (
/turf/closed/wall/mineral/titanium,
/area/shuttle/supply)
"c" = (
/obj/effect/turf_decal/tile/brown,
/obj/effect/turf_decal/tile/brown{
	dir = 1
	},
/obj/effect/turf_decal/stripes/line{
	dir = 9
	},
/turf/open/floor/mineral/titanium/yellow,
/area/shuttle/supply)
"d" = (
/obj/effect/turf_decal/tile/brown,
/obj/effect/turf_decal/tile/brown{
	dir = 1
	},
/obj/effect/turf_decal/stripes/line{
	dir = 1
	},
/turf/open/floor/mineral/titanium/yellow,
/area/shuttle/supply)
"e" = (
/obj/effect/turf_decal/tile/brown,
/obj/effect/turf_decal/tile/brown{
	dir = 1
	},
/obj/effect/turf_decal/stripes/line{
	dir = 5
	},
/turf/open/floor/mineral/titanium/yellow,
/area/shuttle/supply)
"f" = (
/obj/effect/turf_decal/tile/brown,
/obj/effect/turf_decal/tile/brown{
	dir = 1
	},
/obj/effect/turf_decal/stripes/line{
	dir = 10
	},
/turf/open/floor/mineral/titanium/yellow,
/area/shuttle/supply)
"g" = (
/obj/effect/turf_decal/tile/brown,
/obj/effect/turf_decal/tile/brown{
	dir = 1
	},
/obj/effect/turf_decal/stripes/corner{
	dir = 8
	},
/turf/open/floor/mineral/titanium/yellow,
/area/shuttle/supply)
"h" = (
/obj/effect/turf_decal/tile/brown,
/obj/effect/turf_decal/tile/brown{
	dir = 1
	},
/turf/open/floor/mineral/titanium/yellow,
/area/shuttle/supply)
"i" = (
/obj/effect/turf_decal/tile/brown,
/obj/effect/turf_decal/tile/brown{
	dir = 1
	},
/obj/effect/turf_decal/stripes/line{
	dir = 4
	},
/turf/open/floor/mineral/titanium/yellow,
/area/shuttle/supply)
"j" = (
/obj/machinery/conveyor{
	dir = 4;
	id = "QMOnload"
	},
/obj/structure/fans/tiny,
/obj/machinery/door/poddoor/shutters/ship{
	dir = 4;
	id = "QMOnloaddoors";
	name = "Supply Dock Loading Door"
	},
/turf/open/floor/plating,
/area/shuttle/supply)
"k" = (
/obj/effect/turf_decal/loading_area{
	dir = 4
	},
/turf/open/floor/mineral/plastitanium,
/area/shuttle/supply)
"l" = (
/obj/effect/turf_decal/tile/brown,
/obj/effect/turf_decal/tile/brown{
	dir = 1
	},
/obj/effect/turf_decal/stripes/corner{
	dir = 1
	},
/obj/effect/turf_decal/stripes/corner{
	dir = 8
	},
/turf/open/floor/mineral/titanium/yellow,
/area/shuttle/supply)
"m" = (
/obj/effect/turf_decal/tile/brown,
/obj/effect/turf_decal/tile/brown{
	dir = 1
	},
/obj/machinery/light{
	dir = 8
	},
/turf/open/floor/mineral/titanium/yellow,
/area/shuttle/supply)
"n" = (
/obj/effect/turf_decal/tile/brown,
/obj/effect/turf_decal/tile/brown{
	dir = 1
	},
/obj/machinery/light{
	dir = 4
	},
/turf/open/floor/mineral/titanium/yellow,
/area/shuttle/supply)
"o" = (
/obj/effect/turf_decal/tile/brown,
/obj/effect/turf_decal/tile/brown{
	dir = 1
	},
/obj/effect/turf_decal/stripes/line{
	dir = 1
	},
/obj/effect/turf_decal/stripes/corner{
	dir = 8
	},
/turf/open/floor/mineral/titanium/yellow,
/area/shuttle/supply)
"p" = (
/obj/effect/turf_decal/tile/brown,
/obj/effect/turf_decal/tile/brown{
	dir = 1
	},
/obj/effect/turf_decal/stripes/corner{
	dir = 1
	},
/turf/open/floor/mineral/titanium/yellow,
/area/shuttle/supply)
"q" = (
/obj/effect/turf_decal/tile/brown,
/obj/effect/turf_decal/tile/brown{
	dir = 1
	},
/obj/effect/turf_decal/stripes/line{
	dir = 8
	},
/obj/machinery/button/door{
	id = "QMOnloaddoors";
	name = "Loading Doors";
	pixel_x = -24;
	req_one_access_txt = "31;69"
	},
/turf/open/floor/mineral/titanium/yellow,
/area/shuttle/supply)
"r" = (
/obj/effect/spawner/structure/window/shuttle,
/turf/open/floor/plating,
/area/shuttle/supply)
"s" = (
/obj/effect/turf_decal/tile/brown,
/obj/effect/turf_decal/tile/brown{
	dir = 1
	},
/obj/effect/turf_decal/stripes/line{
	dir = 8
	},
/turf/open/floor/mineral/titanium/yellow,
/area/shuttle/supply)
"t" = (
/obj/effect/turf_decal/tile/brown,
/obj/effect/turf_decal/tile/brown{
	dir = 1
	},
/obj/effect/turf_decal/stripes/line{
	dir = 4
	},
/obj/structure/sign/departments/cargo{
	pixel_x = 32
	},
/turf/open/floor/mineral/titanium/yellow,
/area/shuttle/supply)
"u" = (
/obj/effect/turf_decal/tile/brown,
/obj/effect/turf_decal/tile/brown{
	dir = 1
	},
/obj/effect/turf_decal/stripes/line{
	dir = 8
	},
/obj/machinery/button/door{
	id = "QMOffloaddoors";
	name = "Loading Doors";
	pixel_x = -24;
	req_one_access_txt = "31;69"
	},
/turf/open/floor/mineral/titanium/yellow,
/area/shuttle/supply)
"v" = (
/obj/machinery/door/airlock/shuttle{
	name = "Supply Shuttle Airlock";
	req_one_access_txt = "31;69"
	},
/obj/effect/decal/cleanable/dirt,
/obj/structure/fans/tiny,
/turf/open/floor/mineral/plastitanium,
/area/shuttle/supply)
"w" = (
/obj/effect/turf_decal/tile/brown,
/obj/effect/turf_decal/tile/brown{
	dir = 1
	},
/obj/effect/turf_decal/stripes/line,
/obj/effect/turf_decal/stripes/corner{
	dir = 1
	},
/turf/open/floor/mineral/titanium/yellow,
/area/shuttle/supply)
"x" = (
/obj/machinery/conveyor{
	dir = 8;
	id = "QMOffload"
	},
/obj/structure/fans/tiny,
/obj/machinery/door/poddoor/shutters/ship{
	dir = 4;
	id = "QMOffloaddoors";
	name = "Supply Dock Loading Door"
	},
/turf/open/floor/plating,
/area/shuttle/supply)
"y" = (
/obj/effect/turf_decal/loading_area{
	dir = 8
	},
/turf/open/floor/mineral/plastitanium,
/area/shuttle/supply)
"z" = (
/obj/effect/turf_decal/tile/brown,
/obj/effect/turf_decal/tile/brown{
	dir = 1
	},
/obj/effect/turf_decal/stripes/end{
	dir = 8
	},
/turf/open/floor/mineral/titanium/yellow,
/area/shuttle/supply)
"A" = (
/obj/effect/turf_decal/tile/brown,
/obj/effect/turf_decal/tile/brown{
	dir = 1
	},
/obj/effect/turf_decal/stripes/corner,
/turf/open/floor/mineral/titanium/yellow,
/area/shuttle/supply)
"B" = (
/obj/effect/turf_decal/tile/brown,
/obj/effect/turf_decal/tile/brown{
	dir = 1
	},
/obj/effect/turf_decal/stripes/line{
	dir = 6
	},
/turf/open/floor/mineral/titanium/yellow,
/area/shuttle/supply)
"C" = (
/obj/structure/sign/warning/fire,
/turf/closed/wall/mineral/titanium/nodiagonal,
/area/shuttle/supply)
"D" = (
/obj/effect/turf_decal/tile/brown,
/obj/effect/turf_decal/tile/brown{
	dir = 1
	},
/obj/effect/turf_decal/stripes/line,
/turf/open/floor/mineral/titanium/yellow,
/area/shuttle/supply)
"E" = (
/obj/effect/spawner/structure/window/shuttle,
/obj/structure/shuttle/engine/heater,
/turf/open/floor/plating,
/area/shuttle/supply)
"F" = (
/turf/template_noop,
/area/template_noop)
"G" = (
/obj/structure/shuttle/engine/propulsion/burst/left,
/obj/effect/turf_decal/stripes/line,
/turf/open/floor/plating/airless,
/area/shuttle/supply)
"H" = (
/obj/structure/shuttle/engine/propulsion,
/obj/effect/turf_decal/stripes/line,
/turf/open/floor/plating/airless,
/area/shuttle/supply)
"I" = (
/obj/structure/shuttle/engine/propulsion/burst/right,
/obj/effect/turf_decal/stripes/line,
/turf/open/floor/plating/airless,
/area/shuttle/supply)

(1,1,1) = {"
b
b
b
j
a
b
r
r
r
b
v
x
b
b
b
F
"}
(2,1,1) = {"
b
c
f
k
o
q
s
s
s
u
w
y
z
C
b
G
"}
(3,1,1) = {"
b
d
g
l
p
h
h
n
h
h
g
l
l
f
E
H
"}
(4,1,1) = {"
b
d
h
h
h
h
h
b
h
h
h
h
h
D
E
H
"}
(5,1,1) = {"
b
d
h
h
h
h
h
b
h
h
h
h
h
D
E
H
"}
(6,1,1) = {"
b
d
h
h
h
h
h
m
h
h
h
h
A
B
E
H
"}
(7,1,1) = {"
b
e
i
i
i
i
i
t
i
i
i
i
B
C
b
I
"}
(8,1,1) = {"
b
b
b
b
b
b
b
b
b
b
b
b
b
b
b
F
"}
