"a" = (/turf/template_noop,/area/space)
"b" = (/obj/effect/turf_decal/tile/brown,/obj/effect/turf_decal/tile/brown{dir = 1},/obj/effect/turf_decal/stripes/corner,/turf/open/floor/mineral/titanium/yellow,/area/space)
"c" = (/obj/effect/turf_decal/tile/brown,/obj/effect/turf_decal/tile/brown{dir = 1},/obj/effect/turf_decal/stripes/end{dir = 8},/turf/open/floor/mineral/titanium/yellow,/area/space)
"f" = (/obj/effect/turf_decal/tile/brown,/obj/effect/turf_decal/tile/brown{dir = 1},/obj/effect/turf_decal/stripes/line{dir = 8},/obj/machinery/button/door{id = "QMOffloaddoors"; name = "Loading Doors"; pixel_x = -24; req_one_access_txt = "31;69"},/turf/open/floor/mineral/titanium/yellow,/area/space)
"h" = (/obj/effect/turf_decal/loading_area{dir = 8},/turf/open/floor/mineral/plastitanium,/area/space)
"i" = (/obj/effect/spawner/structure/window/shuttle,/obj/structure/shuttle/engine/heater,/turf/open/floor/plating,/area/space)
"j" = (/obj/machinery/conveyor{dir = 4; id = "QMOnload"},/obj/structure/fans/tiny,/obj/machinery/door/poddoor/shutters/ship{dir = 4; id = "QMOnloaddoors"; name = "Supply Dock Loading Door"},/turf/open/floor/plating,/area/space)
"k" = (/obj/effect/turf_decal/tile/brown,/obj/effect/turf_decal/tile/brown{dir = 1},/obj/effect/turf_decal/stripes/corner{dir = 8},/turf/open/floor/mineral/titanium/yellow,/area/space)
"m" = (/obj/effect/decal/cleanable/dirt,/obj/docking_port/mobile/supply{dir = 4; dwidth = 4; height = 8; width = 16},/obj/structure/fans/tiny,/obj/machinery/door/airlock/shuttle{name = "Supply Shuttle Airlock"; req_one_access_txt = "31;69"},/turf/open/floor/mineral/plastitanium,/area/space)
"o" = (/obj/effect/turf_decal/tile/brown,/obj/effect/turf_decal/tile/brown{dir = 1},/turf/open/floor/mineral/titanium/yellow,/area/space)
"q" = (/obj/effect/turf_decal/tile/brown,/obj/effect/turf_decal/tile/brown{dir = 1},/obj/effect/turf_decal/stripes/line{dir = 6},/turf/open/floor/mineral/titanium/yellow,/area/space)
"r" = (/obj/effect/turf_decal/tile/brown,/obj/effect/turf_decal/tile/brown{dir = 1},/obj/effect/turf_decal/stripes/corner{dir = 1},/turf/open/floor/mineral/titanium/yellow,/area/space)
"s" = (/obj/effect/turf_decal/tile/brown,/obj/effect/turf_decal/tile/brown{dir = 1},/obj/effect/turf_decal/stripes/line,/turf/open/floor/mineral/titanium/yellow,/area/space)
"t" = (/obj/effect/spawner/structure/window/shuttle,/turf/open/floor/plating,/area/space)
"v" = (/obj/effect/turf_decal/tile/brown,/obj/effect/turf_decal/tile/brown{dir = 1},/obj/machinery/light{dir = 4},/turf/open/floor/mineral/titanium/yellow,/area/space)
"w" = (/obj/effect/turf_decal/loading_area{dir = 4},/turf/open/floor/mineral/plastitanium,/area/space)
"y" = (/turf/closed/wall/mineral/titanium,/area/space)
"z" = (/obj/effect/turf_decal/tile/brown,/obj/effect/turf_decal/tile/brown{dir = 1},/obj/effect/turf_decal/stripes/line,/obj/effect/turf_decal/stripes/corner{dir = 1},/turf/open/floor/mineral/titanium/yellow,/area/space)
"A" = (/obj/structure/shuttle/engine/propulsion/burst/left,/obj/effect/turf_decal/stripes/line,/turf/open/floor/plating/airless,/area/space)
"E" = (/obj/effect/turf_decal/tile/brown,/obj/effect/turf_decal/tile/brown{dir = 1},/obj/effect/turf_decal/stripes/line{dir = 1},/obj/effect/turf_decal/stripes/corner{dir = 8},/turf/open/floor/mineral/titanium/yellow,/area/space)
"F" = (/obj/effect/turf_decal/tile/brown,/obj/effect/turf_decal/tile/brown{dir = 1},/obj/effect/turf_decal/stripes/line{dir = 8},/turf/open/floor/mineral/titanium/yellow,/area/space)
"G" = (/obj/effect/turf_decal/tile/brown,/obj/effect/turf_decal/tile/brown{dir = 1},/obj/effect/turf_decal/stripes/line{dir = 4},/turf/open/floor/mineral/titanium/yellow,/area/space)
"H" = (/obj/structure/shuttle/engine/propulsion,/obj/effect/turf_decal/stripes/line,/turf/open/floor/plating/airless,/area/space)
"J" = (/obj/structure/shuttle/engine/propulsion/burst/right,/obj/effect/turf_decal/stripes/line,/turf/open/floor/plating/airless,/area/space)
"K" = (/obj/effect/turf_decal/tile/brown,/obj/effect/turf_decal/tile/brown{dir = 1},/obj/effect/turf_decal/stripes/corner{dir = 1},/obj/effect/turf_decal/stripes/corner{dir = 8},/turf/open/floor/mineral/titanium/yellow,/area/space)
"L" = (/obj/effect/turf_decal/tile/brown,/obj/effect/turf_decal/tile/brown{dir = 1},/obj/effect/turf_decal/stripes/line{dir = 9},/turf/open/floor/mineral/titanium/yellow,/area/space)
"M" = (/obj/effect/turf_decal/tile/brown,/obj/effect/turf_decal/tile/brown{dir = 1},/obj/effect/turf_decal/stripes/line{dir = 8},/obj/machinery/button/door{id = "QMOnloaddoors"; name = "Loading Doors"; pixel_x = -24; req_one_access_txt = "31;69"},/turf/open/floor/mineral/titanium/yellow,/area/space)
"N" = (/obj/machinery/door/airlock/shuttle{name = "Supply Shuttle Airlock"; req_one_access_txt = "31;69"},/obj/effect/decal/cleanable/dirt,/obj/structure/fans/tiny,/turf/open/floor/mineral/plastitanium,/area/space)
"Q" = (/obj/structure/sign/warning/fire,/turf/closed/wall/mineral/titanium/nodiagonal,/area/space)
"R" = (/obj/effect/turf_decal/tile/brown,/obj/effect/turf_decal/tile/brown{dir = 1},/obj/effect/turf_decal/stripes/line{dir = 1},/turf/open/floor/mineral/titanium/yellow,/area/space)
"S" = (/obj/effect/turf_decal/tile/brown,/obj/effect/turf_decal/tile/brown{dir = 1},/obj/machinery/light{dir = 8},/turf/open/floor/mineral/titanium/yellow,/area/space)
"U" = (/obj/machinery/conveyor{dir = 8; id = "QMOffload"},/obj/structure/fans/tiny,/obj/machinery/door/poddoor/shutters/ship{dir = 4; id = "QMOffloaddoors"; name = "Supply Dock Loading Door"},/turf/open/floor/plating,/area/space)
"V" = (/obj/effect/turf_decal/tile/brown,/obj/effect/turf_decal/tile/brown{dir = 1},/obj/effect/turf_decal/stripes/line{dir = 4},/obj/structure/sign/departments/cargo{pixel_x = 32},/turf/open/floor/mineral/titanium/yellow,/area/space)
"X" = (/obj/effect/turf_decal/tile/brown,/obj/effect/turf_decal/tile/brown{dir = 1},/obj/effect/turf_decal/stripes/line{dir = 10},/turf/open/floor/mineral/titanium/yellow,/area/space)
"Z" = (/obj/effect/turf_decal/tile/brown,/obj/effect/turf_decal/tile/brown{dir = 1},/obj/effect/turf_decal/stripes/line{dir = 5},/turf/open/floor/mineral/titanium/yellow,/area/space)

(1,1,1) = {"
yyyyyyy
yLRRRZy
yXkooGy
jwKooGy
mErooGy
yMoooGy
tFoooGy
tFvySVy
tFoooGy
yfoooGy
NzkooGy
UhKooGy
ycKobqy
yQXsqQy
yyiiiyy
aAHHHJa
"}
