//MAP CONVERTED BY dmm2tgm.py THIS HEADER COMMENT PREVENTS RECONVERSION, DO NOT REMOVE
"a" = (
/obj/effect/turf_decal/tile/brown,
/obj/effect/turf_decal/tile/brown{
	dir = 1
	},
/obj/structure/fans/tiny/invisible,
/turf/open/floor/mineral/titanium/yellow,
/area/shuttle/supply)
"i" = (
/obj/structure/fans/tiny/invisible,
/obj/effect/turf_decal/loading_area{
	dir = 8
	},
/obj/docking_port/mobile/supply{
	dwidth = 1;
	height = 2;
	width = 3
	},
/obj/machinery/light/runway,
/turf/open/floor/mineral/plastitanium,
/area/shuttle/supply)
"I" = (
/obj/structure/fans/tiny/invisible,
/obj/effect/turf_decal/ship/delivery/yellow,
/turf/open/floor/mineral/plastitanium,
/area/shuttle/supply)

(1,1,1) = {"
a
I
a
"}
(2,1,1) = {"
a
i
a
"}
