"a" = (/turf/template_noop,/area/shuttle_arena)
"c" = (/obj/effect/turf_decal/tile/brown,/obj/effect/turf_decal/tile/brown{dir = 1},/obj/effect/turf_decal/stripes/line{dir = 8},/obj/machinery/button/door{id = "QMOffloaddoors"; name = "Loading Doors"; pixel_x = -24; req_one_access_txt = "31;69"},/turf/open/floor/mineral/titanium/yellow,/area/shuttle)
"d" = (/obj/effect/turf_decal/tile/brown,/obj/effect/turf_decal/tile/brown{dir = 1},/obj/effect/turf_decal/stripes/line{dir = 1},/turf/open/floor/mineral/titanium/yellow,/area/shuttle)
"e" = (/obj/effect/turf_decal/tile/brown,/obj/effect/turf_decal/tile/brown{dir = 1},/obj/effect/turf_decal/stripes/line{dir = 4},/obj/structure/sign/departments/cargo{pixel_x = 32},/turf/open/floor/mineral/titanium/yellow,/area/shuttle)
"f" = (/obj/effect/turf_decal/tile/brown,/obj/effect/turf_decal/tile/brown{dir = 1},/obj/machinery/light{dir = 4},/turf/open/floor/mineral/titanium/yellow,/area/shuttle)
"l" = (/obj/effect/turf_decal/tile/brown,/obj/effect/turf_decal/tile/brown{dir = 1},/obj/effect/turf_decal/stripes/corner{dir = 1},/obj/effect/turf_decal/stripes/corner{dir = 8},/turf/open/floor/mineral/titanium/yellow,/area/shuttle)
"m" = (/obj/effect/turf_decal/tile/brown,/obj/effect/turf_decal/tile/brown{dir = 1},/obj/effect/turf_decal/stripes/line{dir = 8},/turf/open/floor/mineral/titanium/yellow,/area/shuttle)
"n" = (/obj/effect/turf_decal/tile/brown,/obj/effect/turf_decal/tile/brown{dir = 1},/obj/effect/turf_decal/stripes/corner{dir = 8},/turf/open/floor/mineral/titanium/yellow,/area/shuttle)
"o" = (/obj/effect/turf_decal/tile/brown,/obj/effect/turf_decal/tile/brown{dir = 1},/obj/effect/turf_decal/stripes/line,/turf/open/floor/mineral/titanium/yellow,/area/shuttle)
"p" = (/obj/structure/shuttle/engine/propulsion,/obj/effect/turf_decal/stripes/line,/turf/open/floor/plating/airless,/area/shuttle)
"q" = (/obj/effect/turf_decal/tile/brown,/obj/effect/turf_decal/tile/brown{dir = 1},/obj/effect/turf_decal/stripes/line{dir = 4},/turf/open/floor/mineral/titanium/yellow,/area/shuttle)
"r" = (/turf/closed/wall/mineral/titanium,/area/shuttle)
"s" = (/obj/effect/turf_decal/tile/brown,/obj/effect/turf_decal/tile/brown{dir = 1},/obj/effect/turf_decal/stripes/line,/obj/effect/turf_decal/stripes/corner{dir = 1},/turf/open/floor/mineral/titanium/yellow,/area/shuttle)
"u" = (/obj/effect/turf_decal/tile/brown,/obj/effect/turf_decal/tile/brown{dir = 1},/obj/effect/turf_decal/stripes/line{dir = 8},/obj/machinery/button/door{id = "QMOnloaddoors"; name = "Loading Doors"; pixel_x = -24; req_one_access_txt = "31;69"},/turf/open/floor/mineral/titanium/yellow,/area/shuttle)
"w" = (/obj/effect/turf_decal/tile/brown,/obj/effect/turf_decal/tile/brown{dir = 1},/obj/machinery/light{dir = 8},/turf/open/floor/mineral/titanium/yellow,/area/shuttle)
"x" = (/obj/effect/turf_decal/tile/brown,/obj/effect/turf_decal/tile/brown{dir = 1},/obj/effect/turf_decal/stripes/end{dir = 8},/turf/open/floor/mineral/titanium/yellow,/area/shuttle)
"A" = (/obj/machinery/conveyor{dir = 4; id = "QMOnload"},/obj/structure/fans/tiny,/obj/machinery/door/poddoor/shutters/ship{dir = 4; id = "QMOnloaddoors"; name = "Supply Dock Loading Door"},/turf/open/floor/plating,/area/shuttle)
"B" = (/obj/effect/turf_decal/tile/brown,/obj/effect/turf_decal/tile/brown{dir = 1},/obj/effect/turf_decal/stripes/corner{dir = 1},/turf/open/floor/mineral/titanium/yellow,/area/shuttle)
"C" = (/obj/structure/shuttle/engine/propulsion/burst/right,/obj/effect/turf_decal/stripes/line,/turf/open/floor/plating/airless,/area/shuttle)
"D" = (/obj/effect/turf_decal/loading_area{dir = 8},/turf/open/floor/mineral/plastitanium,/area/shuttle)
"E" = (/obj/effect/spawner/structure/window/shuttle,/obj/structure/shuttle/engine/heater,/turf/open/floor/plating,/area/shuttle)
"J" = (/obj/effect/turf_decal/tile/brown,/obj/effect/turf_decal/tile/brown{dir = 1},/obj/effect/turf_decal/stripes/line{dir = 1},/obj/effect/turf_decal/stripes/corner{dir = 8},/turf/open/floor/mineral/titanium/yellow,/area/shuttle)
"K" = (/obj/structure/shuttle/engine/propulsion/burst/left,/obj/effect/turf_decal/stripes/line,/turf/open/floor/plating/airless,/area/shuttle)
"L" = (/obj/structure/sign/warning/fire,/turf/closed/wall/mineral/titanium/nodiagonal,/area/shuttle)
"M" = (/obj/effect/turf_decal/tile/brown,/obj/effect/turf_decal/tile/brown{dir = 1},/obj/effect/turf_decal/stripes/line{dir = 10},/turf/open/floor/mineral/titanium/yellow,/area/shuttle)
"N" = (/obj/effect/turf_decal/tile/brown,/obj/effect/turf_decal/tile/brown{dir = 1},/obj/effect/turf_decal/stripes/corner,/turf/open/floor/mineral/titanium/yellow,/area/shuttle)
"O" = (/obj/effect/turf_decal/tile/brown,/obj/effect/turf_decal/tile/brown{dir = 1},/obj/effect/turf_decal/stripes/line{dir = 6},/turf/open/floor/mineral/titanium/yellow,/area/shuttle)
"P" = (/obj/machinery/door/airlock/shuttle{name = "Supply Shuttle Airlock"; req_one_access_txt = "31;69"},/obj/effect/decal/cleanable/dirt,/obj/structure/fans/tiny,/turf/open/floor/mineral/plastitanium,/area/shuttle)
"R" = (/obj/effect/turf_decal/tile/brown,/obj/effect/turf_decal/tile/brown{dir = 1},/turf/open/floor/mineral/titanium/yellow,/area/shuttle)
"S" = (/obj/effect/turf_decal/tile/brown,/obj/effect/turf_decal/tile/brown{dir = 1},/obj/effect/turf_decal/stripes/line{dir = 9},/turf/open/floor/mineral/titanium/yellow,/area/shuttle)
"T" = (/obj/effect/decal/cleanable/dirt,/obj/structure/fans/tiny,/obj/machinery/door/airlock/shuttle{name = "Supply Shuttle Airlock"; req_one_access_txt = "31;69"},/obj/docking_port/mobile/supply{dir = 4; dwidth = 4; name = "Supply Shuttle"; width = 16},/turf/open/floor/mineral/plastitanium,/area/shuttle)
"U" = (/obj/effect/spawner/structure/window/shuttle,/turf/open/floor/plating,/area/shuttle)
"V" = (/obj/machinery/conveyor{dir = 8; id = "QMOffload"},/obj/structure/fans/tiny,/obj/machinery/door/poddoor/shutters/ship{dir = 4; id = "QMOffloaddoors"; name = "Supply Dock Loading Door"},/turf/open/floor/plating,/area/shuttle)
"X" = (/obj/effect/turf_decal/loading_area{dir = 4},/turf/open/floor/mineral/plastitanium,/area/shuttle)
"Z" = (/obj/effect/turf_decal/tile/brown,/obj/effect/turf_decal/tile/brown{dir = 1},/obj/effect/turf_decal/stripes/line{dir = 5},/turf/open/floor/mineral/titanium/yellow,/area/shuttle)

(1,1,1) = {"
rrrrrrr
rSdddZr
rMnRRqr
AXlRRqr
TJBRRqr
ruRRRqr
UmRRRqr
Umfrwer
UmRRRqr
rcRRRqr
PsnRRqr
VDlRRqr
rxlRNOr
rLMoOLr
rrEEErr
aKpppCa
"}
