"a" = (/turf/template_noop,/area/template_noop)
"c" = (/obj/effect/turf_decal/loading_area{dir = 8},/turf/open/floor/mineral/plastitanium,/area/shuttle/supply)
"e" = (/obj/structure/sign/warning/fire,/turf/closed/wall/mineral/titanium/nodiagonal,/area/shuttle/supply)
"f" = (/obj/structure/shuttle/engine/propulsion/burst/left,/obj/effect/turf_decal/stripes/line,/turf/open/floor/plating/airless,/area/shuttle/supply)
"g" = (/obj/effect/turf_decal/tile/brown,/obj/effect/turf_decal/tile/brown{dir = 1},/obj/effect/turf_decal/stripes/line{dir = 1},/obj/effect/turf_decal/stripes/corner{dir = 8},/turf/open/floor/mineral/titanium/yellow,/area/shuttle/supply)
"h" = (/obj/machinery/door/airlock/shuttle{name = "Supply Shuttle Airlock"; req_one_access_txt = "31;69"},/obj/effect/decal/cleanable/dirt,/obj/structure/fans/tiny,/turf/open/floor/mineral/plastitanium,/area/shuttle/supply)
"j" = (/obj/effect/turf_decal/tile/brown,/obj/effect/turf_decal/tile/brown{dir = 1},/obj/effect/turf_decal/stripes/corner,/turf/open/floor/mineral/titanium/yellow,/area/shuttle/supply)
"k" = (/obj/effect/turf_decal/tile/brown,/obj/effect/turf_decal/tile/brown{dir = 1},/obj/effect/turf_decal/stripes/line{dir = 6},/turf/open/floor/mineral/titanium/yellow,/area/shuttle/supply)
"m" = (/obj/machinery/conveyor{dir = 4; id = "QMOnload"},/obj/structure/fans/tiny,/obj/machinery/door/poddoor/shutters/ship{dir = 4; id = "QMOnloaddoors"; name = "Supply Dock Loading Door"},/turf/open/floor/plating,/area/shuttle/supply)
"n" = (/obj/effect/turf_decal/tile/brown,/obj/effect/turf_decal/tile/brown{dir = 1},/obj/effect/turf_decal/stripes/line{dir = 4},/turf/open/floor/mineral/titanium/yellow,/area/shuttle/supply)
"p" = (/obj/effect/turf_decal/tile/brown,/obj/effect/turf_decal/tile/brown{dir = 1},/turf/open/floor/mineral/titanium/yellow,/area/shuttle/supply)
"q" = (/obj/effect/turf_decal/tile/brown,/obj/effect/turf_decal/tile/brown{dir = 1},/obj/effect/turf_decal/stripes/line,/obj/effect/turf_decal/stripes/corner{dir = 1},/turf/open/floor/mineral/titanium/yellow,/area/shuttle/supply)
"s" = (/obj/structure/shuttle/engine/propulsion,/obj/effect/turf_decal/stripes/line,/turf/open/floor/plating/airless,/area/shuttle/supply)
"u" = (/obj/effect/turf_decal/tile/brown,/obj/effect/turf_decal/tile/brown{dir = 1},/obj/effect/turf_decal/stripes/line{dir = 9},/turf/open/floor/mineral/titanium/yellow,/area/shuttle/supply)
"w" = (/obj/effect/turf_decal/tile/brown,/obj/effect/turf_decal/tile/brown{dir = 1},/obj/effect/turf_decal/stripes/line{dir = 8},/turf/open/floor/mineral/titanium/yellow,/area/shuttle/supply)
"x" = (/obj/effect/turf_decal/loading_area{dir = 4},/turf/open/floor/mineral/plastitanium,/area/shuttle/supply)
"z" = (/obj/effect/turf_decal/tile/brown,/obj/effect/turf_decal/tile/brown{dir = 1},/obj/effect/turf_decal/stripes/corner{dir = 1},/obj/effect/turf_decal/stripes/corner{dir = 8},/turf/open/floor/mineral/titanium/yellow,/area/shuttle/supply)
"A" = (/obj/structure/shuttle/engine/propulsion/burst/right,/obj/effect/turf_decal/stripes/line,/turf/open/floor/plating/airless,/area/shuttle/supply)
"B" = (/obj/effect/spawner/structure/window/shuttle,/turf/open/floor/plating,/area/shuttle/supply)
"C" = (/obj/effect/decal/cleanable/dirt,/obj/docking_port/mobile/supply{dir = 4; dwidth = 4; height = 8; width = 16},/obj/structure/fans/tiny,/obj/machinery/door/airlock/shuttle{name = "Supply Shuttle Airlock"; req_one_access_txt = "31;69"},/turf/open/floor/mineral/plastitanium,/area/shuttle/supply)
"D" = (/obj/effect/turf_decal/tile/brown,/obj/effect/turf_decal/tile/brown{dir = 1},/obj/effect/turf_decal/stripes/end{dir = 8},/turf/open/floor/mineral/titanium/yellow,/area/shuttle/supply)
"H" = (/obj/effect/turf_decal/tile/brown,/obj/effect/turf_decal/tile/brown{dir = 1},/obj/effect/turf_decal/stripes/line{dir = 1},/turf/open/floor/mineral/titanium/yellow,/area/shuttle/supply)
"I" = (/obj/effect/turf_decal/tile/brown,/obj/effect/turf_decal/tile/brown{dir = 1},/obj/effect/turf_decal/stripes/line{dir = 8},/obj/machinery/button/door{id = "QMOnloaddoors"; name = "Loading Doors"; pixel_x = -24; req_one_access_txt = "31;69"},/turf/open/floor/mineral/titanium/yellow,/area/shuttle/supply)
"J" = (/obj/effect/turf_decal/tile/brown,/obj/effect/turf_decal/tile/brown{dir = 1},/obj/effect/turf_decal/stripes/line{dir = 8},/obj/machinery/button/door{id = "QMOffloaddoors"; name = "Loading Doors"; pixel_x = -24; req_one_access_txt = "31;69"},/turf/open/floor/mineral/titanium/yellow,/area/shuttle/supply)
"M" = (/obj/effect/spawner/structure/window/shuttle,/obj/structure/shuttle/engine/heater,/turf/open/floor/plating,/area/shuttle/supply)
"N" = (/obj/machinery/conveyor{dir = 8; id = "QMOffload"},/obj/structure/fans/tiny,/obj/machinery/door/poddoor/shutters/ship{dir = 4; id = "QMOffloaddoors"; name = "Supply Dock Loading Door"},/turf/open/floor/plating,/area/shuttle/supply)
"P" = (/obj/effect/turf_decal/tile/brown,/obj/effect/turf_decal/tile/brown{dir = 1},/obj/effect/turf_decal/stripes/corner{dir = 8},/turf/open/floor/mineral/titanium/yellow,/area/shuttle/supply)
"R" = (/obj/effect/turf_decal/tile/brown,/obj/effect/turf_decal/tile/brown{dir = 1},/obj/effect/turf_decal/stripes/corner{dir = 1},/turf/open/floor/mineral/titanium/yellow,/area/shuttle/supply)
"S" = (/obj/effect/turf_decal/tile/brown,/obj/effect/turf_decal/tile/brown{dir = 1},/obj/effect/turf_decal/stripes/line{dir = 4},/obj/structure/sign/departments/cargo{pixel_x = 32},/turf/open/floor/mineral/titanium/yellow,/area/shuttle/supply)
"T" = (/obj/effect/turf_decal/tile/brown,/obj/effect/turf_decal/tile/brown{dir = 1},/obj/effect/turf_decal/stripes/line{dir = 10},/turf/open/floor/mineral/titanium/yellow,/area/shuttle/supply)
"W" = (/obj/effect/turf_decal/tile/brown,/obj/effect/turf_decal/tile/brown{dir = 1},/obj/effect/turf_decal/stripes/line{dir = 5},/turf/open/floor/mineral/titanium/yellow,/area/shuttle/supply)
"X" = (/turf/closed/wall/mineral/titanium,/area/shuttle/supply)

(1,1,1) = {"
XXXXXX
XuHHWX
XTPpnX
mxzpnX
CgRpnX
XIppnX
BwppnX
BwppSX
BwppnX
XJppnX
hqPpnX
NczpnX
XDzjkX
XeTkeX
XXMMXX
afssAa
"}
