//MAP CONVERTED BY dmm2tgm.py THIS HEADER COMMENT PREVENTS RECONVERSION, DO NOT REMOVE
"cr" = (
/obj/machinery/button/flasher{
	pixel_y = -21;
	req_one_access_txt = "3;4;38;63";
	id = "celerity_sec"
	},
/obj/item/storage/box/handcuffs{
	pixel_x = 9;
	pixel_y = 3
	},
/obj/structure/table/glass/plasma,
/obj/machinery/recharger{
	pixel_x = -5
	},
/turf/open/floor/noslip/dark,
/area/shuttle/escape)
"dL" = (
/obj/structure/chair/shuttlecraft_chair{
	dir = 4;
	pixel_x = -8
	},
/turf/open/floor/noslip/dark,
/area/shuttle/escape)
"ev" = (
/obj/structure/chair/shuttlecraft_chair{
	dir = 4;
	pixel_x = -8
	},
/turf/open/floor/noslip/standard,
/area/shuttle/escape)
"gX" = (
/obj/machinery/computer/emergency_shuttle{
	dir = 1
	},
/turf/open/floor/noslip/white,
/area/shuttle/escape)
"iq" = (
/obj/structure/reagent_dispensers/peppertank{
	pixel_y = -30
	},
/turf/open/floor/noslip/dark,
/area/shuttle/escape)
"jo" = (
/obj/machinery/door/airlock/ship/command/glass{
	name = "Bridge";
	req_access_txt = "19";
	req_one_access_txt = "19"
	},
/turf/open/floor/noslip/white,
/area/shuttle/escape)
"ka" = (
/obj/structure/reagent_dispensers/fueltank{
	anchored = 1
	},
/turf/open/floor/noslip,
/area/shuttle/escape)
"ky" = (
/obj/structure/sign/departments/minsky/security/security{
	pixel_y = -32
	},
/obj/item/storage/firstaid/regular{
	pixel_x = 6;
	pixel_y = 6
	},
/obj/item/storage/firstaid/regular{
	pixel_x = 3;
	pixel_y = 3
	},
/obj/item/storage/firstaid/regular,
/obj/structure/table/glass/plasma,
/turf/open/floor/noslip/blue,
/area/shuttle/escape)
"lx" = (
/obj/structure/window/plasma/reinforced{
	dir = 4
	},
/obj/machinery/flasher{
	pixel_y = 22;
	id = "celerity_sec"
	},
/turf/open/floor/noslip/dark,
/area/shuttle/escape)
"ly" = (
/obj/structure/sign/departments/minsky/security/security{
	pixel_y = -32
	},
/obj/machinery/vending/medical,
/turf/open/floor/noslip/blue,
/area/shuttle/escape)
"oy" = (
/obj/structure/chair/shuttlecraft_chair{
	dir = 4;
	pixel_x = -8
	},
/turf/open/floor/noslip/white,
/area/shuttle/escape)
"oA" = (
/obj/effect/spawner/structure/window/shuttle,
/turf/open/floor/plating,
/area/shuttle/escape)
"pp" = (
/obj/structure/window/plasma/reinforced{
	dir = 4
	},
/obj/machinery/flasher{
	pixel_y = -22;
	id = "celerity_sec"
	},
/turf/open/floor/noslip/dark,
/area/shuttle/escape)
"pI" = (
/obj/machinery/door/airlock/shuttle/glass,
/obj/structure/fans/tiny,
/turf/open/floor/noslip/standard,
/area/shuttle/escape)
"qt" = (
/obj/structure/chair/shuttlecraft_chair{
	dir = 8;
	pixel_x = 8
	},
/turf/open/floor/noslip/dark,
/area/shuttle/escape)
"rr" = (
/obj/structure/closet/emcloset,
/turf/open/floor/noslip,
/area/shuttle/escape)
"sT" = (
/turf/open/floor/noslip/standard,
/area/shuttle/escape)
"ti" = (
/obj/docking_port/mobile/emergency{
	dir = 2;
	id = "emergency_celerity";
	name = "Celerity Main Docking"
	},
/obj/machinery/door/airlock/shuttle/glass,
/obj/structure/fans/tiny,
/turf/open/floor/noslip/standard,
/area/shuttle/escape)
"tA" = (
/obj/structure/table/glass/plasma,
/obj/item/defibrillator/loaded,
/obj/item/storage/firstaid/advanced,
/turf/open/floor/noslip/blue,
/area/shuttle/escape)
"tJ" = (
/obj/structure/reagent_dispensers/water_cooler,
/turf/open/floor/noslip,
/area/shuttle/escape)
"ua" = (
/obj/structure/table/glass/plasma,
/obj/item/storage/toolbox/mechanical,
/turf/open/floor/noslip/white,
/area/shuttle/escape)
"uh" = (
/obj/machinery/recharge_station,
/turf/open/floor/noslip,
/area/shuttle/escape)
"vv" = (
/obj/machinery/stasis,
/turf/open/floor/noslip/blue,
/area/shuttle/escape)
"vK" = (
/obj/structure/chair/comfy/shuttle,
/turf/open/floor/noslip/white,
/area/shuttle/escape)
"wn" = (
/obj/structure/closet/crate/freezer/blood{
	anchored = 1
	},
/obj/machinery/iv_drip,
/turf/open/floor/noslip/blue,
/area/shuttle/escape)
"wr" = (
/obj/machinery/computer/station_alert{
	dir = 1;
	name = "ship alert console"
	},
/turf/open/floor/noslip/white,
/area/shuttle/escape)
"xh" = (
/obj/structure/reagent_dispensers/watertank,
/turf/open/floor/noslip,
/area/shuttle/escape)
"yU" = (
/obj/structure/shuttle/engine/propulsion{
	dir = 1
	},
/turf/open/floor/plating,
/area/shuttle/escape)
"zL" = (
/obj/structure/table/glass/plasma,
/obj/structure/extinguisher_cabinet/east,
/obj/item/phone,
/turf/open/floor/noslip/white,
/area/shuttle/escape)
"Aj" = (
/obj/structure/window/plasma/reinforced/spawner/east,
/obj/structure/chair/shuttlecraft_chair{
	dir = 8;
	pixel_x = 2
	},
/turf/open/floor/noslip/standard,
/area/shuttle/escape)
"BG" = (
/obj/structure/closet/crate/medical{
	name = "medical crate"
	},
/obj/item/storage/firstaid/regular,
/obj/item/storage/firstaid/o2{
	pixel_x = 3;
	pixel_y = 3
	},
/obj/item/storage/firstaid/toxin{
	pixel_x = -4;
	pixel_y = 3
	},
/obj/item/healthanalyzer{
	pixel_x = 3;
	pixel_y = 3
	},
/obj/item/lazarus_injector,
/mob/living/simple_animal/bot/medbot{
	name = "\improper emergency medibot";
	pixel_x = -3;
	pixel_y = 2
	},
/turf/open/floor/noslip,
/area/shuttle/escape)
"BX" = (
/obj/structure/closet/firecloset{
	anchored = 1
	},
/turf/open/floor/noslip,
/area/shuttle/escape)
"Dk" = (
/turf/closed/wall/mineral/titanium,
/area/shuttle/escape)
"DJ" = (
/obj/structure/chair/shuttlecraft_chair{
	pixel_y = 18
	},
/turf/open/floor/noslip/blue,
/area/shuttle/escape)
"Ey" = (
/obj/structure/chair/shuttlecraft_chair{
	dir = 8;
	pixel_x = 8
	},
/turf/open/floor/noslip/white,
/area/shuttle/escape)
"Ft" = (
/obj/structure/tank_dispenser/oxygen,
/turf/open/floor/noslip,
/area/shuttle/escape)
"FH" = (
/turf/open/floor/noslip/dark,
/area/shuttle/escape)
"Hr" = (
/obj/structure/table/glass/plasma,
/obj/machinery/recharger{
	active_power_usage = 0;
	idle_power_usage = 0;
	pixel_y = 4;
	use_power = 0
	},
/turf/open/floor/noslip/white,
/area/shuttle/escape)
"Ii" = (
/obj/machinery/vending/wallmed{
	name = "Emergency NanoMed";
	use_power = 0
	},
/turf/closed/wall/mineral/titanium,
/area/shuttle/escape)
"IG" = (
/obj/structure/closet/radiation{
	anchored = 1
	},
/turf/open/floor/noslip,
/area/shuttle/escape)
"IH" = (
/obj/structure/window/plasma/reinforced/spawner/west,
/obj/structure/chair/shuttlecraft_chair{
	dir = 4;
	pixel_x = -2
	},
/turf/open/floor/noslip/standard,
/area/shuttle/escape)
"IV" = (
/turf/open/floor/noslip,
/area/shuttle/escape)
"Jc" = (
/obj/machinery/door/window/brigdoor/security/cell/eastright{
	req_one_access_txt = "3;4;38;63"
	},
/turf/open/floor/noslip/dark,
/area/shuttle/escape)
"KC" = (
/turf/open/floor/noslip/blue,
/area/shuttle/escape)
"NH" = (
/turf/template_noop,
/area/shuttle/escape)
"NR" = (
/obj/structure/reagent_dispensers/peppertank{
	pixel_y = 32
	},
/turf/open/floor/noslip/dark,
/area/shuttle/escape)
"Ov" = (
/obj/machinery/computer/crew{
	dir = 1
	},
/turf/open/floor/noslip/white,
/area/shuttle/escape)
"Qp" = (
/obj/machinery/door/airlock/ship/medical/glass{
	req_one_access_txt = "5;2;34;19";
	name = "Trauma Center"
	},
/turf/open/floor/noslip/blue,
/area/shuttle/escape)
"QN" = (
/obj/structure/shuttle/engine/propulsion,
/turf/open/floor/plating,
/area/shuttle/escape)
"QZ" = (
/obj/structure/table/glass/plasma,
/turf/open/floor/noslip/white,
/area/shuttle/escape)
"Tv" = (
/obj/machinery/door/airlock/ship/security/glass{
	req_one_access_txt = "2;34;19"
	},
/turf/open/floor/noslip/dark,
/area/shuttle/escape)
"TD" = (
/turf/open/floor/noslip/white,
/area/shuttle/escape)
"VU" = (
/obj/structure/sign/departments/medbay/alt{
	pixel_y = -32
	},
/turf/open/floor/noslip/standard,
/area/shuttle/escape)
"Wo" = (
/obj/structure/chair/shuttlecraft_chair{
	dir = 8;
	pixel_x = 8
	},
/turf/open/floor/noslip/standard,
/area/shuttle/escape)
"Yl" = (
/obj/structure/table/glass/plasma,
/obj/item/storage/backpack/duffelbag/med/surgery,
/obj/item/storage/backpack/duffelbag/med/surgery{
	pixel_y = 6
	},
/turf/open/floor/noslip/blue,
/area/shuttle/escape)
"ZX" = (
/obj/structure/extinguisher_cabinet/south,
/turf/open/floor/noslip/dark,
/area/shuttle/escape)

(1,1,1) = {"
NH
NH
Dk
pI
Dk
Dk
Dk
Dk
pI
Dk
QN
NH
NH
NH
NH
NH
NH
NH
NH
NH
NH
NH
NH
NH
NH
NH
"}
(2,1,1) = {"
NH
NH
pI
sT
ev
ev
ev
ev
sT
Dk
Dk
oA
Dk
Dk
QN
NH
NH
NH
NH
NH
NH
NH
NH
NH
NH
NH
"}
(3,1,1) = {"
NH
NH
oA
sT
Aj
Aj
Aj
Aj
sT
Dk
DJ
KC
vv
Dk
Dk
Dk
Dk
Dk
QN
NH
NH
NH
NH
NH
NH
NH
"}
(4,1,1) = {"
NH
NH
ti
sT
IH
IH
IH
IH
sT
Dk
DJ
KC
vv
Dk
dL
dL
dL
Dk
Dk
oA
oA
Dk
QN
NH
NH
NH
"}
(5,1,1) = {"
NH
NH
Ii
IV
sT
IV
sT
IV
sT
Dk
DJ
KC
vv
Dk
lx
Jc
pp
Dk
QZ
oy
oy
Dk
Dk
Dk
Dk
Dk
"}
(6,1,1) = {"
yU
Dk
Dk
sT
BX
rr
IG
sT
VU
Dk
KC
KC
ly
Dk
FH
FH
iq
Dk
ua
TD
TD
oy
oy
vK
gX
oA
"}
(7,1,1) = {"
yU
Dk
uh
IV
Ft
Ii
BG
IV
IV
Qp
KC
KC
KC
Tv
FH
FH
FH
jo
TD
TD
TD
TD
TD
vK
wr
oA
"}
(8,1,1) = {"
yU
Dk
Dk
sT
tJ
ka
xh
sT
VU
Dk
KC
KC
ky
Dk
FH
FH
cr
Dk
Hr
TD
TD
Ey
Ey
vK
Ov
oA
"}
(9,1,1) = {"
NH
NH
Ii
IV
sT
IV
sT
IV
sT
Dk
DJ
KC
Yl
Dk
NR
FH
ZX
Dk
zL
Ey
Ey
Dk
Dk
Dk
Dk
Dk
"}
(10,1,1) = {"
NH
NH
pI
sT
Aj
Aj
Aj
Aj
sT
Dk
DJ
KC
tA
Dk
qt
qt
qt
Dk
Dk
oA
oA
Dk
QN
NH
NH
NH
"}
(11,1,1) = {"
NH
NH
oA
sT
IH
IH
IH
IH
sT
Dk
DJ
KC
wn
Dk
Dk
Dk
Dk
Dk
QN
NH
NH
NH
NH
NH
NH
NH
"}
(12,1,1) = {"
NH
NH
pI
sT
Wo
Wo
Wo
Wo
sT
Dk
Dk
oA
Dk
Dk
QN
NH
NH
NH
NH
NH
NH
NH
NH
NH
NH
NH
"}
(13,1,1) = {"
NH
NH
Dk
pI
Dk
Dk
Dk
Dk
pI
Dk
QN
NH
NH
NH
NH
NH
NH
NH
NH
NH
NH
NH
NH
NH
NH
NH
"}
