//MAP CONVERTED BY dmm2tgm.py THIS HEADER COMMENT PREVENTS RECONVERSION, DO NOT REMOVE
"a" = (
/obj/docking_port/mobile/emergency{
	dwidth = 0;
	height = 1;
	name = "Null Escape";
	width = 1
	},
/turf/open/space/basic,
/area/template_noop)

(1,1,1) = {"
a
"}
