"a" = (/turf/template_noop,/area/template_noop)
"b" = (/obj/structure/shuttle/engine/propulsion{dir = 4},/turf/closed/wall/mineral/titanium,/area/shuttle/transport)
"c" = (/turf/closed/wall/mineral/titanium,/area/shuttle/transport)
"d" = (/obj/structure/window/shuttle,/obj/structure/grille,/turf/open/floor/plating,/area/shuttle/transport)
"e" = (/obj/machinery/door/airlock/titanium,/turf/open/floor/mineral/plastitanium,/area/shuttle/transport)
"f" = (/obj/effect/spawner/structure/window/shuttle,/turf/open/floor/plating,/area/shuttle/transport)
"g" = (/obj/structure/window/shuttle,/obj/structure/grille,/obj/structure/shuttle/engine/heater{icon_state = "heater"; dir = 8},/turf/open/floor/plating,/area/shuttle/transport)
"h" = (/obj/structure/sign/warning/fire,/turf/closed/wall/mineral/titanium/nodiagonal,/area/shuttle/transport)
"i" = (/obj/structure/table/reinforced,/obj/item/storage/firstaid/o2{pixel_x = 4; pixel_y = 4},/obj/item/storage/firstaid/regular,/obj/item/crowbar,/obj/machinery/light{dir = 8},/turf/open/floor/mineral/plastitanium,/area/shuttle/transport)
"j" = (/obj/effect/turf_decal/bot,/obj/structure/chair/comfy/shuttle,/turf/open/floor/mineral/plastitanium,/area/shuttle/transport)
"k" = (/obj/effect/turf_decal/tile/neutral,/obj/effect/turf_decal/tile/neutral{dir = 1},/obj/effect/turf_decal/stripes/line{dir = 8},/obj/effect/turf_decal/stripes/line{dir = 4},/turf/open/floor/mineral/plastitanium,/area/shuttle/transport)
"l" = (/obj/docking_port/mobile{dir = 8; dwidth = 2; height = 12; id = "ferry"; name = "ferry shuttle"; port_direction = 2; width = 5},/obj/structure/grille,/obj/structure/window/shuttle,/turf/open/floor/plating,/area/shuttle/transport)
"m" = (/obj/structure/table/reinforced,/obj/machinery/recharger,/turf/open/floor/mineral/plastitanium,/area/shuttle/transport)
"n" = (/obj/effect/turf_decal/bot,/obj/structure/chair/comfy/shuttle,/obj/machinery/light{dir = 1},/turf/open/floor/mineral/plastitanium,/area/shuttle/transport)
"o" = (/obj/effect/turf_decal/tile/neutral,/obj/effect/turf_decal/tile/neutral{dir = 1},/obj/effect/turf_decal/stripes/line{dir = 1},/obj/effect/turf_decal/stripes/line,/obj/structure/chair/comfy/shuttle{dir = 8; name = "briefing room chair"},/turf/open/floor/mineral/plastitanium,/area/shuttle/transport)
"p" = (/obj/machinery/computer/shuttle/ferry/request{dir = 4},/obj/effect/turf_decal/bot,/obj/effect/turf_decal/stripes/line{dir = 4},/turf/open/floor/mineral/plastitanium,/area/shuttle/transport)
"q" = (/obj/effect/turf_decal/tile/neutral,/obj/effect/turf_decal/tile/neutral{dir = 1},/obj/effect/turf_decal/stripes/line{dir = 1},/obj/effect/turf_decal/stripes/line,/turf/open/floor/mineral/plastitanium,/area/shuttle/transport)
"r" = (/obj/effect/turf_decal/tile/neutral,/obj/effect/turf_decal/tile/neutral{dir = 1},/obj/effect/turf_decal/stripes/corner,/obj/effect/turf_decal/stripes/corner{dir = 1},/obj/effect/turf_decal/stripes/corner{dir = 4},/obj/effect/turf_decal/stripes/corner{dir = 8},/turf/open/floor/mineral/plastitanium,/area/shuttle/transport)
"s" = (/obj/structure/rack,/obj/effect/turf_decal/bot,/obj/effect/turf_decal/tile/neutral{dir = 1},/obj/effect/turf_decal/tile/neutral{dir = 4},/obj/item/radio{pixel_x = -6; pixel_y = 6},/obj/item/radio{pixel_x = 6; pixel_y = 6},/obj/item/radio{pixel_y = 4},/obj/machinery/light{dir = 8},/turf/open/floor/mineral/plastitanium,/area/shuttle/transport)
"t" = (/obj/effect/turf_decal/bot,/obj/structure/chair/comfy/shuttle{dir = 1},/turf/open/floor/mineral/plastitanium,/area/shuttle/transport)
"u" = (/obj/effect/turf_decal/bot,/obj/structure/chair/comfy/shuttle{dir = 1},/obj/machinery/light,/turf/open/floor/mineral/plastitanium,/area/shuttle/transport)

(1,1,1) = {"
abccdecefccc
bghijkmkjnjd
bgpoqrqrqqql
bghstkmktutd
abccdecefccc
"}
