//MAP CONVERTED BY dmm2tgm.py THIS HEADER COMMENT PREVENTS RECONVERSION, DO NOT REMOVE
"a" = (
/turf/template_noop,
/area/template_noop)
"b" = (
/obj/structure/shuttle/engine/propulsion{
	dir = 4
	},
/turf/closed/wall/mineral/titanium,
/area/shuttle/transport)
"c" = (
/turf/closed/wall/mineral/titanium,
/area/shuttle/transport)
"d" = (
/obj/structure/window/shuttle,
/obj/structure/grille,
/turf/open/floor/plating,
/area/shuttle/transport)
"e" = (
/obj/machinery/door/airlock/titanium,
/obj/machinery/door/firedoor/border_only/directional/north,
/obj/machinery/door/firedoor/border_only/directional/south,
/obj/structure/fans/tiny/invisible,
/turf/open/floor/mineral/plastitanium,
/area/shuttle/transport)
"f" = (
/obj/effect/spawner/structure/window/shuttle,
/turf/open/floor/plating,
/area/shuttle/transport)
"g" = (
/obj/structure/window/shuttle,
/obj/structure/grille,
/obj/structure/shuttle/engine/heater{
	dir = 8;
	icon_state = "heater"
	},
/turf/open/floor/plating,
/area/shuttle/transport)
"h" = (
/obj/structure/sign/warning/fire,
/turf/closed/wall/mineral/titanium/nodiagonal,
/area/shuttle/transport)
"i" = (
/obj/structure/table/reinforced,
/obj/item/storage/firstaid/o2{
	pixel_x = 4;
	pixel_y = 4
	},
/obj/item/storage/firstaid/regular,
/obj/item/crowbar,
/obj/machinery/light{
	dir = 8
	},
/turf/open/floor/mineral/plastitanium,
/area/shuttle/transport)
"j" = (
/obj/effect/turf_decal/bot,
/obj/structure/chair/comfy/shuttle,
/turf/open/floor/mineral/plastitanium,
/area/shuttle/transport)
"k" = (
/obj/effect/turf_decal/tile/neutral,
/obj/effect/turf_decal/tile/neutral{
	dir = 1
	},
/obj/effect/turf_decal/stripes/line{
	dir = 8
	},
/obj/effect/turf_decal/stripes/line{
	dir = 4
	},
/turf/open/floor/mineral/plastitanium,
/area/shuttle/transport)
"l" = (
/obj/docking_port/mobile{
	dir = 8;
	dwidth = 2;
	height = 12;
	id = "ferry";
	name = "ferry shuttle";
	port_direction = 2;
	width = 5
	},
/obj/effect/turf_decal/tile/neutral,
/obj/effect/turf_decal/tile/neutral{
	dir = 1
	},
/obj/machinery/door/airlock/titanium,
/obj/machinery/door/firedoor/border_only/directional/west,
/obj/machinery/door/firedoor/border_only/directional/east,
/obj/structure/fans/tiny/invisible,
/turf/open/floor/mineral/plastitanium,
/area/shuttle/transport)
"m" = (
/obj/structure/table/reinforced,
/obj/machinery/recharger,
/turf/open/floor/mineral/plastitanium,
/area/shuttle/transport)
"n" = (
/obj/effect/turf_decal/bot,
/obj/structure/chair/comfy/shuttle,
/obj/machinery/light{
	dir = 1
	},
/turf/open/floor/mineral/plastitanium,
/area/shuttle/transport)
"o" = (
/obj/effect/turf_decal/tile/neutral,
/obj/effect/turf_decal/tile/neutral{
	dir = 1
	},
/obj/effect/turf_decal/stripes/line{
	dir = 1
	},
/obj/effect/turf_decal/stripes/line,
/obj/structure/chair/comfy/shuttle{
	dir = 8;
	name = "briefing room chair"
	},
/turf/open/floor/mineral/plastitanium,
/area/shuttle/transport)
"p" = (
/obj/machinery/computer/shuttle/ferry/request{
	dir = 4
	},
/obj/effect/turf_decal/bot,
/obj/effect/turf_decal/stripes/line{
	dir = 4
	},
/turf/open/floor/mineral/plastitanium,
/area/shuttle/transport)
"q" = (
/obj/effect/turf_decal/tile/neutral,
/obj/effect/turf_decal/tile/neutral{
	dir = 1
	},
/obj/effect/turf_decal/stripes/line{
	dir = 1
	},
/obj/effect/turf_decal/stripes/line,
/turf/open/floor/mineral/plastitanium,
/area/shuttle/transport)
"r" = (
/obj/effect/turf_decal/tile/neutral,
/obj/effect/turf_decal/tile/neutral{
	dir = 1
	},
/obj/effect/turf_decal/stripes/corner,
/obj/effect/turf_decal/stripes/corner{
	dir = 1
	},
/obj/effect/turf_decal/stripes/corner{
	dir = 4
	},
/obj/effect/turf_decal/stripes/corner{
	dir = 8
	},
/turf/open/floor/mineral/plastitanium,
/area/shuttle/transport)
"s" = (
/obj/structure/rack,
/obj/effect/turf_decal/bot,
/obj/effect/turf_decal/tile/neutral{
	dir = 1
	},
/obj/effect/turf_decal/tile/neutral{
	dir = 4
	},
/obj/item/radio{
	pixel_x = -6;
	pixel_y = 6
	},
/obj/item/radio{
	pixel_x = 6;
	pixel_y = 6
	},
/obj/item/radio{
	pixel_y = 4
	},
/obj/machinery/light{
	dir = 8
	},
/turf/open/floor/mineral/plastitanium,
/area/shuttle/transport)
"t" = (
/obj/effect/turf_decal/bot,
/obj/structure/chair/comfy/shuttle{
	dir = 1
	},
/turf/open/floor/mineral/plastitanium,
/area/shuttle/transport)
"u" = (
/obj/effect/turf_decal/bot,
/obj/structure/chair/comfy/shuttle{
	dir = 1
	},
/obj/machinery/light,
/turf/open/floor/mineral/plastitanium,
/area/shuttle/transport)

(1,1,1) = {"
a
b
b
b
a
"}
(2,1,1) = {"
b
g
g
g
b
"}
(3,1,1) = {"
c
h
p
h
c
"}
(4,1,1) = {"
c
i
o
s
c
"}
(5,1,1) = {"
d
j
q
t
d
"}
(6,1,1) = {"
e
k
r
k
e
"}
(7,1,1) = {"
c
m
q
m
c
"}
(8,1,1) = {"
e
k
r
k
e
"}
(9,1,1) = {"
f
j
q
t
f
"}
(10,1,1) = {"
c
n
q
u
c
"}
(11,1,1) = {"
c
j
q
t
c
"}
(12,1,1) = {"
c
d
l
d
c
"}
