//MAP CONVERTED BY dmm2tgm.py THIS HEADER COMMENT PREVENTS RECONVERSION, DO NOT REMOVE
"c" = (
/obj/effect/turf_decal/stripes/line{
	dir = 4
	},
/turf/open/floor/mineral/plastitanium/red,
/area/nsv/boarding_pod)
"f" = (
/turf/open/floor/mineral/plastitanium/red,
/area/nsv/boarding_pod)
"h" = (
/obj/structure/hull_plate/end,
/turf/open/floor/mineral/plastitanium/airless,
/area/space)
"i" = (
/obj/structure/table/survival_pod,
/obj/item/book/manual/nuclear,
/obj/item/storage/box/pinpointer_pairs,
/obj/item/storage/box/pinpointer_pairs,
/obj/item/storage/box/pinpointer_pairs,
/obj/item/crowbar/red,
/obj/item/pinpointer/nuke/syndicate,
/obj/item/gps,
/turf/open/floor/mineral/plastitanium,
/area/nsv/boarding_pod)
"l" = (
/obj/machinery/sleeper/survival_pod,
/turf/open/floor/mineral/plastitanium,
/area/nsv/boarding_pod)
"p" = (
/obj/structure/hull_plate/end{
	dir = 6
	},
/turf/open/floor/mineral/plastitanium/airless,
/area/space)
"r" = (
/obj/structure/sign/poster/contraband/c20r,
/turf/closed/wall/r_wall,
/area/nsv/boarding_pod)
"w" = (
/obj/structure/hull_plate/end{
	dir = 9
	},
/turf/open/floor/mineral/plastitanium/airless,
/area/space)
"x" = (
/obj/structure/hull_plate/end{
	dir = 4
	},
/obj/structure/peacekeeper_barricade/metal{
	dir = 4
	},
/turf/open/floor/mineral/plastitanium/airless,
/area/space)
"y" = (
/obj/structure/hull_plate/end{
	dir = 8
	},
/turf/open/floor/mineral/plastitanium/airless,
/area/space)
"A" = (
/obj/machinery/computer/ship/viewscreen,
/obj/machinery/smartfridge/survival_pod,
/obj/machinery/light/small{
	dir = 1;
	emergency_mode = 1
	},
/turf/open/floor/mineral/plastitanium,
/area/nsv/boarding_pod)
"I" = (
/obj/structure/hull_plate/end,
/obj/structure/peacekeeper_barricade/metal,
/turf/open/floor/mineral/plastitanium/airless,
/area/space)
"K" = (
/obj/structure/hull_plate/end{
	dir = 10
	},
/turf/open/floor/mineral/plastitanium/airless,
/area/space)
"M" = (
/obj/structure/chair/comfy/shuttle{
	dir = 1
	},
/turf/open/floor/mineral/plastitanium,
/area/nsv/boarding_pod)
"O" = (
/obj/machinery/door/airlock/ship/external/glass{
	req_one_access_txt = "150"
	},
/obj/structure/fans/tiny,
/turf/open/floor/mineral/plastitanium/red,
/area/nsv/boarding_pod)
"Q" = (
/obj/structure/hull_plate/end{
	dir = 8
	},
/obj/structure/peacekeeper_barricade/metal{
	dir = 8
	},
/turf/open/floor/mineral/plastitanium/airless,
/area/space)
"R" = (
/obj/structure/grille,
/obj/structure/window/reinforced/survival_pod,
/obj/structure/window/reinforced/survival_pod{
	dir = 1
	},
/turf/open/floor/mineral/plastitanium,
/area/nsv/boarding_pod)
"S" = (
/obj/structure/hull_plate/end{
	dir = 4
	},
/turf/open/floor/mineral/plastitanium/airless,
/area/space)
"T" = (
/obj/structure/hull_plate/end{
	dir = 1
	},
/turf/open/floor/mineral/plastitanium/airless,
/area/space)
"U" = (
/obj/effect/turf_decal/stripes/line{
	dir = 8;
	icon_state = "warningline"
	},
/turf/open/floor/mineral/plastitanium/red,
/area/nsv/boarding_pod)
"W" = (
/turf/template_noop,
/area/template_noop)
"Y" = (
/obj/structure/hull_plate/end{
	dir = 5
	},
/turf/open/floor/mineral/plastitanium/airless,
/area/space)
"Z" = (
/turf/closed/wall/r_wall,
/area/nsv/boarding_pod)

(1,1,1) = {"
W
W
W
W
W
W
W
W
W
"}
(2,1,1) = {"
W
w
y
Q
y
Q
y
K
W
"}
(3,1,1) = {"
W
T
Z
Z
O
Z
Z
h
W
"}
(4,1,1) = {"
W
T
Z
l
U
M
Z
h
W
"}
(5,1,1) = {"
W
T
Z
A
f
M
R
I
W
"}
(6,1,1) = {"
W
T
r
i
c
M
Z
h
W
"}
(7,1,1) = {"
W
T
Z
Z
O
Z
Z
h
W
"}
(8,1,1) = {"
W
Y
S
x
S
x
S
p
W
"}
(9,1,1) = {"
W
W
W
W
W
W
W
W
W
"}
