//MAP CONVERTED BY dmm2tgm.py THIS HEADER COMMENT PREVENTS RECONVERSION, DO NOT REMOVE
"a" = (
/obj/effect/spawner/structure/window/shuttle,
/turf/open/floor/plating,
/area/shuttle/arrival)
"c" = (
/obj/machinery/light/floor,
/turf/open/floor/mineral/titanium/yellow,
/area/shuttle/arrival)
"d" = (
/obj/item/kirbyplants/random,
/turf/open/floor/mineral/titanium/yellow,
/area/shuttle/arrival)
"e" = (
/turf/open/floor/mineral/titanium,
/area/shuttle/arrival)
"g" = (
/obj/structure/sign/poster/official/moth3{
	pixel_y = -32
	},
/obj/machinery/light/floor,
/turf/open/floor/mineral/titanium/yellow,
/area/shuttle/arrival)
"h" = (
/obj/structure/shuttle/engine/propulsion{
	dir = 4
	},
/turf/open/floor/plating,
/area/shuttle/arrival)
"k" = (
/obj/machinery/light/floor,
/obj/machinery/requests_console{
	department = "Arrival shuttle";
	name = "Arrivals Shuttle console";
	pixel_x = -32
	},
/turf/open/floor/mineral/titanium/yellow,
/area/shuttle/arrival)
"n" = (
/turf/template_noop,
/area/template_noop)
"p" = (
/obj/structure/window/plasma/reinforced/spawner/west,
/obj/structure/chair/shuttlecraft_chair{
	dir = 4
	},
/turf/open/floor/mineral/titanium,
/area/shuttle/arrival)
"r" = (
/turf/closed/wall/mineral/titanium/nodiagonal,
/area/shuttle/arrival)
"u" = (
/obj/machinery/computer/ship/navigation/public,
/turf/open/floor/mineral/titanium/yellow,
/area/shuttle/arrival)
"w" = (
/obj/structure/sign/poster/official/moth6{
	pixel_x = -32
	},
/obj/machinery/light{
	dir = 8
	},
/turf/open/floor/mineral/titanium/yellow,
/area/shuttle/arrival)
"y" = (
/obj/structure/closet/emcloset,
/obj/machinery/light{
	dir = 1
	},
/turf/open/floor/mineral/titanium/yellow,
/area/shuttle/arrival)
"z" = (
/obj/structure/shuttle/engine/propulsion,
/turf/open/floor/plating,
/area/shuttle/arrival)
"B" = (
/obj/structure/sign/poster/official/moth2{
	pixel_y = -32
	},
/obj/machinery/light/floor,
/turf/open/floor/mineral/titanium/yellow,
/area/shuttle/arrival)
"C" = (
/obj/structure/shuttle/engine/propulsion{
	dir = 8
	},
/turf/open/floor/plating,
/area/shuttle/arrival)
"F" = (
/turf/open/floor/mineral/titanium/yellow,
/area/shuttle/arrival)
"G" = (
/turf/closed/wall/mineral/titanium,
/area/shuttle/arrival)
"I" = (
/obj/structure/sign/poster/official/moth9{
	pixel_x = -32
	},
/obj/machinery/light{
	dir = 8
	},
/turf/open/floor/mineral/titanium/yellow,
/area/shuttle/arrival)
"K" = (
/obj/machinery/door/airlock/shuttle/glass,
/obj/docking_port/mobile/arrivals{
	name = "serendipity arrivals shuttle";
	dwidth = 8;
	width = 15;
	height = 8
	},
/turf/open/floor/noslip,
/area/shuttle/arrival)
"L" = (
/obj/structure/sign/poster/official/moth1{
	pixel_y = 31
	},
/obj/machinery/light/floor,
/turf/open/floor/mineral/titanium/yellow,
/area/shuttle/arrival)
"M" = (
/obj/machinery/light{
	dir = 4
	},
/turf/open/floor/mineral/titanium/yellow,
/area/shuttle/arrival)
"O" = (
/obj/structure/window/plasma/reinforced/spawner/east,
/obj/structure/chair/shuttlecraft_chair{
	dir = 8
	},
/turf/open/floor/mineral/titanium,
/area/shuttle/arrival)
"Q" = (
/obj/machinery/computer/station_alert,
/turf/open/floor/mineral/titanium/yellow,
/area/shuttle/arrival)
"R" = (
/obj/structure/closet/emcloset,
/obj/machinery/light,
/turf/open/floor/mineral/titanium/yellow,
/area/shuttle/arrival)
"Y" = (
/obj/structure/sign/poster/official/moth4{
	pixel_y = 32
	},
/obj/machinery/light/floor,
/turf/open/floor/mineral/titanium/yellow,
/area/shuttle/arrival)

(1,1,1) = {"
n
C
r
a
a
a
G
G
G
a
a
a
r
z
n
"}
(2,1,1) = {"
C
r
r
Y
F
F
w
k
I
F
F
g
r
r
z
"}
(3,1,1) = {"
r
r
y
e
O
O
O
O
O
O
O
e
R
r
r
"}
(4,1,1) = {"
a
u
e
e
p
p
p
p
p
p
p
e
e
d
a
"}
(5,1,1) = {"
a
Q
e
e
O
O
O
O
O
O
O
e
e
d
a
"}
(6,1,1) = {"
r
r
y
e
p
p
p
p
p
p
p
e
R
r
r
"}
(7,1,1) = {"
h
r
r
L
F
F
M
c
M
F
F
B
r
r
z
"}
(8,1,1) = {"
n
h
r
a
a
a
G
K
G
a
a
a
r
z
n
"}
