//MAP CONVERTED BY dmm2tgm.py THIS HEADER COMMENT PREVENTS RECONVERSION, DO NOT REMOVE
"a" = (
/turf/template_noop,
/area/template_noop)
"b" = (
/obj/effect/turf_decal/ship/techfloor/corner,
/obj/effect/turf_decal/ship/techfloor/corner{
	dir = 4
	},
/turf/open/floor/plasteel/grid/techfloor,
/area/shuttle/arrival)
"c" = (
/obj/machinery/door/airlock/titanium{
	name = "Arrivals Shuttle Airlock"
	},
/obj/structure/fans/tiny,
/turf/open/floor/plasteel/grid/techfloor,
/area/shuttle/arrival)
"d" = (
/obj/machinery/computer/station_alert{
	dir = 1
	},
/turf/open/floor/monofloor,
/area/shuttle/arrival)
"f" = (
/obj/structure/chair/fancy/shuttle,
/obj/machinery/light{
	dir = 1;
	icon_state = "tube"
	},
/turf/open/floor/monofloor{
	dir = 1
	},
/area/shuttle/arrival)
"h" = (
/obj/structure/shuttle/engine/heater{
	dir = 8
	},
/obj/structure/window/reinforced{
	dir = 4
	},
/turf/open/floor/plating/airless,
/area/shuttle/arrival)
"i" = (
/obj/structure/closet/emcloset{
	anchored = 1
	},
/turf/open/floor/monofloor{
	dir = 8
	},
/area/shuttle/arrival)
"j" = (
/obj/structure/shuttle/engine/propulsion{
	dir = 8
	},
/turf/open/floor/plating/airless,
/area/shuttle/arrival)
"k" = (
/obj/structure/chair/fancy/shuttle{
	dir = 4
	},
/obj/effect/turf_decal/ship/techfloor/corner{
	dir = 4
	},
/obj/effect/turf_decal/ship/techfloor/corner,
/obj/effect/turf_decal/ship/techfloor/corner{
	dir = 8
	},
/obj/effect/turf_decal/ship/techfloor/corner{
	dir = 1
	},
/turf/open/floor/plasteel/grid/techfloor,
/area/shuttle/arrival)
"m" = (
/obj/structure/shuttle/engine/propulsion{
	dir = 8
	},
/obj/docking_port/mobile/arrivals{
	dir = 4;
	name = "shrike arrivals shuttle"
	},
/turf/open/floor/plating/airless,
/area/shuttle/arrival)
"p" = (
/turf/open/floor/plasteel/grid/techfloor,
/area/shuttle/arrival)
"v" = (
/obj/effect/turf_decal/ship/techfloor/corner,
/obj/effect/turf_decal/ship/techfloor/corner{
	dir = 8
	},
/obj/effect/turf_decal/ship/techfloor/corner{
	dir = 4
	},
/obj/effect/turf_decal/ship/techfloor/corner{
	dir = 1
	},
/turf/open/floor/plasteel/grid/techfloor,
/area/shuttle/arrival)
"w" = (
/obj/structure/chair/fancy/shuttle,
/turf/open/floor/monofloor{
	dir = 1
	},
/area/shuttle/arrival)
"C" = (
/turf/closed/wall/mineral/titanium,
/area/shuttle/arrival)
"G" = (
/obj/machinery/modular_computer/console/preset/civilian,
/turf/open/floor/monofloor{
	dir = 1
	},
/area/shuttle/arrival)
"K" = (
/obj/effect/spawner/structure/window/shuttle,
/turf/open/floor/plating/airless,
/area/shuttle/arrival)
"L" = (
/obj/machinery/computer/ship/navigation/public{
	dir = 8
	},
/turf/open/floor/monofloor{
	dir = 4
	},
/area/shuttle/arrival)
"M" = (
/obj/structure/chair/fancy/shuttle{
	dir = 1
	},
/turf/open/floor/monofloor,
/area/shuttle/arrival)
"N" = (
/obj/effect/turf_decal/stripes/line{
	dir = 1
	},
/turf/open/floor/plasteel/grid/techfloor,
/area/shuttle/arrival)
"S" = (
/obj/effect/turf_decal/ship/techfloor/corner{
	dir = 1
	},
/obj/effect/turf_decal/ship/techfloor/corner{
	dir = 8
	},
/turf/open/floor/plasteel/grid/techfloor,
/area/shuttle/arrival)
"U" = (
/turf/closed/wall/mineral/titanium/nodiagonal,
/area/shuttle/arrival)
"V" = (
/obj/structure/chair/fancy/shuttle{
	dir = 1
	},
/obj/machinery/light,
/turf/open/floor/monofloor,
/area/shuttle/arrival)
"Y" = (
/obj/effect/turf_decal/stripes/line,
/turf/open/floor/plasteel/grid/techfloor,
/area/shuttle/arrival)

(1,1,1) = {"
a
j
m
j
a
"}
(2,1,1) = {"
U
h
h
h
U
"}
(3,1,1) = {"
C
U
i
U
C
"}
(4,1,1) = {"
C
w
S
M
C
"}
(5,1,1) = {"
c
N
p
Y
c
"}
(6,1,1) = {"
C
f
p
V
C
"}
(7,1,1) = {"
c
N
p
Y
c
"}
(8,1,1) = {"
C
w
b
M
C
"}
(9,1,1) = {"
C
C
v
C
C
"}
(10,1,1) = {"
K
G
k
d
K
"}
(11,1,1) = {"
K
K
L
K
K
"}
(12,1,1) = {"
a
K
K
K
a
"}
